agency_bureau_indicator,agency_nm,bureau_nm,cfo_agency_indicator,compliance_rate_amt,compliance_rate_cnt,eligible_debt_not_referred_amt,eligible_debt_not_referred_cnt,eligible_debt_referred_amt,eligible_debt_referred_cnt,record_calendar_day,record_calendar_month,record_calendar_quarter,record_calendar_year,record_date,record_fiscal_quarter,record_fiscal_year,total_eligible_debt_amt,total_eligible_debt_cnt
Bureau,Legislative Branch-GPO,Government Publishing Office,null,0.0,0.0,747847,95,0,0,31,12,4,2015,2015-12-31,1,2016,747847,95
Bureau,Other Agencies,Federal Mine Safety & Health Review Comm,null,100.0,100.0,0,0,366,1,31,12,4,2015,2015-12-31,1,2016,366,1
Bureau,National Credit Union Administration,Nat'l Credit Union Admin. Treasury Acct.,null,0.0,0.0,0,0,0,0,31,12,4,2015,2015-12-31,1,2016,0,0
Bureau,Department of Transportation,Surface Transportation Board,null,100.0,100.0,0,0,716,4,31,12,4,2015,2015-12-31,1,2016,716,4
Bureau,Department of Commerce,Office of the Inspector General,null,0.0,0.0,0,0,0,0,31,12,4,2015,2015-12-31,1,2016,0,0
Bureau,Department of Justice,U.S. Marshals Service,null,0.0,0.0,3432,3,0,0,31,12,4,2015,2015-12-31,1,2016,3432,3
Bureau,Department of Veterans Affairs,Life Insurance,null,47.713681348320975,95.3125,406123,3,370606,61,31,12,4,2015,2015-12-31,1,2016,776729,64
Agency,Federal Labor Relations Authority,null,Non-CFO,0.0,0.0,0,0,0,0,31,12,4,2015,2015-12-31,1,2016,0,0
Bureau,Consumer Product Safety Commission,Consumer Product Safety Commission,null,80.60606060606061,50.0,96,1,399,1,31,12,4,2015,2015-12-31,1,2016,495,2
Bureau,Department of Transportation,Federal Aviation Administration,null,91.09026915482549,78.72340425531915,390270,180,3989997,666,31,12,4,2015,2015-12-31,1,2016,4380267,846
Agency,Legislative Branch - U.S. House/Senate,null,Non-CFO,0.0,0.0,232611,206,0,0,31,12,4,2015,2015-12-31,1,2016,232611,206
Bureau,Other Agencies,Commission On Fine Arts,null,0.0,0.0,0,0,0,0,31,12,4,2015,2015-12-31,1,2016,0,0
Bureau,Department of Homeland Security,Federal Law Enforcement Training Ctr.,null,100.0,100.0,0,0,22878,12,31,12,4,2015,2015-12-31,1,2016,22878,12
Bureau,National Foundation  Arts & Humanities,National Endowment for the Arts,null,0.0,0.0,0,0,0,0,31,12,4,2015,2015-12-31,1,2016,0,0
Bureau,Other Agencies,Gulf Coast Ecosystem Restoration Council,null,0.0,0.0,0,0,0,0,31,12,4,2015,2015-12-31,1,2016,0,0
Bureau,Legis Branch-Library of Congress,Library of Congress,null,0.0,0.0,0,0,0,0,31,12,4,2015,2015-12-31,1,2016,0,0
Bureau,Department of Health & Human Services,Program Support Center,null,100.0,100.0,0,0,3007464,339,31,12,4,2015,2015-12-31,1,2016,3007464,339
Bureau,Agency for International Development,Agency for International Development,null,85.35966188984898,37.254901960784316,2793090,32,16284953,19,31,12,4,2015,2015-12-31,1,2016,19078043,51
Bureau,Other Agencies,Christopher Columbus Fellowship Found,null,0.0,0.0,0,0,0,0,31,12,4,2015,2015-12-31,1,2016,0,0
Bureau,Nuclear Regulatory Commission,Nuclear Regulatory Commission,null,100.0,100.0,0,0,982669,178,31,12,4,2015,2015-12-31,1,2016,982669,178
Bureau,Department of Labor,Employment and Training Administration,null,100.0,100.0,0,0,62270,1,31,12,4,2015,2015-12-31,1,2016,62270,1
Bureau,Other Agencies,Federal Housing Finance Agency OIG,null,0.0,0.0,0,0,0,0,31,12,4,2015,2015-12-31,1,2016,0,0
Bureau,Department of the Treasury,Spec Insp Gen-Troubled Asset Rel Prog,null,100.0,100.0,0,0,3916,1,31,12,4,2015,2015-12-31,1,2016,3916,1
Bureau,Other Agencies,Council of Insps. Gen. of Intg. & Effy.,null,0.0,0.0,9338,6,0,0,31,12,4,2015,2015-12-31,1,2016,9338,6
Bureau,Other Agencies,Consumer Financial Protection Bureau,null,0.0,0.0,28793,44,0,0,31,12,4,2015,2015-12-31,1,2016,28793,44
Bureau,Securities & Exchange Commission,Securities and Exchange Commission,null,99.99499327552734,97.40112994350282,92053,23,1838495241,862,31,12,4,2015,2015-12-31,1,2016,1838587294,885
Bureau,Funds Appropriated to the President,Defense Security Assistance Agency,null,0.0,0.0,0,0,0,0,31,12,4,2015,2015-12-31,1,2016,0,0
Agency,U.S. Postal Service,null,Non-CFO,72.32685243257772,40.0,15443000,3,40362000,2,31,12,4,2015,2015-12-31,1,2016,55805000,5
Bureau,Department of the Treasury,Treasury Forfeiture Fund,null,0.0,0.0,0,0,0,0,31,12,4,2015,2015-12-31,1,2016,0,0
Bureau,Department of Energy,Bonneville Power Administration,null,100.0,100.0,0,0,1137778,42,31,12,4,2015,2015-12-31,1,2016,1137778,42
Bureau,Department of Housing and Urban Development,Management and Administration,null,0.0,0.0,0,0,0,0,31,12,4,2015,2015-12-31,1,2016,0,0
Bureau,Department of Homeland Security,Office of Health Affairs,null,0.0,0.0,0,0,0,0,31,12,4,2015,2015-12-31,1,2016,0,0
Bureau,Other Agencies,Comm. for Purchase from Blind/Handic.,null,0.0,0.0,9358,6,0,0,31,12,4,2015,2015-12-31,1,2016,9358,6
Bureau,Department of Transportation,Office of the Secretary,null,51.04551312683725,92.3076923076923,540904,2,564008,24,31,12,4,2015,2015-12-31,1,2016,1104912,26
Bureau,Social Security Administration,Social Security Administration,null,53.34080341754686,53.36429056509358,1151849546,626284,1316794645,716644,31,12,4,2015,2015-12-31,1,2016,2468644191,1342928
Bureau,Department of Homeland Security,Management Headquarters,null,0.0,0.0,0,0,0,0,31,12,4,2015,2015-12-31,1,2016,0,0
Bureau,Department of the Treasury,International Monetary Funds,null,0.0,0.0,0,0,0,0,31,12,4,2015,2015-12-31,1,2016,0,0
Agency,Office of Special Counsel,null,Non-CFO,0.0,0.0,0,0,0,0,31,12,4,2015,2015-12-31,1,2016,0,0
Agency,Occupational Safety & Health Rev Comm,null,Non-CFO,0.0,0.0,0,0,0,0,31,12,4,2015,2015-12-31,1,2016,0,0
Bureau,Smithsonian Institution,JFK Center for the Performing Arts,null,0.0,0.0,0,0,0,0,31,12,4,2015,2015-12-31,1,2016,0,0
Agency,Legis Branch-Library of Congress,null,Non-CFO,0.0,0.0,0,0,0,0,31,12,4,2015,2015-12-31,1,2016,0,0
Bureau,Other Agencies,District of Columbia Government,null,0.0,0.0,96573,31,0,0,31,12,4,2015,2015-12-31,1,2016,96573,31
Bureau,Department of the Treasury,Financial Crimes Enforcement Network,null,100.0,100.0,0,0,1569945,4,31,12,4,2015,2015-12-31,1,2016,1569945,4
Bureau,Department of Education,Federal Student Aid,null,62.27481973753808,50.59950780158669,42129637259,10724217,69545474605,10984508,31,12,4,2015,2015-12-31,1,2016,111675111864,21708725
Bureau,Other Agencies,Japan-U.S. Friendship Commission,null,0.0,0.0,0,0,0,0,31,12,4,2015,2015-12-31,1,2016,0,0
Bureau,Department of the Treasury,Tobacco Tax and Trade,null,100.0,100.0,0,0,1000,1,31,12,4,2015,2015-12-31,1,2016,1000,1
Bureau,Other Agencies,U.S. Institute of Peace,null,0.0,0.0,4054,5,0,0,31,12,4,2015,2015-12-31,1,2016,4054,5
Bureau,Funds Appropriated to the President,Trade and Development Agency,null,0.0,0.0,0,0,0,0,31,12,4,2015,2015-12-31,1,2016,0,0
Bureau,The Judiciary,Administrative Office of the U.S. Courts,null,36.68784496069001,26.285714285714285,570792,129,330760,46,31,12,4,2015,2015-12-31,1,2016,901552,175
Bureau,Department of the Interior,Office of Surface Mining,null,100.0,100.0,0,0,1708903,195,31,12,4,2015,2015-12-31,1,2016,1708903,195
Bureau,Department of Commerce,National Technical Information Service,null,0.0,0.0,0,0,0,0,31,12,4,2015,2015-12-31,1,2016,0,0
Bureau,Federal Mediation/Conciliation Service,Federal Mediation/Conciliation Service,null,0.0,0.0,0,0,0,0,31,12,4,2015,2015-12-31,1,2016,0,0
Bureau,Department of Homeland Security,Science and Technology,null,0.0,0.0,0,0,0,0,31,12,4,2015,2015-12-31,1,2016,0,0
Bureau,Legislative Branch-Office of Tech.,Open World Leadership,null,0.0,0.0,0,0,0,0,31,12,4,2015,2015-12-31,1,2016,0,0
Bureau,Other Agencies,Chemical Safety Board,null,0.0,0.0,0,0,0,0,31,12,4,2015,2015-12-31,1,2016,0,0
Bureau,Other Agencies,Recovery and Acct. and Transparency Bd.,null,0.0,0.0,0,0,0,0,31,12,4,2015,2015-12-31,1,2016,0,0
Bureau,Department of the Treasury,Office of Sec International Affairs,null,0.0,0.0,0,0,0,0,31,12,4,2015,2015-12-31,1,2016,0,0
Bureau,Department of Commerce,Nat'l Telecomm & Information Admin.,null,0.0,0.0,0,0,0,0,31,12,4,2015,2015-12-31,1,2016,0,0
Bureau,Other Agencies/Boards/Commissions,U.S.-China Security Review Commission,null,0.0,0.0,1747,4,0,0,31,12,4,2015,2015-12-31,1,2016,1747,4
Bureau,U.S. Postal Service,U.S. Postal Service,null,72.32685243257772,40.0,15443000,3,40362000,2,31,12,4,2015,2015-12-31,1,2016,55805000,5
Agency,Commodity Futures Trading Commission,null,Non-CFO,96.46705248878655,94.44444444444444,12604226,13,344158108,221,31,12,4,2015,2015-12-31,1,2016,356762334,234
Agency,Federal Deposit Insurance Corporation,null,Non-CFO,0.0,0.0,0,0,0,0,31,12,4,2015,2015-12-31,1,2016,0,0
Bureau,Department of the Interior,Geological Survey,null,100.0,100.0,0,0,113270,128,31,12,4,2015,2015-12-31,1,2016,113270,128
Agency,American Battle Monuments Commission,null,Non-CFO,0.0,0.0,0,0,0,0,31,12,4,2015,2015-12-31,1,2016,0,0
Agency,Federal Communications Commission,null,Non-CFO,72.79901032911789,83.12081401339516,56167230,2621,150322426,12907,31,12,4,2015,2015-12-31,1,2016,206489656,15528
Bureau,Department of Labor,Departmental Management,null,0.0,0.0,0,0,0,0,31,12,4,2015,2015-12-31,1,2016,0,0
Bureau,Department of Homeland Security,Citizenship and Immigration Services,null,100.0,100.0,0,0,909374,1491,31,12,4,2015,2015-12-31,1,2016,909374,1491
Bureau,Department of Defense,Consolidated Report,null,40.52645520156609,51.863068771799036,1535205375,289276,1046119448,311668,31,12,4,2015,2015-12-31,1,2016,2581324823,600944
Bureau,Department of Agriculture,Food Safety and Inspection Service,null,99.97445563014195,99.92337164750958,251,1,982353,1304,31,12,4,2015,2015-12-31,1,2016,982604,1305
Bureau,Department of Agriculture,Food and Nutrition Service,null,0.059329195542655186,0.8379888268156425,13956172,710,8285,6,31,12,4,2015,2015-12-31,1,2016,13964457,716
Bureau,Department of Health & Human Services,Health Resources and Services Admin,null,100.0,100.0,0,0,61877849,399,31,12,4,2015,2015-12-31,1,2016,61877849,399
Bureau,Department of the Interior,Bureau of Indian Affairs,null,92.64768574203478,82.12678536489923,730222,3654,9201644,16790,31,12,4,2015,2015-12-31,1,2016,9931866,20444
Bureau,Department of Energy,Energy Consolidated Reports,null,99.99258489498695,97.95918367346938,768,1,10356469,48,31,12,4,2015,2015-12-31,1,2016,10357237,49
Bureau,Legislative Branch-Office of Tech.,Medicaid & CHIP Payment & Access Comm.,null,0.0,0.0,0,0,0,0,31,12,4,2015,2015-12-31,1,2016,0,0
Bureau,Department of the Treasury,U.S. Treasury IG Office,null,0.0,0.0,0,0,0,0,31,12,4,2015,2015-12-31,1,2016,0,0
Agency,Smithsonian Institution,null,Non-CFO,0.0,0.0,0,0,0,0,31,12,4,2015,2015-12-31,1,2016,0,0
Bureau,Tennessee Valley Authority,Tennessee Valley Authority,null,0.0,0.0,0,0,0,0,31,12,4,2015,2015-12-31,1,2016,0,0
Bureau,Other Agencies,U.S. Holocaust Memorial Council,null,0.0,0.0,0,0,0,0,31,12,4,2015,2015-12-31,1,2016,0,0
Bureau,Department of Transportation,Federal Motor Carrier Safety Admin,null,94.1951374781541,93.18021201413427,2213237,386,35914057,5274,31,12,4,2015,2015-12-31,1,2016,38127294,5660
Bureau,Department of Labor,Employment Standards Administration,null,16.124602694305512,24.380165289256198,52072248,3660,10010615,1180,31,12,4,2015,2015-12-31,1,2016,62082863,4840
Agency,Federal Trade Commission,null,Non-CFO,100.0,100.0,0,0,487135886,57,31,12,4,2015,2015-12-31,1,2016,487135886,57
Bureau,Other Agencies,Archit.&Trans. Barriers Compliance Bd,null,0.0,0.0,0,0,0,0,31,12,4,2015,2015-12-31,1,2016,0,0
Bureau,Department of the Interior,National Park Service,null,99.46122476929801,95.76530612244898,24233,83,4473561,1877,31,12,4,2015,2015-12-31,1,2016,4497794,1960
Bureau,Department of Commerce,NOAA,null,100.0,100.0,0,0,5358749,726,31,12,4,2015,2015-12-31,1,2016,5358749,726
Bureau,Department of State,International Commissions,null,0.0,0.0,0,0,0,0,31,12,4,2015,2015-12-31,1,2016,0,0
Bureau,Legislative Branch-GAO,Government Accountability Office,null,0.0,0.0,0,0,0,0,31,12,4,2015,2015-12-31,1,2016,0,0
Bureau,Department of Labor,Occupational Safety and Health Admin,null,89.7110438898483,66.9789807654174,3586050,6661,31267340,13511,31,12,4,2015,2015-12-31,1,2016,34853390,20172
Bureau,Federal Deposit Insurance Corporation,Federal Deposit Insurance Corporation,null,0.0,0.0,0,0,0,0,31,12,4,2015,2015-12-31,1,2016,0,0
Bureau,Merit Systems Protection Board,Merit Systems Protection Board,null,0.0,0.0,0,0,0,0,31,12,4,2015,2015-12-31,1,2016,0,0
Bureau,Department of Transportation,St. Lawrence Seaway Development Corp.,null,0.0,0.0,0,0,0,0,31,12,4,2015,2015-12-31,1,2016,0,0
Bureau,Office of Government Ethics,Office of Government Ethics,null,0.0,0.0,0,0,0,0,31,12,4,2015,2015-12-31,1,2016,0,0
Bureau,Department of Homeland Security,Emergency Preparedness & Resp,null,85.15000109628407,86.75748259655818,48886641,7495,280316353,49103,31,12,4,2015,2015-12-31,1,2016,329202994,56598
Bureau,Department of Justice,Office of Justice Assistance Programs,null,100.0,100.0,0,0,1026506,13,31,12,4,2015,2015-12-31,1,2016,1026506,13
Bureau,Federal Maritime Commission,Salaries and Expenses,null,0.0,0.0,2196,18,0,0,31,12,4,2015,2015-12-31,1,2016,2196,18
Bureau,Department of Labor,Bureau of Labor Statistics,null,0.0,0.0,10969,1,0,0,31,12,4,2015,2015-12-31,1,2016,10969,1
Bureau,Environmental Protection Agency,Environmental Protection Agency,null,99.11077489797806,98.55072463768116,132782,3,14799545,204,31,12,4,2015,2015-12-31,1,2016,14932327,207
Bureau,Department of the Treasury,Bureau of the Fiscal Service,null,100.0,100.0,0,0,114778,180,31,12,4,2015,2015-12-31,1,2016,114778,180
Bureau,Other Agencies/Boards/Commissions,Nuclear Waste Technical Review Board,null,0.0,0.0,0,0,0,0,31,12,4,2015,2015-12-31,1,2016,0,0
Agency,Federal Election Commission,null,Non-CFO,99.91161904272175,97.61904761904762,275,1,310878,41,31,12,4,2015,2015-12-31,1,2016,311153,42
Agency,National Foundation  Arts & Humanities,null,Non-CFO,0.0,0.0,0,0,0,0,31,12,4,2015,2015-12-31,1,2016,0,0
Bureau,Selective Service System,Selective Service System,null,0.0,0.0,2314,3,0,0,31,12,4,2015,2015-12-31,1,2016,2314,3
Bureau,Funds Appropriated to the President,Inter-American Foundation,null,0.0,0.0,0,0,0,0,31,12,4,2015,2015-12-31,1,2016,0,0
Bureau,Smithsonian Institution,Smithsonian Institution,null,0.0,0.0,0,0,0,0,31,12,4,2015,2015-12-31,1,2016,0,0
Bureau,Funds Appropriated to the President,African Development Foundation,null,0.0,0.0,0,0,0,0,31,12,4,2015,2015-12-31,1,2016,0,0
Bureau,Department of Labor,Employee Benefit Security Administration,null,0.0,0.0,15119768,310,0,0,31,12,4,2015,2015-12-31,1,2016,15119768,310
Bureau,Commodity Futures Trading Commission,Commodity Futures Trading Commission,null,96.46705248878655,94.44444444444444,12604226,13,344158108,221,31,12,4,2015,2015-12-31,1,2016,356762334,234
Bureau,Other Agencies,National Capital Planning Commission,null,0.0,0.0,0,0,0,0,31,12,4,2015,2015-12-31,1,2016,0,0
Bureau,Department of Homeland Security,Immigration and Customs Enforcement,null,100.0,100.0,0,0,5453787,319,31,12,4,2015,2015-12-31,1,2016,5453787,319
Bureau,Neighborhood Reinvestment Corporation,Neighborhood Reinvestment Corporation,null,0.0,0.0,0,0,0,0,31,12,4,2015,2015-12-31,1,2016,0,0
Bureau,Department of Homeland Security,Domestic Nuclear Detection Office,null,0.0,0.0,0,0,0,0,31,12,4,2015,2015-12-31,1,2016,0,0
Bureau,Funds Appropriated to the President,Executive Branch,null,0.0,0.0,0,0,0,0,31,12,4,2015,2015-12-31,1,2016,0,0
Bureau,Other Agencies,Marine Mammal Commission,null,0.0,0.0,0,0,0,0,31,12,4,2015,2015-12-31,1,2016,0,0
Agency,Securities & Exchange Commission,null,Non-CFO,99.99499327552734,97.40112994350282,92053,23,1838495241,862,31,12,4,2015,2015-12-31,1,2016,1838587294,885
Agency,National Credit Union Administration,null,Non-CFO,0.0,0.0,0,0,0,0,31,12,4,2015,2015-12-31,1,2016,0,0
Bureau,Other Agencies,U.S.  Agency of Global Media,null,0.0,0.0,13356,3,0,0,31,12,4,2015,2015-12-31,1,2016,13356,3
Bureau,Department of Transportation,Federal Highway Administration,null,49.294740873117185,71.42857142857143,15889,4,15447,10,31,12,4,2015,2015-12-31,1,2016,31336,14
Bureau,Department of Agriculture,Agricultural Marketing Service,null,22.962593066522405,50.150150150150154,888608,166,264868,167,31,12,4,2015,2015-12-31,1,2016,1153476,333
Agency,Equal Employment Opportunity Commission,null,Non-CFO,0.0,0.0,380681,58,0,0,31,12,4,2015,2015-12-31,1,2016,380681,58
Bureau,Department of Housing and Urban Development,"Policy, Development and Research",null,0.0,0.0,0,0,0,0,31,12,4,2015,2015-12-31,1,2016,0,0
Agency,Office of Compliance,null,Non-CFO,0.0,0.0,0,0,0,0,31,12,4,2015,2015-12-31,1,2016,0,0
Bureau,Corp. for National and Community Service,Corp. for National and Community Service,null,99.19435427787126,88.3177570093458,21953,25,2702942,189,31,12,4,2015,2015-12-31,1,2016,2724895,214
Bureau,General Services Administration,General Services Administration,null,82.60108890530049,89.43854324734446,1911586,348,9075228,2947,31,12,4,2015,2015-12-31,1,2016,10986814,3295
Bureau,Department of Homeland Security,U.S. Secret Service,null,0.0,0.0,36534,6,0,0,31,12,4,2015,2015-12-31,1,2016,36534,6
Bureau,Other Agencies/Boards/Commissions,Medicare Payment Advisory Commission,null,0.0,0.0,24,1,0,0,31,12,4,2015,2015-12-31,1,2016,24,1
Bureau,Overseas Private Investment Corp Accts,Overseas Private Investment Corp Accts,null,0.0,0.0,0,0,0,0,31,12,4,2015,2015-12-31,1,2016,0,0
Agency,Department of Housing and Urban Development,null,CFO,98.36620956972784,99.11190053285968,1827570,45,110033166,5022,31,12,4,2015,2015-12-31,1,2016,111860736,5067
Bureau,Other Agencies,Appraisal Subcommittee,null,0.0,0.0,0,0,0,0,31,12,4,2015,2015-12-31,1,2016,0,0
Agency,Office of Government Ethics,null,Non-CFO,0.0,0.0,0,0,0,0,31,12,4,2015,2015-12-31,1,2016,0,0
Bureau,Department of the Treasury,Bureau of Public Debt,null,100.0,100.0,0,0,2772431,21,31,12,4,2015,2015-12-31,1,2016,2772431,21
Bureau,Department of Health & Human Services,Administration for Community Living,null,0.0,0.0,0,0,0,0,31,12,4,2015,2015-12-31,1,2016,0,0
Agency,Export - Import  Bank,null,Non-CFO,0.0,0.0,0,0,0,0,31,12,4,2015,2015-12-31,1,2016,0,0
Bureau,Federal Trade Commission,Federal Trade Commission,null,100.0,100.0,0,0,487135886,57,31,12,4,2015,2015-12-31,1,2016,487135886,57
Bureau,Other Agencies,Election Assistance Commission,null,0.0,0.0,0,0,0,0,31,12,4,2015,2015-12-31,1,2016,0,0
Bureau,Department of the Treasury,Office of Financial Research,null,0.0,0.0,36,1,0,0,31,12,4,2015,2015-12-31,1,2016,36,1
Bureau,Department of the Interior,Fish and Wildlife Service,null,97.4084219772367,92.10526315789474,6963,9,261715,105,31,12,4,2015,2015-12-31,1,2016,268678,114
Bureau,Department of the Treasury,Office of the Secretary,null,99.40067255264248,97.43150684931507,107318,15,17799087,569,31,12,4,2015,2015-12-31,1,2016,17906405,584
Bureau,Other Agencies,Millennium Challenge Corporation,null,0.0,0.0,0,0,0,0,31,12,4,2015,2015-12-31,1,2016,0,0
Agency,Other Agencies,null,Non-CFO,1.8931552251285693,2.4,389545,122,7517,3,31,12,4,2015,2015-12-31,1,2016,397062,125
Bureau,Other Agencies,National Mediation Board,null,0.0,0.0,0,0,0,0,31,12,4,2015,2015-12-31,1,2016,0,0
Bureau,Occupational Safety & Health Rev Comm,Occupational Safety & Health Rev Comm,null,0.0,0.0,0,0,0,0,31,12,4,2015,2015-12-31,1,2016,0,0
Bureau,Department of Homeland Security,Bureau of Customs & Border Protection,null,7.710914153409375,71.7687074829932,5501465,166,459657,422,31,12,4,2015,2015-12-31,1,2016,5961122,588
Bureau,Small Business Administration,Small Business Administration,null,90.6429037642903,93.29725120297938,965322939,7703,9351156818,107220,31,12,4,2015,2015-12-31,1,2016,10316479757,114923
Bureau,Department of the Treasury,Comptroller of the Currency,null,96.62141078379086,57.57575757575758,39087,14,1117816,19,31,12,4,2015,2015-12-31,1,2016,1156903,33
Bureau,Department of Transportation,National Highway Traffic Safety Admin.,null,17.919825527053693,8.333333333333334,15807,11,3451,1,31,12,4,2015,2015-12-31,1,2016,19258,12
Bureau,Department of Justice,Drug Enforcement Administration,null,100.0,100.0,0,0,278617,16,31,12,4,2015,2015-12-31,1,2016,278617,16
Agency,Legislative Branch-GPO,null,Non-CFO,0.0,0.0,747847,95,0,0,31,12,4,2015,2015-12-31,1,2016,747847,95
Bureau,Department of Agriculture,Rural Development,null,99.97769528559022,99.94972347913524,109632,16,491409775,31808,31,12,4,2015,2015-12-31,1,2016,491519407,31824
Bureau,Other Agencies,Appalachian Regional Commission,null,0.0,0.0,0,0,0,0,31,12,4,2015,2015-12-31,1,2016,0,0
Bureau,Department of Commerce,International Trade Administration,null,0.0,0.0,0,0,0,0,31,12,4,2015,2015-12-31,1,2016,0,0
Bureau,Department of Commerce,Economic and Statistical Analysis,null,0.0,0.0,0,0,0,0,31,12,4,2015,2015-12-31,1,2016,0,0
Bureau,Department of Health & Human Services,Office of the Secretary,null,100.0,100.0,0,0,128,1,31,12,4,2015,2015-12-31,1,2016,128,1
Bureau,Department of Commerce,Bureau of Industry and Security,null,0.0,0.0,41450,1,0,0,31,12,4,2015,2015-12-31,1,2016,41450,1
Bureau,Department of Justice,General Administration,null,0.0,0.0,0,0,0,0,31,12,4,2015,2015-12-31,1,2016,0,0
Bureau,Smithsonian Institution,National Gallery of Art,null,0.0,0.0,0,0,0,0,31,12,4,2015,2015-12-31,1,2016,0,0
Bureau,Federal Labor Relations Authority,Federal Labor Relations Authority,null,0.0,0.0,0,0,0,0,31,12,4,2015,2015-12-31,1,2016,0,0
Bureau,Department of Commerce,Minority Business Development Agency,null,0.0,0.0,0,0,0,0,31,12,4,2015,2015-12-31,1,2016,0,0
Bureau,American Battle Monuments Commission,American Battle Monuments Commission,null,0.0,0.0,0,0,0,0,31,12,4,2015,2015-12-31,1,2016,0,0
Agency,Farm Credit Administration,null,Non-CFO,0.0,0.0,0,0,0,0,31,12,4,2015,2015-12-31,1,2016,0,0
Bureau,Pension Benefit Guaranty Corp,Pension Benefit Guaranty Corporation,null,32.58793383775786,33.2541567695962,1953661,562,944427,280,31,12,4,2015,2015-12-31,1,2016,2898088,842
Bureau,Department of Health & Human Services,Administration for Children and Families,null,100.0,100.0,0,0,18131820,1074,31,12,4,2015,2015-12-31,1,2016,18131820,1074
Bureau,Department of Agriculture,Farm Service Agency,null,99.99276848407635,99.99117932433624,36511,1,504850713,11336,31,12,4,2015,2015-12-31,1,2016,504887224,11337
Bureau,Other Agencies,Advisory Council on Hist. Preservation,null,0.0,0.0,0,0,0,0,31,12,4,2015,2015-12-31,1,2016,0,0
Bureau,Federal Election Commission,Federal Election Commission,null,99.91161904272175,97.61904761904762,275,1,310878,41,31,12,4,2015,2015-12-31,1,2016,311153,42
Bureau,Department of the Treasury,Interest on Public Debt,null,100.0,100.0,0,0,8934424,4293,31,12,4,2015,2015-12-31,1,2016,8934424,4293
Bureau,Department of Homeland Security,Office of Biometric Identity Management,null,0.0,0.0,0,0,0,0,31,12,4,2015,2015-12-31,1,2016,0,0
Bureau,Armed Forces Retirement Home,Armed Forces Retirement Home,null,63.43681431705979,75.78125,42659,31,74013,97,31,12,4,2015,2015-12-31,1,2016,116672,128
Bureau,Department of Commerce,General Administration,null,0.0,0.0,0,0,0,0,31,12,4,2015,2015-12-31,1,2016,0,0
Bureau,Other Agencies,Defense Nuclear Facilities Safety Board,null,0.0,0.0,0,0,0,0,31,12,4,2015,2015-12-31,1,2016,0,0
Agency,The Judiciary,null,Non-CFO,36.68784496069001,26.285714285714285,570792,129,330760,46,31,12,4,2015,2015-12-31,1,2016,901552,175
Bureau,Department of the Treasury,Internal Revenue Service,null,97.14726412545629,97.29729729729729,9081,4,309245,144,31,12,4,2015,2015-12-31,1,2016,318326,148
Bureau,Department of Veterans Affairs,Medical and Construction,null,7.69677819527144,0.3323906599219954,543149143,9912768,45290927,33059,31,12,4,2015,2015-12-31,1,2016,588440070,9945827
Bureau,Legislative Branch - U.S. House/Senate,U.S. House of Representatives,null,0.0,0.0,232611,206,0,0,31,12,4,2015,2015-12-31,1,2016,232611,206
Bureau,Department of Homeland Security,Transportation Safety Administration,null,0.0,0.0,10016077,6587,0,0,31,12,4,2015,2015-12-31,1,2016,10016077,6587
Bureau,Department of Housing and Urban Development,Government National Mortgage Association,null,0.0,0.0,0,0,0,0,31,12,4,2015,2015-12-31,1,2016,0,0
Bureau,Office of Compliance,Office of Compliance,null,0.0,0.0,0,0,0,0,31,12,4,2015,2015-12-31,1,2016,0,0
Bureau,U.S. Court of Appeals / Veterans Claims,U.S. Court of Appeals / Veterans Claims,null,0.0,0.0,0,0,0,0,31,12,4,2015,2015-12-31,1,2016,0,0
Bureau,Department of the Interior,Office of the Secretary,null,100.0,100.0,0,0,72918,26,31,12,4,2015,2015-12-31,1,2016,72918,26
Bureau,Department of Agriculture,Federal Crop Insurance Corporation,null,100.0,100.0,0,0,131236,334,31,12,4,2015,2015-12-31,1,2016,131236,334
Bureau,Department of Housing and Urban Development,Community Planning and Development,null,0.0,0.0,274383,9,0,0,31,12,4,2015,2015-12-31,1,2016,274383,9
Bureau,Department of Health & Human Services,Centers for Medicare & Medicaid Services,null,63.013593152008085,52.96509620400097,4093942233,1152405,6974832979,1297701,31,12,4,2015,2015-12-31,1,2016,11068775212,2450106
Bureau,Legislative Branch-CBO,Congressional Budget Office,null,0.0,0.0,0,0,0,0,31,12,4,2015,2015-12-31,1,2016,0,0
Bureau,National Credit Union Administration,National Credit Union Administration,null,0.0,0.0,0,0,0,0,31,12,4,2015,2015-12-31,1,2016,0,0
Agency,Department of Health & Human Services,null,CFO,62.88316602420643,52.92870354992396,4191149602,1156361,7100625997,1300255,31,12,4,2015,2015-12-31,1,2016,11291775599,2456616
Agency,Department of Education,null,CFO,62.18186154408149,50.595681653428784,42587924491,10727130,70024504967,10985810,31,12,4,2015,2015-12-31,1,2016,112612429458,21712940
Agency,Environmental Protection Agency,null,CFO,99.11077489797806,98.55072463768116,132782,3,14799545,204,31,12,4,2015,2015-12-31,1,2016,14932327,207
Agency,Department of the Interior,null,CFO,98.06525496295218,83.95305003427005,761418,3746,38593535,19598,31,12,4,2015,2015-12-31,1,2016,39354953,23344
Agency,Department of Transportation,null,CFO,92.10593076466323,91.11010830324909,3582491,591,41799566,6057,31,12,4,2015,2015-12-31,1,2016,45382057,6648
Agency,Office of Personnel Management,null,CFO,0.0,0.0,68733455,318,0,0,31,12,4,2015,2015-12-31,1,2016,68733455,318
Agency,Department of Labor,null,CFO,57.92288813509888,70.94239017039527,73806795,12534,101601620,30601,31,12,4,2015,2015-12-31,1,2016,175408415,43135
Agency,Department of Agriculture,null,CFO,91.35038574164965,83.96847734309034,106455725,11392,1124301183,59668,31,12,4,2015,2015-12-31,1,2016,1230756908,71060
Agency,Department of Veterans Affairs,null,CFO,53.45941261332198,1.6749368030204097,589884027,9918937,677577473,168966,31,12,4,2015,2015-12-31,1,2016,1267461500,10087903
Agency,Social Security Administration,null,CFO,53.34080341754686,53.36429056509358,1151849546,626284,1316794645,716644,31,12,4,2015,2015-12-31,1,2016,2468644191,1342928
Bureau,Department of Health & Human Services,Centers for Disease Control,null,10.325878205445122,22.916666666666668,235799,37,27152,11,31,12,4,2015,2015-12-31,1,2016,262951,48
Bureau,Department of Health & Human Services,Indian Health Services,null,32.918914835916304,8.351648351648352,31047034,1251,15235810,114,31,12,4,2015,2015-12-31,1,2016,46282844,1365
Agency,National Aeronautics and Space Administration,null,CFO,100.0,100.0,0,0,485786,75,31,12,4,2015,2015-12-31,1,2016,485786,75
Agency,Nuclear Regulatory Commission,null,CFO,100.0,100.0,0,0,982669,178,31,12,4,2015,2015-12-31,1,2016,982669,178
Agency,Department of Commerce,null,CFO,97.85636544864461,83.8737949167397,141790,184,6472677,957,31,12,4,2015,2015-12-31,1,2016,6614467,1141
Agency,General Services Administration,null,CFO,82.60108890530049,89.43854324734446,1911586,348,9075228,2947,31,12,4,2015,2015-12-31,1,2016,10986814,3295
Agency,Department of State,null,CFO,91.92758927838031,97.54220193226458,1108548,463,12624004,18375,31,12,4,2015,2015-12-31,1,2016,13732552,18838
Bureau,Department of the Interior,Bureau of Safety and Environmental Enf.,null,100.0,100.0,0,0,6145,4,31,12,4,2015,2015-12-31,1,2016,6145,4
Bureau,Other Agencies,Federal Housing Finance Agency,null,100.0,100.0,0,0,7151,2,31,12,4,2015,2015-12-31,1,2016,7151,2
Bureau,Other Agencies,U.S. Inst. for Env. Conflict Resolution,null,0.0,0.0,8023,4,0,0,31,12,4,2015,2015-12-31,1,2016,8023,4
Bureau,Department of Transportation,Maritime Administration,null,100.0,100.0,0,0,9221,7,31,12,4,2015,2015-12-31,1,2016,9221,7
Bureau,National Archives & Records Admin,Nat'l Archives & Records Administration,null,88.40022505626406,76.47058823529412,2474,24,18854,78,31,12,4,2015,2015-12-31,1,2016,21328,102
Bureau,Department of Commerce,Patent and Trademark Office,null,49.37618266188237,32.83018867924528,64475,178,62886,87,31,12,4,2015,2015-12-31,1,2016,127361,265
Bureau,Department of the Interior,Bureau of Reclamation,null,100.0,100.0,0,0,151795,84,31,12,4,2015,2015-12-31,1,2016,151795,84
Bureau,Other Agencies,James Madison Memorial Fellowship,null,0.0,0.0,219210,20,0,0,31,12,4,2015,2015-12-31,1,2016,219210,20
Bureau,Department of Veterans Affairs,Housing Credit Assistance,null,16.460644612279417,4.97737556561086,15506921,420,3055493,22,31,12,4,2015,2015-12-31,1,2016,18562414,442
Bureau,Department of Homeland Security,Info Analysis Infrastructure Prot-NPPD,null,100.0,100.0,0,0,4610,1,31,12,4,2015,2015-12-31,1,2016,4610,1
Bureau,Department of Transportation,Research Innovative Technology Admin,null,94.1839762611276,66.66666666666667,294,1,4761,2,31,12,4,2015,2015-12-31,1,2016,5055,3
Bureau,Department of the Interior,"Bureau of Ocean Energy Mgmt., Reg & Enf",null,100.0,100.0,0,0,5141,1,31,12,4,2015,2015-12-31,1,2016,5141,1
Bureau,Export - Import  Bank,Export-Import Bank,null,0.0,0.0,0,0,0,0,31,12,4,2015,2015-12-31,1,2016,0,0
Bureau,Department of State,Civil Monetary Penalties,null,0.0,0.0,0,0,0,0,31,12,4,2015,2015-12-31,1,2016,0,0
Agency,National Labor Relations Board,null,Non-CFO,0.0,0.0,0,0,0,0,31,12,4,2015,2015-12-31,1,2016,0,0
Agency,Federal Mediation/Conciliation Service,null,Non-CFO,0.0,0.0,0,0,0,0,31,12,4,2015,2015-12-31,1,2016,0,0
Agency,Department of Homeland Security,null,CFO,83.84455472711267,80.46862154014799,64440717,14254,334438521,58726,31,12,4,2015,2015-12-31,1,2016,398879238,72980
Bureau,Federal Communications Commission,Federal Communications Commission,null,72.79901032911789,83.12081401339516,56167230,2621,150322426,12907,31,12,4,2015,2015-12-31,1,2016,206489656,15528
Bureau,Department of Veterans Affairs,Veterans Benefits,null,95.51467976016507,96.39260910937212,29528528,5080,628808590,135742,31,12,4,2015,2015-12-31,1,2016,658337118,140822
Bureau,Department of Health & Human Services,Office of the Inspector General,null,0.0,0.0,0,0,0,0,31,12,4,2015,2015-12-31,1,2016,0,0
Bureau,Department of Agriculture,Forest Service,null,7.558250525183318,3.826903023983316,81210773,9223,6639980,367,31,12,4,2015,2015-12-31,1,2016,87850753,9590
Bureau,Department of Housing and Urban Development,Housing Programs,null,98.60808516611345,99.28825622775801,1553187,36,110033166,5022,31,12,4,2015,2015-12-31,1,2016,111586353,5058
Agency,Corp. for National and Community Service,null,Non-CFO,99.19435427787126,88.3177570093458,21953,25,2702942,189,31,12,4,2015,2015-12-31,1,2016,2724895,214
Agency,Pension Benefit Guaranty Corp,null,Non-CFO,32.58793383775786,33.2541567695962,1953661,562,944427,280,31,12,4,2015,2015-12-31,1,2016,2898088,842
Bureau,Funds Appropriated to the President,Peace Corps,null,0.0,0.0,0,0,0,0,31,12,4,2015,2015-12-31,1,2016,0,0
Agency,Railroad Retirement Board,null,Non-CFO,99.99998916971927,100.0,1,0,9233370,1284,31,12,4,2015,2015-12-31,1,2016,9233371,1284
Bureau,National Labor Relations Board,National Labor Relations Board,null,0.0,0.0,0,0,0,0,31,12,4,2015,2015-12-31,1,2016,0,0
Bureau,Department of Education,Office of Postsecondary Education,null,0.0,0.0,0,0,0,0,31,12,4,2015,2015-12-31,1,2016,0,0
Bureau,Department of the Treasury,Bureau of Engraving and Printing,null,0.0,0.0,0,0,0,0,31,12,4,2015,2015-12-31,1,2016,0,0
Agency,U.S. Court of Appeals / Veterans Claims,null,Non-CFO,0.0,0.0,0,0,0,0,31,12,4,2015,2015-12-31,1,2016,0,0
Agency,Consumer Product Safety Commission,null,Non-CFO,80.60606060606061,50.0,96,1,399,1,31,12,4,2015,2015-12-31,1,2016,495,2
Agency,National Archives & Records Admin,null,Non-CFO,88.40022505626406,76.47058823529412,2474,24,18854,78,31,12,4,2015,2015-12-31,1,2016,21328,102
Agency,Armed Forces Retirement Home,null,Non-CFO,63.43681431705979,75.78125,42659,31,74013,97,31,12,4,2015,2015-12-31,1,2016,116672,128
Agency,Other Agencies/Boards/Commissions,null,Non-CFO,0.0,0.0,143417,9,0,0,31,12,4,2015,2015-12-31,1,2016,143417,9
Agency,Department of Justice,null,CFO,99.16284298913165,97.88416190199308,580480,655,68758962,30302,31,12,4,2015,2015-12-31,1,2016,69339442,30957
Bureau,Department of Transportation,Federal Transit Administration,null,70.08445624150676,60.0,353328,2,827757,3,31,12,4,2015,2015-12-31,1,2016,1181085,5
Bureau,Department of Justice,Federal Prison Industries,null,76.92016394388962,71.484375,299859,73,999366,183,31,12,4,2015,2015-12-31,1,2016,1299225,256
Bureau,Department of Veterans Affairs,Administration and Cemeteries,null,3.8550546436916107,10.962566844919786,1293312,666,51857,82,31,12,4,2015,2015-12-31,1,2016,1345169,748
Bureau,Presidio Trust Corporation,Presidio Trust Corporation,null,86.14329293137826,94.18604651162791,204045,20,1268491,324,31,12,4,2015,2015-12-31,1,2016,1472536,344
Bureau,Department of Health & Human Services,National Institutes of Health,null,39.79417401261541,16.09442060085837,6650061,391,4395483,75,31,12,4,2015,2015-12-31,1,2016,11045544,466
Bureau,Department of the Interior,Bureau of Land Management,null,100.0,100.0,0,0,11085618,256,31,12,4,2015,2015-12-31,1,2016,11085618,256
Bureau,Department of the Interior,Office of Natural Resources Revenue,null,100.0,100.0,0,0,11512825,132,31,12,4,2015,2015-12-31,1,2016,11512825,132
Bureau,Department of State,Department of State,null,90.45762672471898,90.9411074153786,1108548,463,10508562,4648,31,12,4,2015,2015-12-31,1,2016,11617110,5111
Bureau,Department of Agriculture,U.S. Department of Agriculture,null,46.568118256832,62.772861356932154,10179132,1262,8871539,2128,31,12,4,2015,2015-12-31,1,2016,19050671,3390
Bureau,Department of Health & Human Services,Food and Drug Administration,null,27.532339568260323,18.852459016393443,59274475,2277,22519907,529,31,12,4,2015,2015-12-31,1,2016,81794382,2806
Bureau,National Aeronautics and Space Administration,National Aeronautics and Space Admin,null,100.0,100.0,0,0,485786,75,31,12,4,2015,2015-12-31,1,2016,485786,75
Bureau,Department of Health & Human Services,Substance Abuse & Mental Health Admin.,null,100.0,100.0,0,0,597405,12,31,12,4,2015,2015-12-31,1,2016,597405,12
Bureau,Department of Commerce,Nat'l Institute of Standards& Technology,null,96.53482948056741,81.48148148148148,35865,5,999149,22,31,12,4,2015,2015-12-31,1,2016,1035014,27
Bureau,Department of Justice,Bureau of ATF and Explosives,null,90.4344754503709,33.333333333333336,4062,8,38403,4,31,12,4,2015,2015-12-31,1,2016,42465,12
Bureau,National Science Foundation,National Science Foundation,null,100.0,100.0,0,0,255868,14,31,12,4,2015,2015-12-31,1,2016,255868,14
Bureau,Farm Credit Administration,Farm Credit System Insurance Corporation,null,0.0,0.0,0,0,0,0,31,12,4,2015,2015-12-31,1,2016,0,0
Bureau,Smithsonian Institution,Administrative Conference of the US,null,0.0,0.0,0,0,0,0,31,12,4,2015,2015-12-31,1,2016,0,0
Bureau,Other Agencies,Comm. to Elim Child Abuse & Neg. Fatal,null,0.0,0.0,0,0,0,0,31,12,4,2015,2015-12-31,1,2016,0,0
Bureau,Farm Credit Administration,Farm Credit Administration,null,0.0,0.0,0,0,0,0,31,12,4,2015,2015-12-31,1,2016,0,0
Bureau,Department of Commerce,Economic Development Administration,null,0.0,0.0,0,0,0,0,31,12,4,2015,2015-12-31,1,2016,0,0
Bureau,Other Agencies,National Transportation Safety Board,null,0.0,0.0,0,0,0,0,31,12,4,2015,2015-12-31,1,2016,0,0
Bureau,Department of State,Passport NSF,null,100.0,100.0,0,0,2115442,13727,31,12,4,2015,2015-12-31,1,2016,2115442,13727
Agency,Federal Maritime Commission,null,Non-CFO,0.0,0.0,2196,18,0,0,31,12,4,2015,2015-12-31,1,2016,2196,18
Bureau,Other Agencies,John C. Stennis,null,0.0,0.0,0,0,0,0,31,12,4,2015,2015-12-31,1,2016,0,0
Bureau,Other Agencies,Northern Border Regional Commission,null,0.0,0.0,0,0,0,0,31,12,4,2015,2015-12-31,1,2016,0,0
Bureau,Department of Transportation,Federal Railroad Administration,null,61.96171731372337,64.28571428571429,52761,5,85944,9,31,12,4,2015,2015-12-31,1,2016,138705,14
Agency,Small Business Administration,null,CFO,90.6429037642903,93.29725120297938,965322939,7703,9351156818,107220,31,12,4,2015,2015-12-31,1,2016,10316479757,114923
Agency,Agency for International Development,null,CFO,85.35966188984898,37.254901960784316,2793090,32,16284953,19,31,12,4,2015,2015-12-31,1,2016,19078043,51
Agency,Department of the Treasury,null,CFO,97.82513953571096,86.44767249917464,725746,821,32644027,5237,31,12,4,2015,2015-12-31,1,2016,33369773,6058
Bureau,Department of Transportation,Office of the Inspector General,null,100.0,100.0,0,0,6557,30,31,12,4,2015,2015-12-31,1,2016,6557,30
Bureau,Department of the Treasury,U.S. Mint,null,3.0839490183881204,0.379746835443038,570224,787,18145,3,31,12,4,2015,2015-12-31,1,2016,588369,790
Agency,Legislative Branch-CBO,null,Non-CFO,0.0,0.0,0,0,0,0,31,12,4,2015,2015-12-31,1,2016,0,0
Bureau,Department of Labor,Mine Safety and Health Administration,null,95.23103619193398,89.32120599629442,3017760,1902,60261395,15909,31,12,4,2015,2015-12-31,1,2016,63279155,17811
Bureau,Department of the Treasury,Interest on Tax/Deposit of Earnings,null,100.0,100.0,0,0,3240,2,31,12,4,2015,2015-12-31,1,2016,3240,2
Bureau,Department of Justice,Federal Bureau of Investigation,null,0.0,0.0,228247,529,0,0,31,12,4,2015,2015-12-31,1,2016,228247,529
Bureau,Department of the Treasury,Treasury IG for Tax Admin,null,0.0,0.0,0,0,0,0,31,12,4,2015,2015-12-31,1,2016,0,0
Agency,Selective Service System,null,Non-CFO,0.0,0.0,2314,3,0,0,31,12,4,2015,2015-12-31,1,2016,2314,3
Agency,National Science Foundation,null,CFO,100.0,100.0,0,0,255868,14,31,12,4,2015,2015-12-31,1,2016,255868,14
Bureau,Other Agencies,National Council on Disability,null,0.0,0.0,229,2,0,0,31,12,4,2015,2015-12-31,1,2016,229,2
Bureau,Department of Justice,Federal Prison System,null,100.0,100.0,0,0,1195821,70,31,12,4,2015,2015-12-31,1,2016,1195821,70
Bureau,Other Agencies,Architect of the Capitol,null,0.0,0.0,0,0,0,0,31,12,4,2015,2015-12-31,1,2016,0,0
Bureau,National Foundation  Arts & Humanities,National Endowment for the Humanities,null,0.0,0.0,0,0,0,0,31,12,4,2015,2015-12-31,1,2016,0,0
Bureau,Department of Housing and Urban Development,Public and Indian Housing Programs,null,0.0,0.0,0,0,0,0,31,12,4,2015,2015-12-31,1,2016,0,0
Agency,Overseas Private Investment Corp Accts,null,Non-CFO,0.0,0.0,0,0,0,0,31,12,4,2015,2015-12-31,1,2016,0,0
Bureau,Department of Commerce,Bureau of the Census,null,100.0,100.0,0,0,51893,122,31,12,4,2015,2015-12-31,1,2016,51893,122
Agency,Department of Energy,null,CFO,99.99331884299411,98.9010989010989,768,1,11494247,90,31,12,4,2015,2015-12-31,1,2016,11495015,91
Bureau,Other Agencies/Boards/Commissions,U.S. Comm. on Int. Religious Freedom,null,0.0,0.0,141646,4,0,0,31,12,4,2015,2015-12-31,1,2016,141646,4
Bureau,Department of Transportation,Pipeline Hazardous Material Safety Admin,null,99.99973520525565,100.0,1,0,377650,27,31,12,4,2015,2015-12-31,1,2016,377651,27
Bureau,Equal Employment Opportunity Commission,Equal Employment Opportunity Commission,null,0.0,0.0,380681,58,0,0,31,12,4,2015,2015-12-31,1,2016,380681,58
Agency,Tennessee Valley Authority,null,Non-CFO,0.0,0.0,0,0,0,0,31,12,4,2015,2015-12-31,1,2016,0,0
Bureau,Railroad Retirement Board,Railroad Retirement Board,null,99.99998916971927,100.0,1,0,9233370,1284,31,12,4,2015,2015-12-31,1,2016,9233371,1284
Bureau,Department of Education,Departmental Management,null,51.106515557415214,30.889679715302492,458287232,2913,479030362,1302,31,12,4,2015,2015-12-31,1,2016,937317594,4215
Agency,Presidio Trust Corporation,null,Non-CFO,86.14329293137826,94.18604651162791,204045,20,1268491,324,31,12,4,2015,2015-12-31,1,2016,1472536,344
Bureau,Office of Special Counsel,Office of Special Counsel,null,0.0,0.0,0,0,0,0,31,12,4,2015,2015-12-31,1,2016,0,0
Agency,Department of Defense,null,CFO,40.52645520156609,51.863068771799036,1535205375,289276,1046119448,311668,31,12,4,2015,2015-12-31,1,2016,2581324823,600944
Bureau,Department of Justice,Legal Activities,null,99.93123433495397,99.86027014438751,44880,42,65220249,30016,31,12,4,2015,2015-12-31,1,2016,65265129,30058
Bureau,Department of Agriculture,Commodity Credit Corporation,null,99.93288261119605,99.89371269724471,74646,13,111142434,12218,31,12,4,2015,2015-12-31,1,2016,111217080,12231
Bureau,Department of Homeland Security,Office of the Inspector General DHS,null,0.0,0.0,0,0,0,0,31,12,4,2015,2015-12-31,1,2016,0,0
Bureau,Other Agencies,Denali Commission,null,0.0,0.0,611,1,0,0,31,12,4,2015,2015-12-31,1,2016,611,1
Bureau,Department of Homeland Security,U.S. Coast Guard,null,100.0,100.0,0,0,47271862,7378,31,12,4,2015,2015-12-31,1,2016,47271862,7378
Bureau,Office of Personnel Management,Office of Personnel Management,null,0.0,0.0,68733455,318,0,0,31,12,4,2015,2015-12-31,1,2016,68733455,318
Agency,Merit Systems Protection Board,null,Non-CFO,0.0,0.0,0,0,0,0,31,12,4,2015,2015-12-31,1,2016,0,0
Agency,Legislative Branch-Office of Tech.,null,Non-CFO,0.0,0.0,0,0,0,0,31,12,4,2015,2015-12-31,1,2016,0,0
Agency,Neighborhood Reinvestment Corporation,null,Non-CFO,0.0,0.0,0,0,0,0,31,12,4,2015,2015-12-31,1,2016,0,0
Agency,Funds Appropriated to the President,null,Non-CFO,0.0,0.0,0,0,0,0,31,12,4,2015,2015-12-31,1,2016,0,0
Agency,Legislative Branch-GAO,null,Non-CFO,0.0,0.0,0,0,0,0,31,12,4,2015,2015-12-31,1,2016,0,0
Bureau,Department of Commerce,International Trade Administration,null,0.0,0.0,0,0,0,0,31,03,1,2016,2016-03-31,2,2016,0,0
Bureau,National Credit Union Administration,National Credit Union Administration,null,0.0,0.0,0,0,0,0,31,03,1,2016,2016-03-31,2,2016,0,0
Bureau,Occupational Safety & Health Rev Comm,Occupational Safety & Health Rev Comm,null,0.0,0.0,0,0,0,0,31,03,1,2016,2016-03-31,2,2016,0,0
Bureau,Department of Homeland Security,Office of Health Affairs,null,0.0,0.0,0,0,0,0,31,03,1,2016,2016-03-31,2,2016,0,0
Bureau,Department of Education,Office of Postsecondary Education,null,0.0,0.0,0,0,0,0,31,03,1,2016,2016-03-31,2,2016,0,0
Bureau,Other Agencies,Federal Housing Finance Agency OIG,null,0.0,0.0,0,0,0,0,31,03,1,2016,2016-03-31,2,2016,0,0
Bureau,National Foundation  Arts & Humanities,National Endowment for the Arts,null,0.0,0.0,0,0,0,0,31,03,1,2016,2016-03-31,2,2016,0,0
Bureau,Office of Government Ethics,Office of Government Ethics,null,0.0,0.0,0,0,0,0,31,03,1,2016,2016-03-31,2,2016,0,0
Bureau,Federal Mediation/Conciliation Service,Federal Mediation/Conciliation Service,null,0.0,0.0,0,0,0,0,31,03,1,2016,2016-03-31,2,2016,0,0
Bureau,American Battle Monuments Commission,American Battle Monuments Commission,null,0.0,0.0,0,0,0,0,31,03,1,2016,2016-03-31,2,2016,0,0
Bureau,Department of Health & Human Services,Office of the Inspector General,null,0.0,0.0,0,0,0,0,31,03,1,2016,2016-03-31,2,2016,0,0
Bureau,Department of Commerce,Nat'l Telecomm & Information Admin.,null,0.0,0.0,0,0,0,0,31,03,1,2016,2016-03-31,2,2016,0,0
Bureau,Office of Personnel Management,Office of Personnel Management,null,0.0,0.0,62293582,307,0,0,31,03,1,2016,2016-03-31,2,2016,62293582,307
Agency,Office of Special Counsel,null,Non-CFO,0.0,0.0,3366,13,0,0,31,03,1,2016,2016-03-31,2,2016,3366,13
Agency,Legislative Branch-GPO,null,Non-CFO,8.544096488501388,29.12621359223301,903256,73,84385,30,31,03,1,2016,2016-03-31,2,2016,987641,103
Bureau,Department of Commerce,Minority Business Development Agency,null,0.0,0.0,0,0,0,0,31,03,1,2016,2016-03-31,2,2016,0,0
Agency,National Archives & Records Admin,null,Non-CFO,82.29707937645583,70.79646017699115,4940,33,22965,80,31,03,1,2016,2016-03-31,2,2016,27905,113
Bureau,Department of the Treasury,Bureau of Engraving and Printing,null,0.0,0.0,0,0,0,0,31,03,1,2016,2016-03-31,2,2016,0,0
Bureau,Department of Veterans Affairs,Veterans Benefits,null,95.81881372927747,97.84990534482928,25221875,2192,578001071,99757,31,03,1,2016,2016-03-31,2,2016,603222946,101949
Bureau,Department of Housing and Urban Development,Community Planning and Development,null,0.0,0.0,0,0,0,0,31,03,1,2016,2016-03-31,2,2016,0,0
Bureau,Department of the Treasury,Office of Financial Research,null,0.0,0.0,36,1,0,0,31,03,1,2016,2016-03-31,2,2016,36,1
Bureau,U.S. Court of Appeals / Veterans Claims,U.S. Court of Appeals / Veterans Claims,null,0.0,0.0,40,1,0,0,31,03,1,2016,2016-03-31,2,2016,40,1
Bureau,Other Agencies,Federal Housing Finance Agency,null,100.0,100.0,0,0,7151,2,31,03,1,2016,2016-03-31,2,2016,7151,2
Bureau,Other Agencies,U.S.  Agency of Global Media,null,0.0,0.0,13356,3,0,0,31,03,1,2016,2016-03-31,2,2016,13356,3
Bureau,Department of Transportation,Federal Highway Administration,null,38.261330341001184,69.23076923076923,19807,4,12275,9,31,03,1,2016,2016-03-31,2,2016,32082,13
Bureau,Armed Forces Retirement Home,Armed Forces Retirement Home,null,51.50248423466463,69.42148760330579,60909,37,64683,84,31,03,1,2016,2016-03-31,2,2016,125592,121
Bureau,Department of Agriculture,Agricultural Marketing Service,null,56.21355853981601,67.56756756756756,240987,96,309382,200,31,03,1,2016,2016-03-31,2,2016,550369,296
Bureau,Department of Justice,Federal Prison System,null,100.0,49.27536231884058,0,35,636663,34,31,03,1,2016,2016-03-31,2,2016,636663,69
Bureau,Department of Veterans Affairs,Life Insurance,null,54.16447707300322,98.55072463768116,352378,1,416410,68,31,03,1,2016,2016-03-31,2,2016,768788,69
Bureau,Corp. for National and Community Service,Corp. for National and Community Service,null,97.50674889998372,88.15165876777252,76740,25,3001169,186,31,03,1,2016,2016-03-31,2,2016,3077909,211
Bureau,Department of Health & Human Services,Program Support Center,null,100.0,100.0,0,0,3128222,337,31,03,1,2016,2016-03-31,2,2016,3128222,337
Bureau,Department of the Treasury,Interest on Public Debt,null,100.0,100.0,0,0,9043595,4238,31,03,1,2016,2016-03-31,2,2016,9043595,4238
Bureau,Department of Agriculture,Forest Service,null,23.384444444186656,3.4958601655933763,158508458,11539,48379630,418,31,03,1,2016,2016-03-31,2,2016,206888088,11957
Bureau,Department of Agriculture,Federal Crop Insurance Corporation,null,99.95755163918894,99.70414201183432,56,1,131869,337,31,03,1,2016,2016-03-31,2,2016,131925,338
Bureau,The Judiciary,Administrative Office of the U.S. Courts,null,38.47721256984945,28.8135593220339,554348,126,346697,51,31,03,1,2016,2016-03-31,2,2016,901045,177
Bureau,Department of Homeland Security,Citizenship and Immigration Services,null,100.0,100.0,0,0,914278,1122,31,03,1,2016,2016-03-31,2,2016,914278,1122
Bureau,Department of Justice,General Administration,null,0.0,0.0,0,0,0,0,31,03,1,2016,2016-03-31,2,2016,0,0
Bureau,Federal Maritime Commission,Salaries and Expenses,null,0.0,0.0,2229,18,0,0,31,03,1,2016,2016-03-31,2,2016,2229,18
Bureau,Legislative Branch - U.S. House/Senate,U.S. House of Representatives,null,0.0,0.0,259515,268,0,0,31,03,1,2016,2016-03-31,2,2016,259515,268
Bureau,Federal Communications Commission,Federal Communications Commission,null,70.46224935035944,75.7560035576638,77503224,3271,184883797,10221,31,03,1,2016,2016-03-31,2,2016,262387021,13492
Bureau,Department of Homeland Security,U.S. Secret Service,null,0.0,0.0,35652,6,0,0,31,03,1,2016,2016-03-31,2,2016,35652,6
Bureau,Department of Transportation,Office of the Inspector General,null,100.0,100.0,0,0,7430,31,31,03,1,2016,2016-03-31,2,2016,7430,31
Bureau,Department of the Treasury,U.S. Mint,null,100.0,100.0,0,0,36059,6,31,03,1,2016,2016-03-31,2,2016,36059,6
Bureau,General Services Administration,General Services Administration,null,66.94225243469171,46.65605095541401,4403449,3350,8917026,2930,31,03,1,2016,2016-03-31,2,2016,13320475,6280
Agency,Presidio Trust Corporation,null,Non-CFO,88.53123920700608,78.0952380952381,165701,92,1279102,328,31,03,1,2016,2016-03-31,2,2016,1444803,420
Bureau,Department of Health & Human Services,Health Resources and Services Admin,null,100.0,100.0,0,0,64617120,414,31,03,1,2016,2016-03-31,2,2016,64617120,414
Bureau,Funds Appropriated to the President,African Development Foundation,null,0.0,0.0,0,0,0,0,31,03,1,2016,2016-03-31,2,2016,0,0
Bureau,Other Agencies,National Mediation Board,null,0.0,0.0,0,0,0,0,31,03,1,2016,2016-03-31,2,2016,0,0
Bureau,Other Agencies,Appraisal Subcommittee,null,0.0,0.0,0,0,0,0,31,03,1,2016,2016-03-31,2,2016,0,0
Agency,Corp. for National and Community Service,null,Non-CFO,97.50674889998372,88.15165876777252,76740,25,3001169,186,31,03,1,2016,2016-03-31,2,2016,3077909,211
Bureau,Other Agencies,Election Assistance Commission,null,0.0,0.0,0,0,0,0,31,03,1,2016,2016-03-31,2,2016,0,0
Bureau,Department of Commerce,National Technical Information Service,null,0.0,0.0,16377,30,0,0,31,03,1,2016,2016-03-31,2,2016,16377,30
Bureau,Department of the Treasury,Treasury Forfeiture Fund,null,0.0,0.0,0,0,0,0,31,03,1,2016,2016-03-31,2,2016,0,0
Bureau,Department of Justice,Legal Activities,null,99.68997018954101,99.60739030023095,203303,119,65372004,30191,31,03,1,2016,2016-03-31,2,2016,65575307,30310
Bureau,Department of Veterans Affairs,Medical and Construction,null,63.660862194750564,98.42713221575836,98547832,116459,172641409,7287787,31,03,1,2016,2016-03-31,2,2016,271189241,7404246
Bureau,Other Agencies,U.S. Inst. for Env. Conflict Resolution,null,0.0,0.0,8023,4,0,0,31,03,1,2016,2016-03-31,2,2016,8023,4
Bureau,Department of Labor,Mine Safety and Health Administration,null,88.10208374998258,84.21839940164547,8062365,2954,59700467,15764,31,03,1,2016,2016-03-31,2,2016,67762832,18718
Agency,Other Agencies/Boards/Commissions,null,Non-CFO,0.0,0.0,30702,7,0,0,31,03,1,2016,2016-03-31,2,2016,30702,7
Bureau,Department of Homeland Security,Bureau of Customs & Border Protection,null,98.92082148193283,83.27868852459017,72669,102,6661064,508,31,03,1,2016,2016-03-31,2,2016,6733733,610
Bureau,Neighborhood Reinvestment Corporation,Neighborhood Reinvestment Corporation,null,0.0,0.0,0,0,0,0,31,03,1,2016,2016-03-31,2,2016,0,0
Bureau,Other Agencies,Chemical Safety Board,null,0.0,0.0,0,0,0,0,31,03,1,2016,2016-03-31,2,2016,0,0
Bureau,Other Agencies,Appalachian Regional Commission,null,0.0,0.0,0,0,0,0,31,03,1,2016,2016-03-31,2,2016,0,0
Bureau,Department of Education,Departmental Management,null,45.58487435041758,29.390519187358915,571823389,3128,479030362,1302,31,03,1,2016,2016-03-31,2,2016,1050853751,4430
Agency,Railroad Retirement Board,null,Non-CFO,0.0,0.0,18482950,4008,0,0,31,03,1,2016,2016-03-31,2,2016,18482950,4008
Bureau,Department of Commerce,Bureau of Industry and Security,null,0.0,0.0,41450,1,0,0,31,03,1,2016,2016-03-31,2,2016,41450,1
Bureau,Department of Commerce,Nat'l Institute of Standards& Technology,null,100.0,100.0,0,0,916152,17,31,03,1,2016,2016-03-31,2,2016,916152,17
Agency,Pension Benefit Guaranty Corp,null,Non-CFO,5.413405889231686,18.582089552238806,10125266,1091,579492,249,31,03,1,2016,2016-03-31,2,2016,10704758,1340
Bureau,Department of the Treasury,Tobacco Tax and Trade,null,100.0,100.0,0,0,1000,1,31,03,1,2016,2016-03-31,2,2016,1000,1
Bureau,Other Agencies,Commission On Fine Arts,null,0.0,0.0,2613,1,0,0,31,03,1,2016,2016-03-31,2,2016,2613,1
Agency,National Aeronautics and Space Administration,null,CFO,100.0,100.0,0,0,511414,84,31,03,1,2016,2016-03-31,2,2016,511414,84
Bureau,Department of Health & Human Services,Office of the Secretary,null,100.0,100.0,0,0,128,1,31,03,1,2016,2016-03-31,2,2016,128,1
Agency,Nuclear Regulatory Commission,null,CFO,91.12701509723644,94.05405405405405,110962,11,1139598,174,31,03,1,2016,2016-03-31,2,2016,1250560,185
Bureau,Funds Appropriated to the President,Inter-American Foundation,null,0.0,0.0,0,0,0,0,31,03,1,2016,2016-03-31,2,2016,0,0
Bureau,Department of State,Department of State,null,85.80367430761828,91.77708495713172,1900572,422,11487202,4710,31,03,1,2016,2016-03-31,2,2016,13387774,5132
Agency,Department of Veterans Affairs,null,CFO,83.81444012197997,98.4033732316867,145237496,119868,752090104,7387710,31,03,1,2016,2016-03-31,2,2016,897327600,7507578
Bureau,Department of Commerce,Patent and Trademark Office,null,44.625012237275115,25.32051282051282,73533,233,59258,79,31,03,1,2016,2016-03-31,2,2016,132791,312
Bureau,Department of Justice,Drug Enforcement Administration,null,100.0,100.0,0,0,278485,15,31,03,1,2016,2016-03-31,2,2016,278485,15
Bureau,Other Agencies,Comm. for Purchase from Blind/Handic.,null,0.0,0.0,9358,6,0,0,31,03,1,2016,2016-03-31,2,2016,9358,6
Bureau,Department of Homeland Security,Federal Law Enforcement Training Ctr.,null,100.0,100.0,0,0,22618,11,31,03,1,2016,2016-03-31,2,2016,22618,11
Bureau,Department of the Treasury,Office of the Secretary,null,99.08264710652102,96.45390070921985,132423,20,14302916,544,31,03,1,2016,2016-03-31,2,2016,14435339,564
Bureau,Department of Homeland Security,U.S. Coast Guard,null,100.0,100.0,0,0,17537057,6406,31,03,1,2016,2016-03-31,2,2016,17537057,6406
Agency,Department of Education,null,CFO,57.84459099465356,47.33043210115872,49000594008,11682837,67237381531,10498543,31,03,1,2016,2016-03-31,2,2016,116237975539,22181380
Bureau,Other Agencies,National Council on Disability,null,0.0,0.0,230,2,0,0,31,03,1,2016,2016-03-31,2,2016,230,2
Bureau,Pension Benefit Guaranty Corp,Pension Benefit Guaranty Corporation,null,5.413405889231686,18.582089552238806,10125266,1091,579492,249,31,03,1,2016,2016-03-31,2,2016,10704758,1340
Bureau,Department of Homeland Security,Emergency Preparedness & Resp,null,99.99999963877752,99.9936948297604,1,3,276837696,47577,31,03,1,2016,2016-03-31,2,2016,276837697,47580
Bureau,Smithsonian Institution,Smithsonian Institution,null,0.0,0.0,0,0,0,0,31,03,1,2016,2016-03-31,2,2016,0,0
Bureau,Department of Justice,Bureau of ATF and Explosives,null,86.50738036574063,25.0,5969,12,38270,4,31,03,1,2016,2016-03-31,2,2016,44239,16
Bureau,Department of Justice,U.S. Marshals Service,null,0.0,0.0,1673,1,0,0,31,03,1,2016,2016-03-31,2,2016,1673,1
Bureau,Funds Appropriated to the President,Peace Corps,null,0.0,0.0,23954,0,0,0,31,03,1,2016,2016-03-31,2,2016,23954,0
Bureau,Funds Appropriated to the President,Trade and Development Agency,null,100.0,100.0,0,0,24713,1,31,03,1,2016,2016-03-31,2,2016,24713,1
Bureau,Securities & Exchange Commission,Securities and Exchange Commission,null,99.99141849957101,97.06774519716886,170828,29,1990483387,960,31,03,1,2016,2016-03-31,2,2016,1990654215,989
Agency,Occupational Safety & Health Rev Comm,null,Non-CFO,0.0,0.0,0,0,0,0,31,03,1,2016,2016-03-31,2,2016,0,0
Bureau,Department of Health & Human Services,National Institutes of Health,null,39.72572590335761,15.434782608695652,6630181,389,4369837,71,31,03,1,2016,2016-03-31,2,2016,11000018,460
Bureau,Commodity Futures Trading Commission,Commodity Futures Trading Commission,null,81.0509742410333,91.32231404958678,80943135,21,346219380,221,31,03,1,2016,2016-03-31,2,2016,427162515,242
Agency,Farm Credit Administration,null,Non-CFO,0.0,0.0,0,0,0,0,31,03,1,2016,2016-03-31,2,2016,0,0
Bureau,Other Agencies/Boards/Commissions,U.S.-China Security Review Commission,null,0.0,0.0,1747,4,0,0,31,03,1,2016,2016-03-31,2,2016,1747,4
Bureau,Funds Appropriated to the President,Defense Security Assistance Agency,null,0.0,0.0,0,0,0,0,31,03,1,2016,2016-03-31,2,2016,0,0
Bureau,Merit Systems Protection Board,Merit Systems Protection Board,null,0.0,0.0,0,0,0,0,31,03,1,2016,2016-03-31,2,2016,0,0
Bureau,Department of Homeland Security,Management Headquarters,null,0.0,0.0,0,0,0,0,31,03,1,2016,2016-03-31,2,2016,0,0
Bureau,Presidio Trust Corporation,Presidio Trust Corporation,null,88.53123920700608,78.0952380952381,165701,92,1279102,328,31,03,1,2016,2016-03-31,2,2016,1444803,420
Bureau,Department of Health & Human Services,Indian Health Services,null,21.852706748305973,8.792742498255409,59296214,1307,16581288,126,31,03,1,2016,2016-03-31,2,2016,75877502,1433
Agency,Tennessee Valley Authority,null,Non-CFO,0.0,0.0,0,0,0,0,31,03,1,2016,2016-03-31,2,2016,0,0
Bureau,Equal Employment Opportunity Commission,Equal Employment Opportunity Commission,null,80.77601223605387,42.05607476635514,108594,62,456294,45,31,03,1,2016,2016-03-31,2,2016,564888,107
Bureau,Department of the Interior,Bureau of Land Management,null,98.77647664929681,93.23843416370107,137364,19,11089557,262,31,03,1,2016,2016-03-31,2,2016,11226921,281
Bureau,Department of the Treasury,Interest on Tax/Deposit of Earnings,null,100.0,100.0,0,0,3240,2,31,03,1,2016,2016-03-31,2,2016,3240,2
Bureau,Department of the Interior,"Bureau of Ocean Energy Mgmt., Reg & Enf",null,100.0,100.0,0,0,2016,1,31,03,1,2016,2016-03-31,2,2016,2016,1
Bureau,Department of Transportation,Research Innovative Technology Admin,null,0.0,0.0,0,0,0,0,31,03,1,2016,2016-03-31,2,2016,0,0
Bureau,Other Agencies,Recovery and Acct. and Transparency Bd.,null,0.0,0.0,0,0,0,0,31,03,1,2016,2016-03-31,2,2016,0,0
Bureau,Other Agencies,Federal Mine Safety & Health Review Comm,null,100.0,100.0,0,0,366,1,31,03,1,2016,2016-03-31,2,2016,366,1
Bureau,Environmental Protection Agency,Environmental Protection Agency,null,99.70216274071089,97.11538461538461,44668,6,14952784,202,31,03,1,2016,2016-03-31,2,2016,14997452,208
Bureau,Overseas Private Investment Corp Accts,Overseas Private Investment Corp Accts,null,0.0,0.0,0,0,0,0,31,03,1,2016,2016-03-31,2,2016,0,0
Bureau,Department of Health & Human Services,Substance Abuse & Mental Health Admin.,null,100.0,100.0,0,0,726362,14,31,03,1,2016,2016-03-31,2,2016,726362,14
Bureau,Department of the Interior,Fish and Wildlife Service,null,94.36194598288651,92.72727272727273,15840,8,265108,102,31,03,1,2016,2016-03-31,2,2016,280948,110
Bureau,Legislative Branch-GPO,Government Publishing Office,null,8.544096488501388,29.12621359223301,903256,73,84385,30,31,03,1,2016,2016-03-31,2,2016,987641,103
Bureau,Department of Agriculture,Food Safety and Inspection Service,null,100.0,100.0,0,0,987786,1339,31,03,1,2016,2016-03-31,2,2016,987786,1339
Bureau,Office of Special Counsel,Office of Special Counsel,null,0.0,0.0,3366,13,0,0,31,03,1,2016,2016-03-31,2,2016,3366,13
Bureau,Department of Commerce,Bureau of the Census,null,100.0,100.0,0,0,50583,115,31,03,1,2016,2016-03-31,2,2016,50583,115
Bureau,Department of Veterans Affairs,Housing Credit Assistance,null,5.042732889342416,15.198237885462555,19070832,385,1012762,69,31,03,1,2016,2016-03-31,2,2016,20083594,454
Agency,Federal Mediation/Conciliation Service,null,Non-CFO,0.0,0.0,0,0,0,0,31,03,1,2016,2016-03-31,2,2016,0,0
Bureau,Other Agencies,John C. Stennis,null,0.0,0.0,0,0,0,0,31,03,1,2016,2016-03-31,2,2016,0,0
Bureau,Department of the Treasury,Office of Sec International Affairs,null,0.0,0.0,0,0,0,0,31,03,1,2016,2016-03-31,2,2016,0,0
Bureau,Department of Justice,Office of Justice Assistance Programs,null,100.0,100.0,0,0,1079553,25,31,03,1,2016,2016-03-31,2,2016,1079553,25
Bureau,Department of Homeland Security,Science and Technology,null,0.0,0.0,0,0,0,0,31,03,1,2016,2016-03-31,2,2016,0,0
Bureau,Department of Energy,Bonneville Power Administration,null,100.0,100.0,0,0,1131244,44,31,03,1,2016,2016-03-31,2,2016,1131244,44
Bureau,Department of Transportation,Federal Transit Administration,null,66.11447965783505,80.0,402152,1,784644,4,31,03,1,2016,2016-03-31,2,2016,1186796,5
Agency,Department of Commerce,null,CFO,97.80862722907453,77.3972602739726,131360,264,5863056,904,31,03,1,2016,2016-03-31,2,2016,5994416,1168
Agency,Office of Compliance,null,Non-CFO,0.0,0.0,0,0,0,0,31,03,1,2016,2016-03-31,2,2016,0,0
Bureau,Department of Housing and Urban Development,"Policy, Development and Research",null,0.0,0.0,0,0,0,0,31,03,1,2016,2016-03-31,2,2016,0,0
Bureau,Department of the Interior,Office of the Secretary,null,100.0,100.0,0,0,70755,22,31,03,1,2016,2016-03-31,2,2016,70755,22
Bureau,Railroad Retirement Board,Railroad Retirement Board,null,0.0,0.0,18482950,4008,0,0,31,03,1,2016,2016-03-31,2,2016,18482950,4008
Bureau,Other Agencies,Gulf Coast Ecosystem Restoration Council,null,0.0,0.0,0,0,0,0,31,03,1,2016,2016-03-31,2,2016,0,0
Agency,Legislative Branch-Office of Tech.,null,Non-CFO,0.0,0.0,0,0,0,0,31,03,1,2016,2016-03-31,2,2016,0,0
Bureau,Department of Housing and Urban Development,Public and Indian Housing Programs,null,0.0,0.0,0,0,0,0,31,03,1,2016,2016-03-31,2,2016,0,0
Bureau,Consumer Product Safety Commission,Consumer Product Safety Commission,null,100.0,100.0,0,0,404,1,31,03,1,2016,2016-03-31,2,2016,404,1
Bureau,Other Agencies,District of Columbia Government,null,0.0,0.0,97922,43,0,0,31,03,1,2016,2016-03-31,2,2016,97922,43
Bureau,Other Agencies,U.S. Institute of Peace,null,0.0,0.0,4054,5,0,0,31,03,1,2016,2016-03-31,2,2016,4054,5
Bureau,Department of the Treasury,Internal Revenue Service,null,97.08440488918427,97.16312056737588,9081,4,302382,137,31,03,1,2016,2016-03-31,2,2016,311463,141
Agency,National Credit Union Administration,null,Non-CFO,0.0,0.0,0,0,0,0,31,03,1,2016,2016-03-31,2,2016,0,0
Agency,Funds Appropriated to the President,null,Non-CFO,50.77978917952617,100.0,23954,0,24713,1,31,03,1,2016,2016-03-31,2,2016,48667,1
Bureau,Department of the Interior,Bureau of Safety and Environmental Enf.,null,100.0,100.0,0,0,27801,9,31,03,1,2016,2016-03-31,2,2016,27801,9
Bureau,Department of State,International Commissions,null,0.0,0.0,0,0,0,0,31,03,1,2016,2016-03-31,2,2016,0,0
Bureau,Agency for International Development,Agency for International Development,null,85.23559741925651,46.34146341463415,2820859,22,16284953,19,31,03,1,2016,2016-03-31,2,2016,19105812,41
Bureau,Other Agencies,Denali Commission,null,0.0,0.0,611,1,0,0,31,03,1,2016,2016-03-31,2,2016,611,1
Agency,Federal Deposit Insurance Corporation,null,Non-CFO,0.0,0.0,0,0,0,0,31,03,1,2016,2016-03-31,2,2016,0,0
Agency,Department of Energy,null,CFO,100.0,100.0,0,0,8867571,92,31,03,1,2016,2016-03-31,2,2016,8867571,92
Bureau,Department of Health & Human Services,Centers for Disease Control,null,15.290217293532594,12.5,131844,63,23798,9,31,03,1,2016,2016-03-31,2,2016,155642,72
Agency,American Battle Monuments Commission,null,Non-CFO,0.0,0.0,0,0,0,0,31,03,1,2016,2016-03-31,2,2016,0,0
Bureau,Department of the Treasury,International Monetary Funds,null,0.0,0.0,0,0,0,0,31,03,1,2016,2016-03-31,2,2016,0,0
Bureau,Smithsonian Institution,Administrative Conference of the US,null,0.0,0.0,0,0,0,0,31,03,1,2016,2016-03-31,2,2016,0,0
Bureau,Nuclear Regulatory Commission,Nuclear Regulatory Commission,null,91.12701509723644,94.05405405405405,110962,11,1139598,174,31,03,1,2016,2016-03-31,2,2016,1250560,185
Agency,Other Agencies,null,Non-CFO,1.3232221347936832,2.158273381294964,560566,136,7517,3,31,03,1,2016,2016-03-31,2,2016,568083,139
Bureau,Other Agencies,Defense Nuclear Facilities Safety Board,null,0.0,0.0,0,0,0,0,31,03,1,2016,2016-03-31,2,2016,0,0
Bureau,Department of Homeland Security,Office of Biometric Identity Management,null,0.0,0.0,0,0,0,0,31,03,1,2016,2016-03-31,2,2016,0,0
Bureau,Other Agencies,Japan-U.S. Friendship Commission,null,0.0,0.0,0,0,0,0,31,03,1,2016,2016-03-31,2,2016,0,0
Agency,General Services Administration,null,CFO,66.94225243469171,46.65605095541401,4403449,3350,8917026,2930,31,03,1,2016,2016-03-31,2,2016,13320475,6280
Bureau,Department of Transportation,National Highway Traffic Safety Admin.,null,99.99194003385186,100.0,1,0,12406,3,31,03,1,2016,2016-03-31,2,2016,12407,3
Bureau,Department of the Treasury,Comptroller of the Currency,null,95.58838796439598,51.21951219512195,55243,20,1196975,21,31,03,1,2016,2016-03-31,2,2016,1252218,41
Bureau,Department of Housing and Urban Development,Management and Administration,null,0.0,0.0,4581,3,0,0,31,03,1,2016,2016-03-31,2,2016,4581,3
Bureau,Social Security Administration,Social Security Administration,null,52.97160503137553,52.98525108399186,1155296604,624338,1301297130,703624,31,03,1,2016,2016-03-31,2,2016,2456593734,1327962
Bureau,Other Agencies,Millennium Challenge Corporation,null,0.0,0.0,743,5,0,0,31,03,1,2016,2016-03-31,2,2016,743,5
Bureau,Department of Transportation,Federal Aviation Administration,null,18.31147520058093,30.019120458891013,17279010,1464,3873300,628,31,03,1,2016,2016-03-31,2,2016,21152310,2092
Bureau,Other Agencies,U.S. Holocaust Memorial Council,null,0.0,0.0,0,0,0,0,31,03,1,2016,2016-03-31,2,2016,0,0
Bureau,Department of Homeland Security,Domestic Nuclear Detection Office,null,0.0,0.0,0,0,0,0,31,03,1,2016,2016-03-31,2,2016,0,0
Bureau,Department of Transportation,Pipeline Hazardous Material Safety Admin,null,100.0,100.0,0,0,380411,27,31,03,1,2016,2016-03-31,2,2016,380411,27
Bureau,Department of the Treasury,Bureau of the Fiscal Service,null,99.98195515856905,99.44444444444444,20,1,110815,179,31,03,1,2016,2016-03-31,2,2016,110835,180
Bureau,Department of the Interior,Office of Surface Mining,null,100.0,100.0,0,0,1761856,204,31,03,1,2016,2016-03-31,2,2016,1761856,204
Bureau,Other Agencies,Council of Insps. Gen. of Intg. & Effy.,null,0.0,0.0,0,0,0,0,31,03,1,2016,2016-03-31,2,2016,0,0
Agency,Neighborhood Reinvestment Corporation,null,Non-CFO,0.0,0.0,0,0,0,0,31,03,1,2016,2016-03-31,2,2016,0,0
Bureau,Department of Commerce,Economic and Statistical Analysis,null,0.0,0.0,0,0,0,0,31,03,1,2016,2016-03-31,2,2016,0,0
Bureau,Other Agencies,Advisory Council on Hist. Preservation,null,0.0,0.0,0,0,0,0,31,03,1,2016,2016-03-31,2,2016,0,0
Bureau,National Labor Relations Board,National Labor Relations Board,null,0.0,0.0,0,0,0,0,31,03,1,2016,2016-03-31,2,2016,0,0
Bureau,Selective Service System,Selective Service System,null,0.0,0.0,2080,3,0,0,31,03,1,2016,2016-03-31,2,2016,2080,3
Bureau,Other Agencies/Boards/Commissions,Nuclear Waste Technical Review Board,null,0.0,0.0,0,0,0,0,31,03,1,2016,2016-03-31,2,2016,0,0
Bureau,Federal Election Commission,Federal Election Commission,null,100.0,100.0,0,0,192033,11,31,03,1,2016,2016-03-31,2,2016,192033,11
Bureau,Other Agencies,Consumer Financial Protection Bureau,null,0.0,0.0,204445,46,0,0,31,03,1,2016,2016-03-31,2,2016,204445,46
Bureau,Department of Labor,Employment and Training Administration,null,0.0,0.0,1004275,11,0,0,31,03,1,2016,2016-03-31,2,2016,1004275,11
Bureau,Department of Veterans Affairs,Administration and Cemeteries,null,0.8944121537679269,3.372093023255814,2044579,831,18452,29,31,03,1,2016,2016-03-31,2,2016,2063031,860
Bureau,Department of Energy,Energy Consolidated Reports,null,100.0,100.0,0,0,7736327,48,31,03,1,2016,2016-03-31,2,2016,7736327,48
Bureau,Department of Agriculture,Food and Nutrition Service,null,0.04984038264821659,1.2534818941504178,26288856,709,13109,9,31,03,1,2016,2016-03-31,2,2016,26301965,718
Agency,The Judiciary,null,Non-CFO,38.47721256984945,28.8135593220339,554348,126,346697,51,31,03,1,2016,2016-03-31,2,2016,901045,177
Bureau,Department of Transportation,Surface Transportation Board,null,0.0,0.0,0,0,0,0,31,03,1,2016,2016-03-31,2,2016,0,0
Bureau,Other Agencies,Christopher Columbus Fellowship Found,null,0.0,0.0,0,0,0,0,31,03,1,2016,2016-03-31,2,2016,0,0
Bureau,Department of the Treasury,Spec Insp Gen-Troubled Asset Rel Prog,null,100.0,100.0,0,0,3916,1,31,03,1,2016,2016-03-31,2,2016,3916,1
Bureau,Department of Transportation,Maritime Administration,null,99.98719590268887,100.0,1,0,7809,6,31,03,1,2016,2016-03-31,2,2016,7810,6
Bureau,Department of State,Passport NSF,null,100.0,100.0,0,0,2031033,13196,31,03,1,2016,2016-03-31,2,2016,2031033,13196
Bureau,Department of Transportation,St. Lawrence Seaway Development Corp.,null,0.0,0.0,0,0,0,0,31,03,1,2016,2016-03-31,2,2016,0,0
Bureau,Department of Justice,Federal Prison Industries,null,80.31454658444477,58.65384615384615,247080,129,1008060,183,31,03,1,2016,2016-03-31,2,2016,1255140,312
Bureau,Department of the Treasury,Financial Crimes Enforcement Network,null,100.0,100.0,0,0,1569945,4,31,03,1,2016,2016-03-31,2,2016,1569945,4
Bureau,Department of Labor,Employee Benefit Security Administration,null,0.0,0.0,16237112,341,0,0,31,03,1,2016,2016-03-31,2,2016,16237112,341
Bureau,Small Business Administration,Small Business Administration,null,90.29038425620764,93.35981439820023,1000197063,7556,9300901244,106236,31,03,1,2016,2016-03-31,2,2016,10301098307,113792
Agency,Environmental Protection Agency,null,CFO,99.70216274071089,97.11538461538461,44668,6,14952784,202,31,03,1,2016,2016-03-31,2,2016,14997452,208
Bureau,Smithsonian Institution,JFK Center for the Performing Arts,null,0.0,0.0,345,4,0,0,31,03,1,2016,2016-03-31,2,2016,345,4
Bureau,Department of Commerce,General Administration,null,100.0,100.0,0,0,4768,2,31,03,1,2016,2016-03-31,2,2016,4768,2
Bureau,Department of Health & Human Services,Administration for Children and Families,null,100.0,100.0,0,0,16241385,1079,31,03,1,2016,2016-03-31,2,2016,16241385,1079
Bureau,Department of Health & Human Services,Administration for Community Living,null,0.0,0.0,0,0,0,0,31,03,1,2016,2016-03-31,2,2016,0,0
Bureau,Legislative Branch-GAO,Government Accountability Office,null,0.0,0.0,0,0,0,0,31,03,1,2016,2016-03-31,2,2016,0,0
Bureau,Federal Deposit Insurance Corporation,Federal Deposit Insurance Corporation,null,0.0,0.0,0,0,0,0,31,03,1,2016,2016-03-31,2,2016,0,0
Bureau,Farm Credit Administration,Farm Credit System Insurance Corporation,null,0.0,0.0,0,0,0,0,31,03,1,2016,2016-03-31,2,2016,0,0
Bureau,Other Agencies,Archit.&Trans. Barriers Compliance Bd,null,0.0,0.0,0,0,0,0,31,03,1,2016,2016-03-31,2,2016,0,0
Bureau,Department of the Interior,Office of Natural Resources Revenue,null,100.0,100.0,0,0,11267603,115,31,03,1,2016,2016-03-31,2,2016,11267603,115
Bureau,Department of Education,Federal Student Aid,null,57.95643656403504,47.334015723532765,48428770619,11679709,66758351169,10497241,31,03,1,2016,2016-03-31,2,2016,115187121788,22176950
Bureau,Legislative Branch-CBO,Congressional Budget Office,null,0.0,0.0,0,0,0,0,31,03,1,2016,2016-03-31,2,2016,0,0
Bureau,Department of Homeland Security,Transportation Safety Administration,null,100.0,100.0,0,0,7933295,4805,31,03,1,2016,2016-03-31,2,2016,7933295,4805
Bureau,Other Agencies,Northern Border Regional Commission,null,0.0,0.0,0,0,0,0,31,03,1,2016,2016-03-31,2,2016,0,0
Bureau,Department of the Treasury,U.S. Treasury IG Office,null,0.0,0.0,0,0,0,0,31,03,1,2016,2016-03-31,2,2016,0,0
Agency,Department of State,null,CFO,87.67367669885225,97.69751200349192,1900572,422,13518235,17906,31,03,1,2016,2016-03-31,2,2016,15418807,18328
Bureau,National Aeronautics and Space Administration,National Aeronautics and Space Admin,null,100.0,100.0,0,0,511414,84,31,03,1,2016,2016-03-31,2,2016,511414,84
Bureau,Department of Agriculture,U.S. Department of Agriculture,null,44.979117308363286,39.094975006577215,15114960,2315,12356355,1486,31,03,1,2016,2016-03-31,2,2016,27471315,3801
Agency,Department of Homeland Security,null,CFO,99.96539262168858,99.81603455922209,109290,112,315690419,60769,31,03,1,2016,2016-03-31,2,2016,315799709,60881
Bureau,Department of Labor,Bureau of Labor Statistics,null,0.0,0.0,10969,1,0,0,31,03,1,2016,2016-03-31,2,2016,10969,1
Agency,Department of the Interior,null,CFO,98.1959767256676,37.12288185804005,752495,26531,40959550,15664,31,03,1,2016,2016-03-31,2,2016,41712045,42195
Agency,Office of Personnel Management,null,CFO,0.0,0.0,62293582,307,0,0,31,03,1,2016,2016-03-31,2,2016,62293582,307
Agency,Department of Transportation,null,CFO,73.0274483731826,82.49821895036808,17745355,1474,48045065,6948,31,03,1,2016,2016-03-31,2,2016,65790420,8422
Agency,Department of Justice,null,CFO,96.8864723183723,96.91299089809688,2198510,970,68413035,30452,31,03,1,2016,2016-03-31,2,2016,70611545,31422
Agency,Department of Housing and Urban Development,null,CFO,98.2432684536726,99.41414141414141,2002531,29,111989331,4921,31,03,1,2016,2016-03-31,2,2016,113991862,4950
Bureau,Office of Compliance,Office of Compliance,null,0.0,0.0,0,0,0,0,31,03,1,2016,2016-03-31,2,2016,0,0
Bureau,Department of the Interior,Bureau of Reclamation,null,100.0,100.0,0,0,112307,83,31,03,1,2016,2016-03-31,2,2016,112307,83
Bureau,Department of Homeland Security,Office of the Inspector General DHS,null,0.0,0.0,968,1,0,0,31,03,1,2016,2016-03-31,2,2016,968,1
Bureau,National Archives & Records Admin,Nat'l Archives & Records Administration,null,82.29707937645583,70.79646017699115,4940,33,22965,80,31,03,1,2016,2016-03-31,2,2016,27905,113
Bureau,Other Agencies,James Madison Memorial Fellowship,null,0.0,0.0,219211,20,0,0,31,03,1,2016,2016-03-31,2,2016,219211,20
Bureau,Department of the Treasury,Treasury IG for Tax Admin,null,0.0,0.0,0,0,0,0,31,03,1,2016,2016-03-31,2,2016,0,0
Bureau,Other Agencies,National Transportation Safety Board,null,0.0,0.0,0,0,0,0,31,03,1,2016,2016-03-31,2,2016,0,0
Bureau,Legislative Branch-Office of Tech.,Medicaid & CHIP Payment & Access Comm.,null,0.0,0.0,0,0,0,0,31,03,1,2016,2016-03-31,2,2016,0,0
Bureau,Other Agencies/Boards/Commissions,Medicare Payment Advisory Commission,null,0.0,0.0,24,1,0,0,31,03,1,2016,2016-03-31,2,2016,24,1
Bureau,Other Agencies/Boards/Commissions,U.S. Comm. on Int. Religious Freedom,null,0.0,0.0,28931,2,0,0,31,03,1,2016,2016-03-31,2,2016,28931,2
Bureau,National Science Foundation,National Science Foundation,null,100.0,100.0,0,0,255868,14,31,03,1,2016,2016-03-31,2,2016,255868,14
Bureau,Department of Justice,Federal Bureau of Investigation,null,0.0,0.0,1740485,674,0,0,31,03,1,2016,2016-03-31,2,2016,1740485,674
Agency,Armed Forces Retirement Home,null,Non-CFO,51.50248423466463,69.42148760330579,60909,37,64683,84,31,03,1,2016,2016-03-31,2,2016,125592,121
Bureau,Funds Appropriated to the President,Executive Branch,null,0.0,0.0,0,0,0,0,31,03,1,2016,2016-03-31,2,2016,0,0
Bureau,Department of Commerce,Office of the Inspector General,null,0.0,0.0,0,0,0,0,31,03,1,2016,2016-03-31,2,2016,0,0
Bureau,Department of State,Civil Monetary Penalties,null,0.0,0.0,0,0,0,0,31,03,1,2016,2016-03-31,2,2016,0,0
Bureau,Federal Labor Relations Authority,Federal Labor Relations Authority,null,0.0,0.0,0,0,0,0,31,03,1,2016,2016-03-31,2,2016,0,0
Bureau,National Foundation  Arts & Humanities,National Endowment for the Humanities,null,0.0,0.0,0,0,0,0,31,03,1,2016,2016-03-31,2,2016,0,0
Bureau,Department of the Treasury,Bureau of Public Debt,null,100.0,100.0,0,0,2747692,19,31,03,1,2016,2016-03-31,2,2016,2747692,19
Agency,U.S. Postal Service,null,Non-CFO,72.01538599159137,40.0,15642000,3,40253000,2,31,03,1,2016,2016-03-31,2,2016,55895000,5
Agency,Federal Communications Commission,null,Non-CFO,70.46224935035944,75.7560035576638,77503224,3271,184883797,10221,31,03,1,2016,2016-03-31,2,2016,262387021,13492
Agency,Commodity Futures Trading Commission,null,Non-CFO,81.0509742410333,91.32231404958678,80943135,21,346219380,221,31,03,1,2016,2016-03-31,2,2016,427162515,242
Agency,Securities & Exchange Commission,null,Non-CFO,99.99141849957101,97.06774519716886,170828,29,1990483387,960,31,03,1,2016,2016-03-31,2,2016,1990654215,989
Bureau,Legislative Branch-Office of Tech.,Open World Leadership,null,0.0,0.0,0,0,0,0,31,03,1,2016,2016-03-31,2,2016,0,0
Bureau,Tennessee Valley Authority,Tennessee Valley Authority,null,0.0,0.0,0,0,0,0,31,03,1,2016,2016-03-31,2,2016,0,0
Bureau,National Credit Union Administration,Nat'l Credit Union Admin. Treasury Acct.,null,0.0,0.0,0,0,0,0,31,03,1,2016,2016-03-31,2,2016,0,0
Bureau,Department of Agriculture,Farm Service Agency,null,100.0,100.0,0,0,522164569,12134,31,03,1,2016,2016-03-31,2,2016,522164569,12134
Bureau,Other Agencies,National Capital Planning Commission,null,0.0,0.0,0,0,0,0,31,03,1,2016,2016-03-31,2,2016,0,0
Bureau,Department of the Interior,Geological Survey,null,100.0,100.0,0,0,124109,192,31,03,1,2016,2016-03-31,2,2016,124109,192
Bureau,Federal Trade Commission,Federal Trade Commission,null,100.0,100.0,0,0,487124090,57,31,03,1,2016,2016-03-31,2,2016,487124090,57
Bureau,Department of Defense,Consolidated Report,null,36.94748309060678,50.37072820579115,1766953864,291769,1035398763,296128,31,03,1,2016,2016-03-31,2,2016,2802352627,587897
Bureau,Department of Health & Human Services,Centers for Medicare & Medicaid Services,null,63.87516814873092,52.866137535224965,4088193913,1177846,7228658522,1321092,31,03,1,2016,2016-03-31,2,2016,11316852435,2498938
Bureau,U.S. Postal Service,U.S. Postal Service,null,72.01538599159137,40.0,15642000,3,40253000,2,31,03,1,2016,2016-03-31,2,2016,55895000,5
Bureau,Department of Agriculture,Commodity Credit Corporation,null,99.82595076899719,99.60081535586886,190117,47,109041621,11727,31,03,1,2016,2016-03-31,2,2016,109231738,11774
Bureau,Department of Housing and Urban Development,Housing Programs,null,98.24721672236396,99.47442894683647,1997950,26,111989331,4921,31,03,1,2016,2016-03-31,2,2016,113987281,4947
Bureau,Department of Agriculture,Rural Development,null,99.99847951610856,99.9826884791829,7384,4,485627488,23102,31,03,1,2016,2016-03-31,2,2016,485634872,23106
Bureau,Smithsonian Institution,National Gallery of Art,null,0.0,0.0,0,0,0,0,31,03,1,2016,2016-03-31,2,2016,0,0
Bureau,Farm Credit Administration,Farm Credit Administration,null,0.0,0.0,0,0,0,0,31,03,1,2016,2016-03-31,2,2016,0,0
Bureau,Department of Homeland Security,Info Analysis Infrastructure Prot-NPPD,null,100.0,100.0,0,0,4610,1,31,03,1,2016,2016-03-31,2,2016,4610,1
Bureau,Department of Labor,Occupational Safety and Health Admin,null,91.2452313163255,87.89647297640192,2800647,477,29189313,3464,31,03,1,2016,2016-03-31,2,2016,31989960,3941
Bureau,Department of Transportation,Federal Motor Carrier Safety Admin,null,100.0,100.0,0,0,42560849,6207,31,03,1,2016,2016-03-31,2,2016,42560849,6207
Bureau,Department of Labor,Employment Standards Administration,null,38.61481403470048,25.417626728110598,28945314,5179,18208268,1765,31,03,1,2016,2016-03-31,2,2016,47153582,6944
Bureau,Department of Housing and Urban Development,Government National Mortgage Association,null,0.0,0.0,0,0,0,0,31,03,1,2016,2016-03-31,2,2016,0,0
Bureau,Other Agencies,Marine Mammal Commission,null,0.0,0.0,0,0,0,0,31,03,1,2016,2016-03-31,2,2016,0,0
Bureau,Department of Health & Human Services,Food and Drug Administration,null,73.88002761007833,27.441860465116278,7733609,1404,21874420,531,31,03,1,2016,2016-03-31,2,2016,29608029,1935
Agency,Department of the Treasury,null,CFO,99.33321786794377,99.11504424778761,196803,46,29318535,5152,31,03,1,2016,2016-03-31,2,2016,29515338,5198
Agency,Federal Trade Commission,null,Non-CFO,100.0,100.0,0,0,487124090,57,31,03,1,2016,2016-03-31,2,2016,487124090,57
Bureau,Legis Branch-Library of Congress,Library of Congress,null,0.0,0.0,0,0,0,0,31,03,1,2016,2016-03-31,2,2016,0,0
Bureau,Department of Transportation,Office of the Secretary,null,99.9994955253095,100.0,1,0,198225,23,31,03,1,2016,2016-03-31,2,2016,198226,23
Bureau,Department of the Interior,National Park Service,null,99.26108992504822,86.1545988258317,35038,283,4706811,1761,31,03,1,2016,2016-03-31,2,2016,4741849,2044
Bureau,Department of Homeland Security,Immigration and Customs Enforcement,null,100.0,100.0,0,0,5779801,339,31,03,1,2016,2016-03-31,2,2016,5779801,339
Bureau,Department of the Interior,Bureau of Indian Affairs,null,95.33516370863468,32.99688250626054,564253,26221,11531627,12913,31,03,1,2016,2016-03-31,2,2016,12095880,39134
Agency,Consumer Product Safety Commission,null,Non-CFO,100.0,100.0,0,0,404,1,31,03,1,2016,2016-03-31,2,2016,404,1
Agency,Selective Service System,null,Non-CFO,0.0,0.0,2080,3,0,0,31,03,1,2016,2016-03-31,2,2016,2080,3
Agency,Federal Maritime Commission,null,Non-CFO,0.0,0.0,2229,18,0,0,31,03,1,2016,2016-03-31,2,2016,2229,18
Agency,Federal Election Commission,null,Non-CFO,100.0,100.0,0,0,192033,11,31,03,1,2016,2016-03-31,2,2016,192033,11
Agency,Legislative Branch - U.S. House/Senate,null,Non-CFO,0.0,0.0,259515,268,0,0,31,03,1,2016,2016-03-31,2,2016,259515,268
Agency,Equal Employment Opportunity Commission,null,Non-CFO,80.77601223605387,42.05607476635514,108594,62,456294,45,31,03,1,2016,2016-03-31,2,2016,564888,107
Agency,Overseas Private Investment Corp Accts,null,Non-CFO,0.0,0.0,0,0,0,0,31,03,1,2016,2016-03-31,2,2016,0,0
Agency,U.S. Court of Appeals / Veterans Claims,null,Non-CFO,0.0,0.0,40,1,0,0,31,03,1,2016,2016-03-31,2,2016,40,1
Agency,Smithsonian Institution,null,Non-CFO,0.0,0.0,345,4,0,0,31,03,1,2016,2016-03-31,2,2016,345,4
Bureau,Department of Labor,Departmental Management,null,0.0,0.0,0,0,0,0,31,03,1,2016,2016-03-31,2,2016,0,0
Bureau,Department of Transportation,Federal Railroad Administration,null,82.39461481402148,66.66666666666667,44383,5,207716,10,31,03,1,2016,2016-03-31,2,2016,252099,15
Agency,Merit Systems Protection Board,null,Non-CFO,0.0,0.0,0,0,0,0,31,03,1,2016,2016-03-31,2,2016,0,0
Bureau,Department of Commerce,Economic Development Administration,null,0.0,0.0,0,0,0,0,31,03,1,2016,2016-03-31,2,2016,0,0
Bureau,Other Agencies,Comm. to Elim Child Abuse & Neg. Fatal,null,0.0,0.0,0,0,0,0,31,03,1,2016,2016-03-31,2,2016,0,0
Agency,Department of Labor,null,CFO,65.24054371034669,70.07944985979437,57060682,8963,107098048,20993,31,03,1,2016,2016-03-31,2,2016,164158730,29956
Agency,Small Business Administration,null,CFO,90.29038425620764,93.35981439820023,1000197063,7556,9300901244,106236,31,03,1,2016,2016-03-31,2,2016,10301098307,113792
Agency,Department of Health & Human Services,null,CFO,63.866026910869564,52.84796519160309,4161985761,1181009,7356221082,1323674,31,03,1,2016,2016-03-31,2,2016,11518206843,2504683
Agency,National Labor Relations Board,null,Non-CFO,0.0,0.0,0,0,0,0,31,03,1,2016,2016-03-31,2,2016,0,0
Agency,Legislative Branch-CBO,null,Non-CFO,0.0,0.0,0,0,0,0,31,03,1,2016,2016-03-31,2,2016,0,0
Agency,Legislative Branch-GAO,null,Non-CFO,0.0,0.0,0,0,0,0,31,03,1,2016,2016-03-31,2,2016,0,0
Agency,Legis Branch-Library of Congress,null,Non-CFO,0.0,0.0,0,0,0,0,31,03,1,2016,2016-03-31,2,2016,0,0
Agency,National Foundation  Arts & Humanities,null,Non-CFO,0.0,0.0,0,0,0,0,31,03,1,2016,2016-03-31,2,2016,0,0
Agency,Federal Labor Relations Authority,null,Non-CFO,0.0,0.0,0,0,0,0,31,03,1,2016,2016-03-31,2,2016,0,0
Agency,Export - Import  Bank,null,Non-CFO,0.0,0.0,0,0,0,0,31,03,1,2016,2016-03-31,2,2016,0,0
Agency,Office of Government Ethics,null,Non-CFO,0.0,0.0,0,0,0,0,31,03,1,2016,2016-03-31,2,2016,0,0
Agency,Department of Defense,null,CFO,36.94748309060678,50.37072820579115,1766953864,291769,1035398763,296128,31,03,1,2016,2016-03-31,2,2016,2802352627,587897
Bureau,Other Agencies,Architect of the Capitol,null,0.0,0.0,0,0,0,0,31,03,1,2016,2016-03-31,2,2016,0,0
Agency,Agency for International Development,null,CFO,85.23559741925651,46.34146341463415,2820859,22,16284953,19,31,03,1,2016,2016-03-31,2,2016,19105812,41
Agency,Social Security Administration,null,CFO,52.97160503137553,52.98525108399186,1155296604,624338,1301297130,703624,31,03,1,2016,2016-03-31,2,2016,2456593734,1327962
Bureau,Department of Commerce,NOAA,null,100.0,100.0,0,0,4832295,691,31,03,1,2016,2016-03-31,2,2016,4832295,691
Agency,Department of Agriculture,null,CFO,85.4751162545453,77.52776377495685,200350818,14711,1179011809,50752,31,03,1,2016,2016-03-31,2,2016,1379362627,65463
Agency,National Science Foundation,null,CFO,100.0,100.0,0,0,255868,14,31,03,1,2016,2016-03-31,2,2016,255868,14
Bureau,Export - Import  Bank,Export-Import Bank,null,0.0,0.0,0,0,0,0,31,03,1,2016,2016-03-31,2,2016,0,0
Bureau,National Foundation  Arts & Humanities,National Endowment for the Arts,null,0.0,0.0,0,0,0,0,30,06,2,2016,2016-06-30,3,2016,0,0
Bureau,Department of Transportation,Surface Transportation Board,null,0.0,0.0,0,0,0,0,30,06,2,2016,2016-06-30,3,2016,0,0
Bureau,Neighborhood Reinvestment Corporation,Neighborhood Reinvestment Corporation,null,0.0,0.0,0,0,0,0,30,06,2,2016,2016-06-30,3,2016,0,0
Agency,National Credit Union Administration,null,Non-CFO,0.0,0.0,0,0,0,0,30,06,2,2016,2016-06-30,3,2016,0,0
Bureau,Department of Education,Departmental Management,null,51.36911983035027,36.28519527702089,501075496,2806,529289355,1598,30,06,2,2016,2016-06-30,3,2016,1030364851,4404
Agency,Tennessee Valley Authority,null,Non-CFO,0.0,0.0,0,0,0,0,30,06,2,2016,2016-06-30,3,2016,0,0
Agency,Farm Credit Administration,null,Non-CFO,0.0,0.0,0,0,0,0,30,06,2,2016,2016-06-30,3,2016,0,0
Agency,Consumer Product Safety Commission,null,Non-CFO,100.0,100.0,0,0,410,1,30,06,2,2016,2016-06-30,3,2016,410,1
Bureau,Department of Homeland Security,Domestic Nuclear Detection Office,null,0.0,0.0,0,0,0,0,30,06,2,2016,2016-06-30,3,2016,0,0
Bureau,Department of Labor,Bureau of Labor Statistics,null,0.0,0.0,10968,1,0,0,30,06,2,2016,2016-06-30,3,2016,10968,1
Bureau,Department of Transportation,National Highway Traffic Safety Admin.,null,100.0,100.0,0,0,12539,3,30,06,2,2016,2016-06-30,3,2016,12539,3
Agency,Selective Service System,null,Non-CFO,0.0,0.0,1845,3,0,0,30,06,2,2016,2016-06-30,3,2016,1845,3
Bureau,Other Agencies,Christopher Columbus Fellowship Found,null,0.0,0.0,0,0,0,0,30,06,2,2016,2016-06-30,3,2016,0,0
Bureau,Equal Employment Opportunity Commission,Equal Employment Opportunity Commission,null,70.16369138408601,25.130890052356023,195614,143,460010,48,30,06,2,2016,2016-06-30,3,2016,655624,191
Bureau,Department of State,Department of State,null,86.65800048093307,90.86172344689379,1723882,456,11196835,4534,30,06,2,2016,2016-06-30,3,2016,12920717,4990
Bureau,Office of Government Ethics,Office of Government Ethics,null,0.0,0.0,0,0,0,0,30,06,2,2016,2016-06-30,3,2016,0,0
Agency,Armed Forces Retirement Home,null,Non-CFO,50.98611089215053,75.0,62180,28,64682,84,30,06,2,2016,2016-06-30,3,2016,126862,112
Agency,Other Agencies/Boards/Commissions,null,Non-CFO,0.0,0.0,143418,9,0,0,30,06,2,2016,2016-06-30,3,2016,143418,9
Bureau,Other Agencies,National Council on Disability,null,0.0,0.0,229,2,0,0,30,06,2,2016,2016-06-30,3,2016,229,2
Bureau,Department of the Treasury,Office of the Secretary,null,99.14361837675995,96.55797101449275,131399,19,15212111,533,30,06,2,2016,2016-06-30,3,2016,15343510,552
Bureau,Other Agencies,Federal Mine Safety & Health Review Comm,null,100.0,100.0,0,0,366,1,30,06,2,2016,2016-06-30,3,2016,366,1
Agency,Department of Veterans Affairs,null,CFO,88.10754563474764,98.1177227720127,105699369,112721,783094195,5875823,30,06,2,2016,2016-06-30,3,2016,888793564,5988544
Bureau,National Archives & Records Admin,Nat'l Archives & Records Administration,null,75.23420796890184,62.0,6371,38,19354,62,30,06,2,2016,2016-06-30,3,2016,25725,100
Bureau,Department of Justice,Bureau of ATF and Explosives,null,90.32881344236276,28.571428571428573,2803,10,26180,4,30,06,2,2016,2016-06-30,3,2016,28983,14
Bureau,Department of Defense,Consolidated Report,null,50.92717564716332,49.92477350376648,989856039,291226,1027260465,290351,30,06,2,2016,2016-06-30,3,2016,2017116504,581577
Bureau,Department of Commerce,Bureau of the Census,null,100.0,100.0,0,0,47367,107,30,06,2,2016,2016-06-30,3,2016,47367,107
Bureau,Department of the Treasury,Internal Revenue Service,null,98.85127569705946,97.84172661870504,3560,3,306349,136,30,06,2,2016,2016-06-30,3,2016,309909,139
Bureau,Securities & Exchange Commission,Securities and Exchange Commission,null,99.98771044463321,96.12756264236901,265386,34,2159178077,844,30,06,2,2016,2016-06-30,3,2016,2159443463,878
Bureau,Department of the Interior,Office of the Secretary,null,100.0,100.0,0,0,76726,22,30,06,2,2016,2016-06-30,3,2016,76726,22
Bureau,The Judiciary,Administrative Office of the U.S. Courts,null,41.648964209771755,32.460732984293195,556785,129,397414,62,30,06,2,2016,2016-06-30,3,2016,954199,191
Bureau,Department of Health & Human Services,Centers for Medicare & Medicaid Services,null,98.1980046593613,78.00138461253171,194844443,640601,10617860707,2271405,30,06,2,2016,2016-06-30,3,2016,10812705150,2912006
Bureau,Department of the Interior,Geological Survey,null,100.0,100.0,0,0,94808,180,30,06,2,2016,2016-06-30,3,2016,94808,180
Bureau,Department of Health & Human Services,Centers for Disease Control,null,5.234479737711881,9.75609756097561,428361,74,23661,8,30,06,2,2016,2016-06-30,3,2016,452022,82
Bureau,Department of Agriculture,U.S. Department of Agriculture,null,52.51730188574307,33.91936240037506,11653605,2819,12889240,1447,30,06,2,2016,2016-06-30,3,2016,24542845,4266
Bureau,Department of Labor,Employment and Training Administration,null,100.0,100.0,0,0,2541742,3,30,06,2,2016,2016-06-30,3,2016,2541742,3
Bureau,Department of Labor,Occupational Safety and Health Admin,null,95.20815367583121,65.12374834687323,1438683,1846,28584880,3447,30,06,2,2016,2016-06-30,3,2016,30023563,5293
Bureau,Department of the Treasury,Spec Insp Gen-Troubled Asset Rel Prog,null,100.0,100.0,0,0,3916,1,30,06,2,2016,2016-06-30,3,2016,3916,1
Bureau,Department of Transportation,Office of the Secretary,null,100.0,100.0,0,0,566605,22,30,06,2,2016,2016-06-30,3,2016,566605,22
Bureau,Department of Justice,Federal Bureau of Investigation,null,0.0,0.0,2682955,739,0,0,30,06,2,2016,2016-06-30,3,2016,2682955,739
Bureau,Other Agencies,U.S. Institute of Peace,null,0.0,0.0,4054,5,0,0,30,06,2,2016,2016-06-30,3,2016,4054,5
Bureau,Department of Transportation,Federal Motor Carrier Safety Admin,null,77.43277341652045,82.47642768190714,9689496,985,33246644,4636,30,06,2,2016,2016-06-30,3,2016,42936140,5621
Bureau,Department of Health & Human Services,Food and Drug Administration,null,41.413596872928345,9.805103475989553,27808925,4489,19657592,488,30,06,2,2016,2016-06-30,3,2016,47466517,4977
Agency,Corp. for National and Community Service,null,Non-CFO,99.343370401598,88.23529411764706,19750,24,2988034,180,30,06,2,2016,2016-06-30,3,2016,3007784,204
Bureau,Department of the Treasury,Bureau of the Fiscal Service,null,100.0,100.0,0,0,107339,173,30,06,2,2016,2016-06-30,3,2016,107339,173
Bureau,Department of the Interior,Bureau of Reclamation,null,100.0,100.0,0,0,108236,83,30,06,2,2016,2016-06-30,3,2016,108236,83
Bureau,Office of Personnel Management,Office of Personnel Management,null,20.872870004430876,35.16483516483517,59496110,1888,15694422,1024,30,06,2,2016,2016-06-30,3,2016,75190532,2912
Bureau,Department of the Interior,National Park Service,null,99.44082919856906,87.65617191404297,27240,247,4844259,1754,30,06,2,2016,2016-06-30,3,2016,4871499,2001
Bureau,Department of Justice,Federal Prison System,null,100.0,100.0,0,0,634547,66,30,06,2,2016,2016-06-30,3,2016,634547,66
Bureau,Department of Veterans Affairs,Medical and Construction,null,73.20049680277145,98.13017661295316,86064765,109924,235078371,5768920,30,06,2,2016,2016-06-30,3,2016,321143136,5878844
Agency,Federal Deposit Insurance Corporation,null,Non-CFO,0.0,0.0,0,0,0,0,30,06,2,2016,2016-06-30,3,2016,0,0
Agency,American Battle Monuments Commission,null,Non-CFO,0.0,0.0,0,0,0,0,30,06,2,2016,2016-06-30,3,2016,0,0
Bureau,Other Agencies,U.S. Inst. for Env. Conflict Resolution,null,0.0,0.0,8023,4,0,0,30,06,2,2016,2016-06-30,3,2016,8023,4
Agency,Occupational Safety & Health Rev Comm,null,Non-CFO,0.0,0.0,0,0,0,0,30,06,2,2016,2016-06-30,3,2016,0,0
Bureau,Department of Agriculture,Farm Service Agency,null,99.99567343131498,99.9656770207654,27668,4,639462931,11650,30,06,2,2016,2016-06-30,3,2016,639490599,11654
Bureau,Department of Justice,Office of Justice Assistance Programs,null,100.0,100.0,0,0,757115,10,30,06,2,2016,2016-06-30,3,2016,757115,10
Agency,National Science Foundation,null,CFO,100.0,100.0,0,0,255868,14,30,06,2,2016,2016-06-30,3,2016,255868,14
Bureau,Department of Education,Office of Postsecondary Education,null,0.0,0.0,0,0,0,0,30,06,2,2016,2016-06-30,3,2016,0,0
Bureau,Consumer Product Safety Commission,Consumer Product Safety Commission,null,100.0,100.0,0,0,410,1,30,06,2,2016,2016-06-30,3,2016,410,1
Bureau,Pension Benefit Guaranty Corp,Pension Benefit Guaranty Corporation,null,27.786885021495902,51.63755458515284,7121739,443,2740374,473,30,06,2,2016,2016-06-30,3,2016,9862113,916
Bureau,Department of Labor,Employee Benefit Security Administration,null,0.0,0.0,16386508,354,0,0,30,06,2,2016,2016-06-30,3,2016,16386508,354
Bureau,Department of Veterans Affairs,Housing Credit Assistance,null,6.939912801505209,26.710097719869708,16212585,225,1209046,82,30,06,2,2016,2016-06-30,3,2016,17421631,307
Agency,Pension Benefit Guaranty Corp,null,Non-CFO,27.786885021495902,51.63755458515284,7121739,443,2740374,473,30,06,2,2016,2016-06-30,3,2016,9862113,916
Bureau,Other Agencies,Japan-U.S. Friendship Commission,null,0.0,0.0,0,0,0,0,30,06,2,2016,2016-06-30,3,2016,0,0
Bureau,National Credit Union Administration,Nat'l Credit Union Admin. Treasury Acct.,null,0.0,0.0,0,0,0,0,30,06,2,2016,2016-06-30,3,2016,0,0
Agency,Department of Education,null,CFO,50.26148495066751,42.12288176117193,62986645624,13646756,63648911472,9932089,30,06,2,2016,2016-06-30,3,2016,126635557096,23578845
Bureau,Armed Forces Retirement Home,Armed Forces Retirement Home,null,50.98611089215053,75.0,62180,28,64682,84,30,06,2,2016,2016-06-30,3,2016,126862,112
Bureau,Other Agencies,U.S.  Agency of Global Media,null,0.0,0.0,13356,3,0,0,30,06,2,2016,2016-06-30,3,2016,13356,3
Agency,Office of Government Ethics,null,Non-CFO,0.0,0.0,0,0,0,0,30,06,2,2016,2016-06-30,3,2016,0,0
Agency,Nuclear Regulatory Commission,null,CFO,100.0,100.0,0,0,1205686,190,30,06,2,2016,2016-06-30,3,2016,1205686,190
Bureau,Department of Agriculture,Federal Crop Insurance Corporation,null,100.0,100.0,0,0,128862,329,30,06,2,2016,2016-06-30,3,2016,128862,329
Bureau,Other Agencies,National Mediation Board,null,0.0,0.0,0,0,0,0,30,06,2,2016,2016-06-30,3,2016,0,0
Bureau,U.S. Postal Service,U.S. Postal Service,null,71.46561281785344,40.0,15957000,3,39965000,2,30,06,2,2016,2016-06-30,3,2016,55922000,5
Bureau,Department of Education,Federal Student Aid,null,50.252398797242094,42.12397231391404,62485570128,13643950,63119622117,9930491,30,06,2,2016,2016-06-30,3,2016,125605192245,23574441
Agency,Legislative Branch-Office of Tech.,null,Non-CFO,0.0,0.0,0,0,0,0,30,06,2,2016,2016-06-30,3,2016,0,0
Agency,Equal Employment Opportunity Commission,null,Non-CFO,70.16369138408601,25.130890052356023,195614,143,460010,48,30,06,2,2016,2016-06-30,3,2016,655624,191
Bureau,Department of Homeland Security,U.S. Secret Service,null,0.0,0.0,35175,5,0,0,30,06,2,2016,2016-06-30,3,2016,35175,5
Agency,Department of Commerce,null,CFO,98.0483832905117,79.65616045845272,123388,213,6198960,834,30,06,2,2016,2016-06-30,3,2016,6322348,1047
Bureau,Legislative Branch-CBO,Congressional Budget Office,null,0.0,0.0,0,0,0,0,30,06,2,2016,2016-06-30,3,2016,0,0
Bureau,Other Agencies,Northern Border Regional Commission,null,0.0,0.0,0,0,0,0,30,06,2,2016,2016-06-30,3,2016,0,0
Bureau,Department of the Treasury,U.S. Mint,null,100.0,100.0,0,0,31388,5,30,06,2,2016,2016-06-30,3,2016,31388,5
Bureau,Department of Health & Human Services,National Institutes of Health,null,40.48780823219948,16.829745596868886,6404736,425,4357321,86,30,06,2,2016,2016-06-30,3,2016,10762057,511
Bureau,Department of Agriculture,Agricultural Marketing Service,null,55.41074002130459,89.26553672316385,149436,38,185703,316,30,06,2,2016,2016-06-30,3,2016,335139,354
Bureau,Legis Branch-Library of Congress,Library of Congress,null,0.0,0.0,0,0,0,0,30,06,2,2016,2016-06-30,3,2016,0,0
Bureau,Office of Compliance,Office of Compliance,null,0.0,0.0,0,0,0,0,30,06,2,2016,2016-06-30,3,2016,0,0
Bureau,Other Agencies,Denali Commission,null,0.0,0.0,611,1,0,0,30,06,2,2016,2016-06-30,3,2016,611,1
Agency,Merit Systems Protection Board,null,Non-CFO,0.0,0.0,0,0,0,0,30,06,2,2016,2016-06-30,3,2016,0,0
Agency,Railroad Retirement Board,null,Non-CFO,83.72995839048144,84.23236514522821,3058029,646,15737430,3451,30,06,2,2016,2016-06-30,3,2016,18795459,4097
Bureau,Federal Labor Relations Authority,Federal Labor Relations Authority,null,0.0,0.0,0,0,0,0,30,06,2,2016,2016-06-30,3,2016,0,0
Agency,Department of Agriculture,null,CFO,87.57348439236168,78.05384505226979,187936411,15325,1324445796,54505,30,06,2,2016,2016-06-30,3,2016,1512382207,69830
Agency,Federal Trade Commission,null,Non-CFO,100.0,100.0,0,0,487119002,57,30,06,2,2016,2016-06-30,3,2016,487119002,57
Bureau,Department of Health & Human Services,Administration for Community Living,null,0.0,0.0,0,0,0,0,30,06,2,2016,2016-06-30,3,2016,0,0
Bureau,Department of Transportation,Federal Railroad Administration,null,100.0,100.0,0,0,116984,9,30,06,2,2016,2016-06-30,3,2016,116984,9
Agency,Department of Energy,null,CFO,100.0,100.0,0,0,8875527,81,30,06,2,2016,2016-06-30,3,2016,8875527,81
Bureau,Department of the Interior,"Bureau of Ocean Energy Mgmt., Reg & Enf",null,0.0,0.0,0,0,0,0,30,06,2,2016,2016-06-30,3,2016,0,0
Bureau,Other Agencies,Appraisal Subcommittee,null,0.0,0.0,0,0,0,0,30,06,2,2016,2016-06-30,3,2016,0,0
Agency,Legis Branch-Library of Congress,null,Non-CFO,0.0,0.0,0,0,0,0,30,06,2,2016,2016-06-30,3,2016,0,0
Agency,Export - Import  Bank,null,Non-CFO,0.0,0.0,0,0,0,0,30,06,2,2016,2016-06-30,3,2016,0,0
Bureau,General Services Administration,General Services Administration,null,79.99714597870913,66.5570690465007,3661322,2136,14642676,4251,30,06,2,2016,2016-06-30,3,2016,18303998,6387
Agency,Department of Defense,null,CFO,50.92717564716332,49.92477350376648,989856039,291226,1027260465,290351,30,06,2,2016,2016-06-30,3,2016,2017116504,581577
Agency,The Judiciary,null,Non-CFO,41.648964209771755,32.460732984293195,556785,129,397414,62,30,06,2,2016,2016-06-30,3,2016,954199,191
Bureau,Department of Homeland Security,Info Analysis Infrastructure Prot-NPPD,null,100.0,100.0,0,0,4610,1,30,06,2,2016,2016-06-30,3,2016,4610,1
Bureau,Commodity Futures Trading Commission,Commodity Futures Trading Commission,null,89.42379690198185,93.96551724137932,36498857,14,308604737,218,30,06,2,2016,2016-06-30,3,2016,345103594,232
Bureau,Other Agencies,National Transportation Safety Board,null,0.0,0.0,16,1,0,0,30,06,2,2016,2016-06-30,3,2016,16,1
Agency,Office of Compliance,null,Non-CFO,0.0,0.0,0,0,0,0,30,06,2,2016,2016-06-30,3,2016,0,0
Bureau,Department of Homeland Security,Citizenship and Immigration Services,null,100.0,100.0,0,0,901265,1081,30,06,2,2016,2016-06-30,3,2016,901265,1081
Bureau,Department of the Treasury,Bureau of Public Debt,null,100.0,100.0,0,0,2726439,19,30,06,2,2016,2016-06-30,3,2016,2726439,19
Bureau,Department of Homeland Security,Bureau of Customs & Border Protection,null,99.06129776400547,74.69135802469135,62088,164,6552150,484,30,06,2,2016,2016-06-30,3,2016,6614238,648
Bureau,Department of the Treasury,Office of Sec International Affairs,null,0.0,0.0,0,0,0,0,30,06,2,2016,2016-06-30,3,2016,0,0
Bureau,Smithsonian Institution,Administrative Conference of the US,null,0.0,0.0,0,0,0,0,30,06,2,2016,2016-06-30,3,2016,0,0
Bureau,Department of Justice,Federal Prison Industries,null,85.61527250693894,97.34042553191489,170456,5,1014523,183,30,06,2,2016,2016-06-30,3,2016,1184979,188
Bureau,Department of Commerce,Office of the Inspector General,null,0.0,0.0,0,0,0,0,30,06,2,2016,2016-06-30,3,2016,0,0
Bureau,Department of the Interior,Fish and Wildlife Service,null,96.71243300099589,79.5275590551181,11752,26,345716,101,30,06,2,2016,2016-06-30,3,2016,357468,127
Agency,Office of Special Counsel,null,Non-CFO,0.0,0.0,0,0,0,0,30,06,2,2016,2016-06-30,3,2016,0,0
Bureau,Department of Commerce,Bureau of Industry and Security,null,0.0,0.0,41450,1,0,0,30,06,2,2016,2016-06-30,3,2016,41450,1
Agency,Department of State,null,CFO,88.43060322963966,97.44193874116459,1723882,456,13176480,17370,30,06,2,2016,2016-06-30,3,2016,14900362,17826
Bureau,Farm Credit Administration,Farm Credit Administration,null,0.0,0.0,0,0,0,0,30,06,2,2016,2016-06-30,3,2016,0,0
Bureau,Department of Commerce,National Technical Information Service,null,0.0,0.0,18734,38,0,0,30,06,2,2016,2016-06-30,3,2016,18734,38
Bureau,Department of Commerce,Patent and Trademark Office,null,48.29050389023882,35.31598513011152,63204,174,59025,95,30,06,2,2016,2016-06-30,3,2016,122229,269
Bureau,Department of Health & Human Services,Health Resources and Services Admin,null,100.0,100.0,0,0,63067281,411,30,06,2,2016,2016-06-30,3,2016,63067281,411
Bureau,Department of Transportation,Office of the Inspector General,null,100.0,100.0,0,0,2903,2,30,06,2,2016,2016-06-30,3,2016,2903,2
Bureau,Funds Appropriated to the President,African Development Foundation,null,0.0,0.0,0,0,0,0,30,06,2,2016,2016-06-30,3,2016,0,0
Bureau,Department of Commerce,International Trade Administration,null,0.0,0.0,0,0,0,0,30,06,2,2016,2016-06-30,3,2016,0,0
Bureau,National Labor Relations Board,National Labor Relations Board,null,0.0,0.0,0,0,0,0,30,06,2,2016,2016-06-30,3,2016,0,0
Bureau,Other Agencies,National Capital Planning Commission,null,0.0,0.0,0,0,0,0,30,06,2,2016,2016-06-30,3,2016,0,0
Bureau,Department of Transportation,Research Innovative Technology Admin,null,100.0,100.0,0,0,4906,2,30,06,2,2016,2016-06-30,3,2016,4906,2
Bureau,Corp. for National and Community Service,Corp. for National and Community Service,null,99.343370401598,88.23529411764706,19750,24,2988034,180,30,06,2,2016,2016-06-30,3,2016,3007784,204
Bureau,Federal Deposit Insurance Corporation,Federal Deposit Insurance Corporation,null,0.0,0.0,0,0,0,0,30,06,2,2016,2016-06-30,3,2016,0,0
Bureau,Railroad Retirement Board,Railroad Retirement Board,null,83.72995839048144,84.23236514522821,3058029,646,15737430,3451,30,06,2,2016,2016-06-30,3,2016,18795459,4097
Bureau,Department of Justice,U.S. Marshals Service,null,0.0,0.0,0,0,0,0,30,06,2,2016,2016-06-30,3,2016,0,0
Bureau,Farm Credit Administration,Farm Credit System Insurance Corporation,null,0.0,0.0,0,0,0,0,30,06,2,2016,2016-06-30,3,2016,0,0
Agency,Environmental Protection Agency,null,CFO,99.65262074929169,98.5,52079,3,14939893,197,30,06,2,2016,2016-06-30,3,2016,14991972,200
Bureau,Other Agencies,Marine Mammal Commission,null,0.0,0.0,0,0,0,0,30,06,2,2016,2016-06-30,3,2016,0,0
Bureau,Department of Homeland Security,Federal Law Enforcement Training Ctr.,null,100.0,100.0,0,0,18879,7,30,06,2,2016,2016-06-30,3,2016,18879,7
Bureau,Department of Commerce,Nat'l Telecomm & Information Admin.,null,0.0,0.0,0,0,0,0,30,06,2,2016,2016-06-30,3,2016,0,0
Bureau,Legislative Branch-Office of Tech.,Medicaid & CHIP Payment & Access Comm.,null,0.0,0.0,0,0,0,0,30,06,2,2016,2016-06-30,3,2016,0,0
Bureau,Other Agencies,Gulf Coast Ecosystem Restoration Council,null,0.0,0.0,0,0,0,0,30,06,2,2016,2016-06-30,3,2016,0,0
Bureau,Other Agencies,Commission On Fine Arts,null,0.0,0.0,765,1,0,0,30,06,2,2016,2016-06-30,3,2016,765,1
Bureau,Funds Appropriated to the President,Defense Security Assistance Agency,null,0.0,0.0,0,0,0,0,30,06,2,2016,2016-06-30,3,2016,0,0
Bureau,Department of the Treasury,Comptroller of the Currency,null,98.53216344593217,58.97435897435897,18223,16,1223264,23,30,06,2,2016,2016-06-30,3,2016,1241487,39
Bureau,Department of Homeland Security,U.S. Coast Guard,null,100.0,100.0,0,0,19598958,5813,30,06,2,2016,2016-06-30,3,2016,19598958,5813
Bureau,Department of Agriculture,Rural Development,null,99.99968983092799,99.99635634906176,1570,1,506173978,27444,30,06,2,2016,2016-06-30,3,2016,506175548,27445
Agency,Federal Labor Relations Authority,null,Non-CFO,0.0,0.0,0,0,0,0,30,06,2,2016,2016-06-30,3,2016,0,0
Bureau,Other Agencies/Boards/Commissions,U.S. Comm. on Int. Religious Freedom,null,0.0,0.0,141647,4,0,0,30,06,2,2016,2016-06-30,3,2016,141647,4
Bureau,Funds Appropriated to the President,Executive Branch,null,0.0,0.0,0,0,0,0,30,06,2,2016,2016-06-30,3,2016,0,0
Bureau,Department of Homeland Security,Office of Health Affairs,null,0.0,0.0,0,0,0,0,30,06,2,2016,2016-06-30,3,2016,0,0
Bureau,Presidio Trust Corporation,Presidio Trust Corporation,null,84.37522080477592,77.3841961852861,234402,83,1265792,284,30,06,2,2016,2016-06-30,3,2016,1500194,367
Agency,Funds Appropriated to the President,null,Non-CFO,100.0,100.0,0,0,24713,1,30,06,2,2016,2016-06-30,3,2016,24713,1
Bureau,Department of Energy,Energy Consolidated Reports,null,100.0,100.0,0,0,7752731,42,30,06,2,2016,2016-06-30,3,2016,7752731,42
Agency,Legislative Branch-GAO,null,Non-CFO,0.0,0.0,0,0,0,0,30,06,2,2016,2016-06-30,3,2016,0,0
Bureau,Other Agencies,Federal Housing Finance Agency,null,100.0,100.0,0,0,7151,2,30,06,2,2016,2016-06-30,3,2016,7151,2
Bureau,Other Agencies,Consumer Financial Protection Bureau,null,0.0,0.0,205235,55,0,0,30,06,2,2016,2016-06-30,3,2016,205235,55
Agency,Federal Mediation/Conciliation Service,null,Non-CFO,0.0,0.0,0,0,0,0,30,06,2,2016,2016-06-30,3,2016,0,0
Bureau,Department of the Treasury,Office of Financial Research,null,0.0,0.0,36,1,0,0,30,06,2,2016,2016-06-30,3,2016,36,1
Bureau,Department of Transportation,Federal Highway Administration,null,100.0,100.0,0,0,22353,9,30,06,2,2016,2016-06-30,3,2016,22353,9
Agency,Legislative Branch-GPO,null,Non-CFO,0.0,0.0,1117462,140,0,0,30,06,2,2016,2016-06-30,3,2016,1117462,140
Agency,Federal Election Commission,null,Non-CFO,75.05301876996454,35.0,56699,13,170579,7,30,06,2,2016,2016-06-30,3,2016,227278,20
Bureau,Department of Transportation,Maritime Administration,null,100.0,100.0,0,0,7900,6,30,06,2,2016,2016-06-30,3,2016,7900,6
Bureau,Funds Appropriated to the President,Trade and Development Agency,null,100.0,100.0,0,0,24713,1,30,06,2,2016,2016-06-30,3,2016,24713,1
Agency,U.S. Postal Service,null,Non-CFO,71.46561281785344,40.0,15957000,3,39965000,2,30,06,2,2016,2016-06-30,3,2016,55922000,5
Agency,Securities & Exchange Commission,null,Non-CFO,99.98771044463321,96.12756264236901,265386,34,2159178077,844,30,06,2,2016,2016-06-30,3,2016,2159443463,878
Bureau,U.S. Court of Appeals / Veterans Claims,U.S. Court of Appeals / Veterans Claims,null,0.0,0.0,191,3,0,0,30,06,2,2016,2016-06-30,3,2016,191,3
Bureau,Department of the Treasury,Tobacco Tax and Trade,null,100.0,100.0,0,0,1000,1,30,06,2,2016,2016-06-30,3,2016,1000,1
Bureau,Department of Labor,Departmental Management,null,0.0,0.0,0,0,0,0,30,06,2,2016,2016-06-30,3,2016,0,0
Bureau,Department of Housing and Urban Development,Housing Programs,null,99.63995703777617,99.75364401560255,400931,12,110955502,4859,30,06,2,2016,2016-06-30,3,2016,111356433,4871
Agency,General Services Administration,null,CFO,79.99714597870913,66.5570690465007,3661322,2136,14642676,4251,30,06,2,2016,2016-06-30,3,2016,18303998,6387
Bureau,Funds Appropriated to the President,Inter-American Foundation,null,0.0,0.0,0,0,0,0,30,06,2,2016,2016-06-30,3,2016,0,0
Bureau,Other Agencies,U.S. Holocaust Memorial Council,null,0.0,0.0,0,0,0,0,30,06,2,2016,2016-06-30,3,2016,0,0
Bureau,Legislative Branch - U.S. House/Senate,U.S. House of Representatives,null,0.0,0.0,227325,215,0,0,30,06,2,2016,2016-06-30,3,2016,227325,215
Bureau,Department of the Treasury,Interest on Public Debt,null,100.0,100.0,0,0,9065441,3832,30,06,2,2016,2016-06-30,3,2016,9065441,3832
Bureau,Department of the Interior,Office of Surface Mining,null,100.0,100.0,0,0,1769328,205,30,06,2,2016,2016-06-30,3,2016,1769328,205
Agency,Social Security Administration,null,CFO,57.49122983770794,57.50857556810337,960392154,473940,1298887873,641438,30,06,2,2016,2016-06-30,3,2016,2259280027,1115378
Bureau,Other Agencies,James Madison Memorial Fellowship,null,0.0,0.0,228288,22,0,0,30,06,2,2016,2016-06-30,3,2016,228288,22
Bureau,Department of Homeland Security,Science and Technology,null,0.0,0.0,0,0,0,0,30,06,2,2016,2016-06-30,3,2016,0,0
Bureau,Federal Mediation/Conciliation Service,Federal Mediation/Conciliation Service,null,0.0,0.0,0,0,0,0,30,06,2,2016,2016-06-30,3,2016,0,0
Bureau,Other Agencies,Recovery and Acct. and Transparency Bd.,null,0.0,0.0,0,0,0,0,30,06,2,2016,2016-06-30,3,2016,0,0
Bureau,Other Agencies,Appalachian Regional Commission,null,0.0,0.0,0,0,0,0,30,06,2,2016,2016-06-30,3,2016,0,0
Bureau,Department of Health & Human Services,Indian Health Services,null,14.330309478189164,8.169727675744141,99527791,1450,16648409,129,30,06,2,2016,2016-06-30,3,2016,116176200,1579
Bureau,Other Agencies,Architect of the Capitol,null,0.0,0.0,0,0,0,0,30,06,2,2016,2016-06-30,3,2016,0,0
Bureau,Department of Health & Human Services,Office of the Inspector General,null,0.0,0.0,0,0,0,0,30,06,2,2016,2016-06-30,3,2016,0,0
Bureau,Department of the Interior,Bureau of Indian Affairs,null,87.41578291829087,85.3438042187928,1361756,3210,9459386,18692,30,06,2,2016,2016-06-30,3,2016,10821142,21902
Bureau,Department of Agriculture,Forest Service,null,24.34620086206414,3.467487111258939,152587625,11609,49104328,417,30,06,2,2016,2016-06-30,3,2016,201691953,12026
Agency,Agency for International Development,null,CFO,77.80669903039721,35.84905660377358,4645061,34,16284953,19,30,06,2,2016,2016-06-30,3,2016,20930014,53
Agency,Legislative Branch - U.S. House/Senate,null,Non-CFO,0.0,0.0,227325,215,0,0,30,06,2,2016,2016-06-30,3,2016,227325,215
Bureau,Other Agencies,John C. Stennis,null,0.0,0.0,0,0,0,0,30,06,2,2016,2016-06-30,3,2016,0,0
Bureau,Department of State,Passport NSF,null,100.0,100.0,0,0,1979645,12836,30,06,2,2016,2016-06-30,3,2016,1979645,12836
Agency,National Foundation  Arts & Humanities,null,Non-CFO,0.0,0.0,0,0,0,0,30,06,2,2016,2016-06-30,3,2016,0,0
Bureau,Agency for International Development,Agency for International Development,null,77.80669903039721,35.84905660377358,4645061,34,16284953,19,30,06,2,2016,2016-06-30,3,2016,20930014,53
Bureau,Department of Commerce,Minority Business Development Agency,null,0.0,0.0,0,0,0,0,30,06,2,2016,2016-06-30,3,2016,0,0
Bureau,Department of Commerce,Economic and Statistical Analysis,null,0.0,0.0,0,0,0,0,30,06,2,2016,2016-06-30,3,2016,0,0
Bureau,Department of Housing and Urban Development,"Policy, Development and Research",null,0.0,0.0,0,0,0,0,30,06,2,2016,2016-06-30,3,2016,0,0
Bureau,Department of Health & Human Services,Program Support Center,null,100.0,100.0,0,0,3255304,460,30,06,2,2016,2016-06-30,3,2016,3255304,460
Bureau,National Science Foundation,National Science Foundation,null,100.0,100.0,0,0,255868,14,30,06,2,2016,2016-06-30,3,2016,255868,14
Agency,Federal Communications Commission,null,Non-CFO,75.37992148781912,51.421896398936596,61392824,6030,187967973,6383,30,06,2,2016,2016-06-30,3,2016,249360797,12413
Bureau,Social Security Administration,Social Security Administration,null,57.49122983770794,57.50857556810337,960392154,473940,1298887873,641438,30,06,2,2016,2016-06-30,3,2016,2259280027,1115378
Bureau,Export - Import  Bank,Export-Import Bank,null,0.0,0.0,0,0,0,0,30,06,2,2016,2016-06-30,3,2016,0,0
Bureau,Occupational Safety & Health Rev Comm,Occupational Safety & Health Rev Comm,null,0.0,0.0,0,0,0,0,30,06,2,2016,2016-06-30,3,2016,0,0
Bureau,Department of Agriculture,Commodity Credit Corporation,null,98.98712296622337,98.30393487109905,1182111,200,115526133,11592,30,06,2,2016,2016-06-30,3,2016,116708244,11792
Agency,Department of the Treasury,null,CFO,99.49604665112511,99.18204697986577,153218,39,30249993,4729,30,06,2,2016,2016-06-30,3,2016,30403211,4768
Bureau,Smithsonian Institution,National Gallery of Art,null,0.0,0.0,0,0,0,0,30,06,2,2016,2016-06-30,3,2016,0,0
Bureau,Other Agencies,Millennium Challenge Corporation,null,0.0,0.0,0,0,0,0,30,06,2,2016,2016-06-30,3,2016,0,0
Bureau,Department of Veterans Affairs,Veterans Benefits,null,99.76460305365917,98.44780359135639,1289388,1683,546461133,106744,30,06,2,2016,2016-06-30,3,2016,547750521,108427
Agency,U.S. Court of Appeals / Veterans Claims,null,Non-CFO,0.0,0.0,191,3,0,0,30,06,2,2016,2016-06-30,3,2016,191,3
Bureau,Department of Homeland Security,Office of Biometric Identity Management,null,0.0,0.0,0,0,0,0,30,06,2,2016,2016-06-30,3,2016,0,0
Bureau,Department of Transportation,Federal Aviation Administration,null,93.26923167724797,81.96078431372548,285100,138,3950672,627,30,06,2,2016,2016-06-30,3,2016,4235772,765
Agency,Federal Maritime Commission,null,Non-CFO,100.0,100.0,0,0,472637,6,30,06,2,2016,2016-06-30,3,2016,472637,6
Bureau,Department of the Treasury,Bureau of Engraving and Printing,null,0.0,0.0,0,0,0,0,30,06,2,2016,2016-06-30,3,2016,0,0
Bureau,Department of Homeland Security,Management Headquarters,null,0.0,0.0,0,0,0,0,30,06,2,2016,2016-06-30,3,2016,0,0
Bureau,Federal Communications Commission,Federal Communications Commission,null,75.37992148781912,51.421896398936596,61392824,6030,187967973,6383,30,06,2,2016,2016-06-30,3,2016,249360797,12413
Bureau,Other Agencies,Election Assistance Commission,null,0.0,0.0,0,0,0,0,30,06,2,2016,2016-06-30,3,2016,0,0
Bureau,Other Agencies,Comm. to Elim Child Abuse & Neg. Fatal,null,0.0,0.0,0,0,0,0,30,06,2,2016,2016-06-30,3,2016,0,0
Bureau,Department of State,Civil Monetary Penalties,null,0.0,0.0,0,0,0,0,30,06,2,2016,2016-06-30,3,2016,0,0
Bureau,Department of Justice,Drug Enforcement Administration,null,100.0,100.0,0,0,273279,14,30,06,2,2016,2016-06-30,3,2016,273279,14
Bureau,Other Agencies/Boards/Commissions,U.S.-China Security Review Commission,null,0.0,0.0,1747,4,0,0,30,06,2,2016,2016-06-30,3,2016,1747,4
Bureau,Department of the Interior,Bureau of Safety and Environmental Enf.,null,100.0,100.0,0,0,25192,8,30,06,2,2016,2016-06-30,3,2016,25192,8
Bureau,Department of Homeland Security,Emergency Preparedness & Resp,null,100.0,100.0,0,0,274193332,47171,30,06,2,2016,2016-06-30,3,2016,274193332,47171
Agency,Overseas Private Investment Corp Accts,null,Non-CFO,0.0,0.0,0,0,0,0,30,06,2,2016,2016-06-30,3,2016,0,0
Bureau,Selective Service System,Selective Service System,null,0.0,0.0,1845,3,0,0,30,06,2,2016,2016-06-30,3,2016,1845,3
Bureau,American Battle Monuments Commission,American Battle Monuments Commission,null,0.0,0.0,0,0,0,0,30,06,2,2016,2016-06-30,3,2016,0,0
Bureau,Department of Commerce,Nat'l Institute of Standards& Technology,null,100.0,100.0,0,0,841255,13,30,06,2,2016,2016-06-30,3,2016,841255,13
Bureau,Funds Appropriated to the President,Peace Corps,null,0.0,0.0,0,0,0,0,30,06,2,2016,2016-06-30,3,2016,0,0
Bureau,Department of Transportation,St. Lawrence Seaway Development Corp.,null,0.0,0.0,0,0,0,0,30,06,2,2016,2016-06-30,3,2016,0,0
Bureau,Overseas Private Investment Corp Accts,Overseas Private Investment Corp Accts,null,0.0,0.0,0,0,0,0,30,06,2,2016,2016-06-30,3,2016,0,0
Bureau,Department of Housing and Urban Development,Community Planning and Development,null,0.0,0.0,0,0,0,0,30,06,2,2016,2016-06-30,3,2016,0,0
Bureau,Small Business Administration,Small Business Administration,null,89.69865718431825,93.05913272010513,1094191966,7923,9527646231,106227,30,06,2,2016,2016-06-30,3,2016,10621838197,114150
Bureau,Office of Special Counsel,Office of Special Counsel,null,0.0,0.0,0,0,0,0,30,06,2,2016,2016-06-30,3,2016,0,0
Bureau,Other Agencies,Archit.&Trans. Barriers Compliance Bd,null,0.0,0.0,0,0,0,0,30,06,2,2016,2016-06-30,3,2016,0,0
Bureau,Department of the Treasury,International Monetary Funds,null,0.0,0.0,0,0,0,0,30,06,2,2016,2016-06-30,3,2016,0,0
Bureau,Department of Agriculture,Food and Nutrition Service,null,0.042123527019208185,1.059001512859304,22334396,654,9412,7,30,06,2,2016,2016-06-30,3,2016,22343808,661
Bureau,Department of Labor,Mine Safety and Health Administration,null,94.71505116770729,92.53174010455564,3351760,1300,60069100,16107,30,06,2,2016,2016-06-30,3,2016,63420860,17407
Bureau,Department of State,International Commissions,null,0.0,0.0,0,0,0,0,30,06,2,2016,2016-06-30,3,2016,0,0
Bureau,Department of the Treasury,Treasury IG for Tax Admin,null,0.0,0.0,0,0,0,0,30,06,2,2016,2016-06-30,3,2016,0,0
Bureau,Other Agencies,Defense Nuclear Facilities Safety Board,null,0.0,0.0,0,0,0,0,30,06,2,2016,2016-06-30,3,2016,0,0
Bureau,Other Agencies/Boards/Commissions,Medicare Payment Advisory Commission,null,0.0,0.0,24,1,0,0,30,06,2,2016,2016-06-30,3,2016,24,1
Bureau,Nuclear Regulatory Commission,Nuclear Regulatory Commission,null,100.0,100.0,0,0,1205686,190,30,06,2,2016,2016-06-30,3,2016,1205686,190
Bureau,Department of Justice,General Administration,null,0.0,0.0,0,0,0,0,30,06,2,2016,2016-06-30,3,2016,0,0
Bureau,Department of the Interior,Bureau of Land Management,null,92.68147467504028,86.66666666666667,886631,42,11228255,273,30,06,2,2016,2016-06-30,3,2016,12114886,315
Bureau,Department of Health & Human Services,Substance Abuse & Mental Health Admin.,null,100.0,100.0,0,0,566997,10,30,06,2,2016,2016-06-30,3,2016,566997,10
Agency,Presidio Trust Corporation,null,Non-CFO,84.37522080477592,77.3841961852861,234402,83,1265792,284,30,06,2,2016,2016-06-30,3,2016,1500194,367
Bureau,Department of Veterans Affairs,Life Insurance,null,86.06746373960779,96.49122807017544,53476,2,330345,55,30,06,2,2016,2016-06-30,3,2016,383821,57
Bureau,National Credit Union Administration,National Credit Union Administration,null,0.0,0.0,0,0,0,0,30,06,2,2016,2016-06-30,3,2016,0,0
Bureau,National Aeronautics and Space Administration,National Aeronautics and Space Admin,null,100.0,100.0,0,0,469762,78,30,06,2,2016,2016-06-30,3,2016,469762,78
Bureau,Department of Homeland Security,Immigration and Customs Enforcement,null,100.0,100.0,0,0,6008070,331,30,06,2,2016,2016-06-30,3,2016,6008070,331
Bureau,Department of Homeland Security,Transportation Safety Administration,null,100.0,100.0,0,0,8170777,4191,30,06,2,2016,2016-06-30,3,2016,8170777,4191
Bureau,Environmental Protection Agency,Environmental Protection Agency,null,99.65262074929169,98.5,52079,3,14939893,197,30,06,2,2016,2016-06-30,3,2016,14991972,200
Bureau,Other Agencies/Boards/Commissions,Nuclear Waste Technical Review Board,null,0.0,0.0,0,0,0,0,30,06,2,2016,2016-06-30,3,2016,0,0
Bureau,Department of Justice,Legal Activities,null,99.88555672835058,99.83559121399448,75294,50,65716254,30362,30,06,2,2016,2016-06-30,3,2016,65791548,30412
Agency,National Aeronautics and Space Administration,null,CFO,100.0,100.0,0,0,469762,78,30,06,2,2016,2016-06-30,3,2016,469762,78
Bureau,Department of the Treasury,Interest on Tax/Deposit of Earnings,null,100.0,100.0,0,0,3240,2,30,06,2,2016,2016-06-30,3,2016,3240,2
Bureau,Department of Commerce,General Administration,null,100.0,100.0,0,0,4767,2,30,06,2,2016,2016-06-30,3,2016,4767,2
Bureau,Department of Housing and Urban Development,Management and Administration,null,0.0,0.0,75049,33,0,0,30,06,2,2016,2016-06-30,3,2016,75049,33
Bureau,Department of Agriculture,Food Safety and Inspection Service,null,100.0,100.0,0,0,965209,1303,30,06,2,2016,2016-06-30,3,2016,965209,1303
Bureau,Department of Health & Human Services,Administration for Children and Families,null,100.0,100.0,0,0,18415234,1020,30,06,2,2016,2016-06-30,3,2016,18415234,1020
Bureau,Department of Transportation,Pipeline Hazardous Material Safety Admin,null,100.0,100.0,0,0,384610,27,30,06,2,2016,2016-06-30,3,2016,384610,27
Bureau,Federal Election Commission,Federal Election Commission,null,75.05301876996454,35.0,56699,13,170579,7,30,06,2,2016,2016-06-30,3,2016,227278,20
Bureau,Legislative Branch-GPO,Government Publishing Office,null,0.0,0.0,1117462,140,0,0,30,06,2,2016,2016-06-30,3,2016,1117462,140
Bureau,Department of the Treasury,Financial Crimes Enforcement Network,null,100.0,100.0,0,0,1569506,4,30,06,2,2016,2016-06-30,3,2016,1569506,4
Bureau,Department of the Interior,Office of Natural Resources Revenue,null,100.0,100.0,0,0,11553496,141,30,06,2,2016,2016-06-30,3,2016,11553496,141
Agency,Department of the Interior,null,CFO,94.52685620514222,85.8909702209414,2287379,3525,39505402,21459,30,06,2,2016,2016-06-30,3,2016,41792781,24984
Bureau,Other Agencies,Advisory Council on Hist. Preservation,null,0.0,0.0,0,0,0,0,30,06,2,2016,2016-06-30,3,2016,0,0
Bureau,Other Agencies,Comm. for Purchase from Blind/Handic.,null,0.0,0.0,9358,6,0,0,30,06,2,2016,2016-06-30,3,2016,9358,6
Bureau,Department of Energy,Bonneville Power Administration,null,100.0,100.0,0,0,1122796,39,30,06,2,2016,2016-06-30,3,2016,1122796,39
Bureau,Department of Labor,Employment Standards Administration,null,28.19951555252178,27.60169906877961,41273229,8863,16209989,3379,30,06,2,2016,2016-06-30,3,2016,57483218,12242
Agency,Other Agencies,null,Non-CFO,1.2073504303705571,1.4492753623188406,615086,204,7517,3,30,06,2,2016,2016-06-30,3,2016,622603,207
Bureau,Department of the Treasury,Treasury Forfeiture Fund,null,0.0,0.0,0,0,0,0,30,06,2,2016,2016-06-30,3,2016,0,0
Bureau,Tennessee Valley Authority,Tennessee Valley Authority,null,0.0,0.0,0,0,0,0,30,06,2,2016,2016-06-30,3,2016,0,0
Bureau,Other Agencies,Federal Housing Finance Agency OIG,null,0.0,0.0,0,0,0,0,30,06,2,2016,2016-06-30,3,2016,0,0
Bureau,Department of Homeland Security,Office of the Inspector General DHS,null,0.0,0.0,1184,2,0,0,30,06,2,2016,2016-06-30,3,2016,1184,2
Bureau,Smithsonian Institution,Smithsonian Institution,null,0.0,0.0,0,0,0,0,30,06,2,2016,2016-06-30,3,2016,0,0
Bureau,Other Agencies,District of Columbia Government,null,0.0,0.0,145151,104,0,0,30,06,2,2016,2016-06-30,3,2016,145151,104
Bureau,Federal Maritime Commission,Salaries and Expenses,null,100.0,100.0,0,0,472637,6,30,06,2,2016,2016-06-30,3,2016,472637,6
Bureau,Federal Trade Commission,Federal Trade Commission,null,100.0,100.0,0,0,487119002,57,30,06,2,2016,2016-06-30,3,2016,487119002,57
Bureau,Merit Systems Protection Board,Merit Systems Protection Board,null,0.0,0.0,0,0,0,0,30,06,2,2016,2016-06-30,3,2016,0,0
Bureau,Smithsonian Institution,JFK Center for the Performing Arts,null,0.0,0.0,194,3,0,0,30,06,2,2016,2016-06-30,3,2016,194,3
Bureau,Department of Veterans Affairs,Administration and Cemeteries,null,0.7305002972133562,2.42024202420242,2079155,887,15300,22,30,06,2,2016,2016-06-30,3,2016,2094455,909
Agency,Legislative Branch-CBO,null,Non-CFO,0.0,0.0,0,0,0,0,30,06,2,2016,2016-06-30,3,2016,0,0
Bureau,Department of Commerce,Economic Development Administration,null,0.0,0.0,0,0,0,0,30,06,2,2016,2016-06-30,3,2016,0,0
Bureau,Department of the Treasury,U.S. Treasury IG Office,null,0.0,0.0,0,0,0,0,30,06,2,2016,2016-06-30,3,2016,0,0
Bureau,National Foundation  Arts & Humanities,National Endowment for the Humanities,null,0.0,0.0,0,0,0,0,30,06,2,2016,2016-06-30,3,2016,0,0
Bureau,Department of Health & Human Services,Office of the Secretary,null,0.0,0.0,0,0,0,0,30,06,2,2016,2016-06-30,3,2016,0,0
Bureau,Department of Housing and Urban Development,Government National Mortgage Association,null,0.0,0.0,0,0,0,0,30,06,2,2016,2016-06-30,3,2016,0,0
Bureau,Other Agencies,Chemical Safety Board,null,0.0,0.0,0,0,0,0,30,06,2,2016,2016-06-30,3,2016,0,0
Agency,National Archives & Records Admin,null,Non-CFO,75.23420796890184,62.0,6371,38,19354,62,30,06,2,2016,2016-06-30,3,2016,25725,100
Bureau,Legislative Branch-Office of Tech.,Open World Leadership,null,0.0,0.0,0,0,0,0,30,06,2,2016,2016-06-30,3,2016,0,0
Bureau,Other Agencies,Council of Insps. Gen. of Intg. & Effy.,null,0.0,0.0,0,0,0,0,30,06,2,2016,2016-06-30,3,2016,0,0
Agency,Commodity Futures Trading Commission,null,Non-CFO,89.42379690198185,93.96551724137932,36498857,14,308604737,218,30,06,2,2016,2016-06-30,3,2016,345103594,232
Bureau,Department of Transportation,Federal Transit Administration,null,100.0,100.0,0,0,834613,3,30,06,2,2016,2016-06-30,3,2016,834613,3
Agency,Smithsonian Institution,null,Non-CFO,0.0,0.0,194,3,0,0,30,06,2,2016,2016-06-30,3,2016,194,3
Agency,Department of Transportation,null,CFO,79.6956132096836,82.64028443345185,9974596,1123,39150729,5346,30,06,2,2016,2016-06-30,3,2016,49125325,6469
Bureau,Department of Housing and Urban Development,Public and Indian Housing Programs,null,0.0,0.0,0,0,0,0,30,06,2,2016,2016-06-30,3,2016,0,0
Agency,Small Business Administration,null,CFO,89.69865718431825,93.05913272010513,1094191966,7923,9527646231,106227,30,06,2,2016,2016-06-30,3,2016,10621838197,114150
Agency,Department of Health & Human Services,null,CFO,97.02864431522724,77.84914085864838,329014256,647039,10743852506,2274017,30,06,2,2016,2016-06-30,3,2016,11072866762,2921056
Agency,Neighborhood Reinvestment Corporation,null,Non-CFO,0.0,0.0,0,0,0,0,30,06,2,2016,2016-06-30,3,2016,0,0
Agency,Office of Personnel Management,null,CFO,20.872870004430876,35.16483516483517,59496110,1888,15694422,1024,30,06,2,2016,2016-06-30,3,2016,75190532,2912
Agency,Department of Housing and Urban Development,null,CFO,99.57284961892546,99.08238172920065,475980,45,110955502,4859,30,06,2,2016,2016-06-30,3,2016,111431482,4904
Agency,Department of Labor,null,CFO,63.229350111195025,64.97450424929178,62461148,12364,107405711,22936,30,06,2,2016,2016-06-30,3,2016,169866859,35300
Agency,Department of Homeland Security,null,CFO,99.96880111053558,99.7113924050633,98447,171,315448041,59079,30,06,2,2016,2016-06-30,3,2016,315546488,59250
Agency,Department of Justice,null,CFO,95.89156542856553,97.44299208090831,2931508,804,68421898,30639,30,06,2,2016,2016-06-30,3,2016,71353406,31443
Agency,National Labor Relations Board,null,Non-CFO,0.0,0.0,0,0,0,0,30,06,2,2016,2016-06-30,3,2016,0,0
Bureau,Department of Commerce,NOAA,null,100.0,100.0,0,0,5246546,617,30,06,2,2016,2016-06-30,3,2016,5246546,617
Bureau,Legislative Branch-GAO,Government Accountability Office,null,0.0,0.0,0,0,0,0,30,06,2,2016,2016-06-30,3,2016,0,0
Agency,Overseas Private Investment Corp Accts,null,Non-CFO,0.0,0.0,0,0,0,0,30,09,3,2016,2016-09-30,4,2016,0,0
Bureau,Department of Health & Human Services,Office of the Inspector General,null,0.0,0.0,0,0,0,0,30,09,3,2016,2016-09-30,4,2016,0,0
Agency,National Archives & Records Admin,null,Non-CFO,91.26105424413342,87.36842105263158,2510,12,26212,83,30,09,3,2016,2016-09-30,4,2016,28722,95
Bureau,Department of Commerce,Minority Business Development Agency,null,0.0,0.0,0,0,0,0,30,09,3,2016,2016-09-30,4,2016,0,0
Bureau,Department of Homeland Security,Management Headquarters,null,0.0,0.0,0,0,0,0,30,09,3,2016,2016-09-30,4,2016,0,0
Agency,Office of Government Ethics,null,Non-CFO,0.0,0.0,0,0,0,0,30,09,3,2016,2016-09-30,4,2016,0,0
Agency,Office of Personnel Management,null,CFO,20.513547237489735,34.883720930232556,61396561,1904,15844980,1020,30,09,3,2016,2016-09-30,4,2016,77241541,2924
Bureau,Department of Homeland Security,Office of Health Affairs,null,0.0,0.0,0,0,0,0,30,09,3,2016,2016-09-30,4,2016,0,0
Bureau,Department of the Treasury,Bureau of Engraving and Printing,null,100.0,100.0,0,0,84528,1,30,09,3,2016,2016-09-30,4,2016,84528,1
Bureau,Other Agencies,Denali Commission,null,0.0,0.0,611,1,0,0,30,09,3,2016,2016-09-30,4,2016,611,1
Bureau,Department of the Treasury,U.S. Treasury IG Office,null,0.0,0.0,0,0,0,0,30,09,3,2016,2016-09-30,4,2016,0,0
Bureau,Legislative Branch-GPO,Government Publishing Office,null,100.0,100.0,0,0,630,3,30,09,3,2016,2016-09-30,4,2016,630,3
Bureau,Department of Transportation,Federal Railroad Administration,null,100.0,100.0,0,0,86227,13,30,09,3,2016,2016-09-30,4,2016,86227,13
Bureau,Department of the Treasury,Bureau of the Fiscal Service,null,99.99224054316198,98.75776397515529,8,2,103092,159,30,09,3,2016,2016-09-30,4,2016,103100,161
Bureau,Armed Forces Retirement Home,Armed Forces Retirement Home,null,49.10643720060001,78.0,63107,22,60891,78,30,09,3,2016,2016-09-30,4,2016,123998,100
Bureau,Legislative Branch-Office of Tech.,Open World Leadership,null,0.0,0.0,0,0,0,0,30,09,3,2016,2016-09-30,4,2016,0,0
Bureau,Department of Agriculture,Food Safety and Inspection Service,null,100.0,100.0,0,0,888698,1090,30,09,3,2016,2016-09-30,4,2016,888698,1090
Bureau,Department of Transportation,Federal Motor Carrier Safety Admin,null,78.30038953265486,81.71238570241064,10037415,1100,36218784,4915,30,09,3,2016,2016-09-30,4,2016,46256199,6015
Bureau,Other Agencies/Boards/Commissions,U.S. Comm. on Int. Religious Freedom,null,0.0,0.0,141646,4,0,0,30,09,3,2016,2016-09-30,4,2016,141646,4
Bureau,Other Agencies,Architect of the Capitol,null,0.0,0.0,110072,51,0,0,30,09,3,2016,2016-09-30,4,2016,110072,51
Bureau,Department of Housing and Urban Development,Government National Mortgage Association,null,0.0,0.0,0,0,0,0,30,09,3,2016,2016-09-30,4,2016,0,0
Bureau,Department of Homeland Security,Citizenship and Immigration Services,null,100.0,100.0,0,0,907582,1112,30,09,3,2016,2016-09-30,4,2016,907582,1112
Bureau,Department of Energy,Bonneville Power Administration,null,100.0,100.0,0,0,1110633,35,30,09,3,2016,2016-09-30,4,2016,1110633,35
Bureau,Department of Transportation,National Highway Traffic Safety Admin.,null,99.9991999295938,83.33333333333333,61,1,7624268,5,30,09,3,2016,2016-09-30,4,2016,7624329,6
Bureau,Department of Health & Human Services,National Institutes of Health,null,50.512239644355695,24.068767908309457,4175267,265,4261702,84,30,09,3,2016,2016-09-30,4,2016,8436969,349
Agency,Funds Appropriated to the President,null,Non-CFO,97.97803591959719,100.0,510,0,24713,1,30,09,3,2016,2016-09-30,4,2016,25223,1
Agency,Legislative Branch-GAO,null,Non-CFO,100.0,100.0,0,0,70140,18,30,09,3,2016,2016-09-30,4,2016,70140,18
Bureau,Department of Energy,Energy Consolidated Reports,null,100.0,100.0,0,0,10379083,40,30,09,3,2016,2016-09-30,4,2016,10379083,40
Bureau,Department of Agriculture,Federal Crop Insurance Corporation,null,100.0,100.0,0,0,142938,360,30,09,3,2016,2016-09-30,4,2016,142938,360
Bureau,Department of the Treasury,Comptroller of the Currency,null,91.90037665882231,56.41025641025641,99950,17,1134058,22,30,09,3,2016,2016-09-30,4,2016,1234008,39
Agency,Federal Maritime Commission,null,Non-CFO,100.0,100.0,0,0,472637,6,30,09,3,2016,2016-09-30,4,2016,472637,6
Agency,Equal Employment Opportunity Commission,null,Non-CFO,72.07631495994183,22.4390243902439,178940,159,461878,46,30,09,3,2016,2016-09-30,4,2016,640818,205
Bureau,Department of the Interior,Bureau of Indian Affairs,null,95.98828431691635,52.31048748987588,420317,21786,10056921,23897,30,09,3,2016,2016-09-30,4,2016,10477238,45683
Agency,The Judiciary,null,Non-CFO,59.25773932340055,38.421052631578945,536105,117,779740,73,30,09,3,2016,2016-09-30,4,2016,1315845,190
Agency,Presidio Trust Corporation,null,Non-CFO,82.88557045162915,76.04166666666667,262350,23,1270567,73,30,09,3,2016,2016-09-30,4,2016,1532917,96
Bureau,Other Agencies,Gulf Coast Ecosystem Restoration Council,null,0.0,0.0,0,0,0,0,30,09,3,2016,2016-09-30,4,2016,0,0
Bureau,Other Agencies/Boards/Commissions,Medicare Payment Advisory Commission,null,0.0,0.0,0,0,0,0,30,09,3,2016,2016-09-30,4,2016,0,0
Bureau,National Foundation  Arts & Humanities,National Endowment for the Arts,null,0.0,0.0,0,0,0,0,30,09,3,2016,2016-09-30,4,2016,0,0
Bureau,Department of Health & Human Services,Indian Health Services,null,27.057227782996133,9.90990990990991,45967810,1200,17051196,132,30,09,3,2016,2016-09-30,4,2016,63019006,1332
Agency,Department of State,null,CFO,98.28093656194937,99.68569632550431,225466,55,12890164,17444,30,09,3,2016,2016-09-30,4,2016,13115630,17499
Agency,Railroad Retirement Board,null,Non-CFO,72.70975384735408,69.46892655367232,6100621,1351,16253963,3074,30,09,3,2016,2016-09-30,4,2016,22354584,4425
Bureau,Overseas Private Investment Corp Accts,Overseas Private Investment Corp Accts,null,0.0,0.0,0,0,0,0,30,09,3,2016,2016-09-30,4,2016,0,0
Agency,U.S. Postal Service,null,Non-CFO,74.39190539337682,0.0,14097000,0,40952000,0,30,09,3,2016,2016-09-30,4,2016,55049000,0
Agency,Environmental Protection Agency,null,CFO,99.56950248924579,98.4375,65388,3,15123550,189,30,09,3,2016,2016-09-30,4,2016,15188938,192
Agency,Department of the Treasury,null,CFO,98.53051254306118,99.22813036020584,467371,36,31337664,4628,30,09,3,2016,2016-09-30,4,2016,31805035,4664
Bureau,Department of the Treasury,Office of the Secretary,null,99.30772761146113,97.7469670710572,113853,13,16332419,564,30,09,3,2016,2016-09-30,4,2016,16446272,577
Bureau,Presidio Trust Corporation,Presidio Trust Corporation,null,82.88557045162915,76.04166666666667,262350,23,1270567,73,30,09,3,2016,2016-09-30,4,2016,1532917,96
Agency,Federal Communications Commission,null,Non-CFO,99.99947005875839,50.11598237067966,1003,12903,189265263,12963,30,09,3,2016,2016-09-30,4,2016,189266266,25866
Bureau,Department of the Treasury,Financial Crimes Enforcement Network,null,100.0,100.0,0,0,1568688,4,30,09,3,2016,2016-09-30,4,2016,1568688,4
Agency,Commodity Futures Trading Commission,null,Non-CFO,97.58319855658924,96.82539682539682,9859445,8,398094838,244,30,09,3,2016,2016-09-30,4,2016,407954283,252
Bureau,Department of the Interior,Bureau of Safety and Environmental Enf.,null,100.0,100.0,0,0,5922,1,30,09,3,2016,2016-09-30,4,2016,5922,1
Bureau,Department of the Treasury,Internal Revenue Service,null,98.82987115435182,97.87234042553192,3560,3,300680,138,30,09,3,2016,2016-09-30,4,2016,304240,141
Bureau,Federal Communications Commission,Federal Communications Commission,null,99.99947005875839,50.11598237067966,1003,12903,189265263,12963,30,09,3,2016,2016-09-30,4,2016,189266266,25866
Bureau,Department of the Treasury,Bureau of Public Debt,null,91.6305356892371,95.23809523809524,250000,1,2737049,20,30,09,3,2016,2016-09-30,4,2016,2987049,21
Agency,Department of Health & Human Services,null,CFO,97.73481435230448,96.11180029147546,251328245,73155,10843932104,1808307,30,09,3,2016,2016-09-30,4,2016,11095260349,1881462
Bureau,Department of Health & Human Services,Office of the Secretary,null,0.0,0.0,0,0,0,0,30,09,3,2016,2016-09-30,4,2016,0,0
Agency,Department of Education,null,CFO,46.38171380743912,38.64924869373797,72451374616,15349523,62673001340,9669768,30,09,3,2016,2016-09-30,4,2016,135124375956,25019291
Bureau,Department of Homeland Security,Emergency Preparedness & Resp,null,100.0,100.0,0,0,274740582,46629,30,09,3,2016,2016-09-30,4,2016,274740582,46629
Agency,Tennessee Valley Authority,null,Non-CFO,0.0,0.0,0,0,0,0,30,09,3,2016,2016-09-30,4,2016,0,0
Agency,Federal Deposit Insurance Corporation,null,Non-CFO,0.0,0.0,0,0,0,0,30,09,3,2016,2016-09-30,4,2016,0,0
Bureau,Legislative Branch-CBO,Congressional Budget Office,null,0.0,0.0,0,0,0,0,30,09,3,2016,2016-09-30,4,2016,0,0
Bureau,General Services Administration,General Services Administration,null,90.78569029594941,85.5705335105373,1577252,760,15540167,4507,30,09,3,2016,2016-09-30,4,2016,17117419,5267
Bureau,Funds Appropriated to the President,Executive Branch,null,0.0,0.0,0,0,0,0,30,09,3,2016,2016-09-30,4,2016,0,0
Bureau,Merit Systems Protection Board,Merit Systems Protection Board,null,0.0,0.0,0,0,0,0,30,09,3,2016,2016-09-30,4,2016,0,0
Bureau,Department of Transportation,Maritime Administration,null,100.0,100.0,0,0,7246,5,30,09,3,2016,2016-09-30,4,2016,7246,5
Bureau,Department of Agriculture,Food and Nutrition Service,null,0.04665167923684204,0.8997429305912596,19891393,771,9284,7,30,09,3,2016,2016-09-30,4,2016,19900677,778
Agency,Office of Compliance,null,Non-CFO,0.0,0.0,0,0,0,0,30,09,3,2016,2016-09-30,4,2016,0,0
Bureau,Office of Government Ethics,Office of Government Ethics,null,0.0,0.0,0,0,0,0,30,09,3,2016,2016-09-30,4,2016,0,0
Bureau,Department of Health & Human Services,Food and Drug Administration,null,83.60721580543235,16.69385535617183,3417397,3064,17429562,614,30,09,3,2016,2016-09-30,4,2016,20846959,3678
Agency,Merit Systems Protection Board,null,Non-CFO,0.0,0.0,0,0,0,0,30,09,3,2016,2016-09-30,4,2016,0,0
Bureau,Department of the Treasury,Office of Financial Research,null,100.0,100.0,0,0,36,1,30,09,3,2016,2016-09-30,4,2016,36,1
Agency,Farm Credit Administration,null,Non-CFO,0.0,0.0,0,0,0,0,30,09,3,2016,2016-09-30,4,2016,0,0
Bureau,Federal Election Commission,Federal Election Commission,null,53.23876153617148,17.647058823529413,157071,42,178829,9,30,09,3,2016,2016-09-30,4,2016,335900,51
Bureau,U.S. Court of Appeals / Veterans Claims,U.S. Court of Appeals / Veterans Claims,null,0.0,0.0,40,1,0,0,30,09,3,2016,2016-09-30,4,2016,40,1
Bureau,Department of Veterans Affairs,Life Insurance,null,87.24456328581005,97.14285714285714,53475,2,365758,68,30,09,3,2016,2016-09-30,4,2016,419233,70
Bureau,Department of Justice,Bureau of ATF and Explosives,null,94.65197129965235,53.84615384615385,1446,6,25592,7,30,09,3,2016,2016-09-30,4,2016,27038,13
Bureau,Federal Maritime Commission,Salaries and Expenses,null,100.0,100.0,0,0,472637,6,30,09,3,2016,2016-09-30,4,2016,472637,6
Bureau,Department of Justice,Federal Prison System,null,99.99960923609564,100.0,2,0,511816,63,30,09,3,2016,2016-09-30,4,2016,511818,63
Bureau,Department of Commerce,Bureau of the Census,null,100.0,100.0,0,0,44611,99,30,09,3,2016,2016-09-30,4,2016,44611,99
Bureau,Equal Employment Opportunity Commission,Equal Employment Opportunity Commission,null,72.07631495994183,22.4390243902439,178940,159,461878,46,30,09,3,2016,2016-09-30,4,2016,640818,205
Bureau,Department of Agriculture,Agricultural Marketing Service,null,70.75365084856794,76.97841726618705,206259,96,498988,321,30,09,3,2016,2016-09-30,4,2016,705247,417
Bureau,Department of Health & Human Services,Program Support Center,null,100.0,100.0,0,0,3206892,382,30,09,3,2016,2016-09-30,4,2016,3206892,382
Bureau,Department of Veterans Affairs,Administration and Cemeteries,null,0.6163878152526441,3.3532934131736525,3305167,807,20499,28,30,09,3,2016,2016-09-30,4,2016,3325666,835
Bureau,Department of Health & Human Services,Centers for Disease Control,null,1.0446782232622203,21.428571428571427,3984439,33,42064,9,30,09,3,2016,2016-09-30,4,2016,4026503,42
Bureau,Department of Transportation,Federal Aviation Administration,null,92.40413504975085,81.52610441767068,325044,138,3954179,609,30,09,3,2016,2016-09-30,4,2016,4279223,747
Agency,Export - Import  Bank,null,Non-CFO,0.0,0.0,0,0,0,0,30,09,3,2016,2016-09-30,4,2016,0,0
Bureau,Department of the Interior,National Park Service,null,99.99832966753785,99.94169096209913,81,1,4849253,1714,30,09,3,2016,2016-09-30,4,2016,4849334,1715
Bureau,Other Agencies,Advisory Council on Hist. Preservation,null,0.0,0.0,0,0,0,0,30,09,3,2016,2016-09-30,4,2016,0,0
Bureau,Farm Credit Administration,Farm Credit System Insurance Corporation,null,0.0,0.0,0,0,0,0,30,09,3,2016,2016-09-30,4,2016,0,0
Bureau,Department of Transportation,Federal Transit Administration,null,100.0,100.0,0,0,783404,1,30,09,3,2016,2016-09-30,4,2016,783404,1
Bureau,Legislative Branch-GAO,Government Accountability Office,null,100.0,100.0,0,0,70140,18,30,09,3,2016,2016-09-30,4,2016,70140,18
Bureau,Department of Veterans Affairs,Veterans Benefits,null,99.76379624310349,98.52802867637925,1277957,1659,539762125,111047,30,09,3,2016,2016-09-30,4,2016,541040082,112706
Bureau,Department of Labor,Occupational Safety and Health Admin,null,95.33526678740239,68.77380045696877,1508191,1640,30823583,3612,30,09,3,2016,2016-09-30,4,2016,32331774,5252
Bureau,Department of Agriculture,Rural Development,null,99.9990783658606,99.99469721073285,5087,2,551949293,37714,30,09,3,2016,2016-09-30,4,2016,551954380,37716
Bureau,Department of Labor,Employment Standards Administration,null,70.28672818976554,18.771560790912915,13308351,9654,31480897,2231,30,09,3,2016,2016-09-30,4,2016,44789248,11885
Bureau,Consumer Product Safety Commission,Consumer Product Safety Commission,null,100.0,100.0,0,0,416,1,30,09,3,2016,2016-09-30,4,2016,416,1
Bureau,Department of Agriculture,Farm Service Agency,null,99.89969406508493,100.0,663700,0,661012003,12953,30,09,3,2016,2016-09-30,4,2016,661675703,12953
Bureau,Department of Defense,Consolidated Report,null,50.068558219964,35.17925303928143,1039363492,547161,1042217682,296953,30,09,3,2016,2016-09-30,4,2016,2081581174,844114
Agency,Office of Special Counsel,null,Non-CFO,0.0,0.0,0,0,0,0,30,09,3,2016,2016-09-30,4,2016,0,0
Agency,U.S. Court of Appeals / Veterans Claims,null,Non-CFO,0.0,0.0,40,1,0,0,30,09,3,2016,2016-09-30,4,2016,40,1
Agency,Smithsonian Institution,null,Non-CFO,0.0,0.0,194,3,0,0,30,09,3,2016,2016-09-30,4,2016,194,3
Agency,Consumer Product Safety Commission,null,Non-CFO,100.0,100.0,0,0,416,1,30,09,3,2016,2016-09-30,4,2016,416,1
Bureau,Department of the Interior,Geological Survey,null,100.0,100.0,0,0,74943,162,30,09,3,2016,2016-09-30,4,2016,74943,162
Bureau,Securities & Exchange Commission,Securities and Exchange Commission,null,99.99316693759488,97.58220502901354,169574,25,2481499551,1009,30,09,3,2016,2016-09-30,4,2016,2481669125,1034
Bureau,Social Security Administration,Social Security Administration,null,39.10904267925975,28.486211046648524,3498859016,1801024,2247247089,717405,30,09,3,2016,2016-09-30,4,2016,5746106105,2518429
Bureau,Funds Appropriated to the President,Defense Security Assistance Agency,null,0.0,0.0,510,0,0,0,30,09,3,2016,2016-09-30,4,2016,510,0
Bureau,Department of the Interior,Bureau of Reclamation,null,100.0,100.0,0,0,111309,81,30,09,3,2016,2016-09-30,4,2016,111309,81
Agency,Other Agencies,null,Non-CFO,0.0,0.0,1003023,249,0,0,30,09,3,2016,2016-09-30,4,2016,1003023,249
Bureau,Department of Education,Office of Postsecondary Education,null,0.0,0.0,0,0,0,0,30,09,3,2016,2016-09-30,4,2016,0,0
Bureau,Other Agencies,Federal Housing Finance Agency,null,0.0,0.0,0,0,0,0,30,09,3,2016,2016-09-30,4,2016,0,0
Bureau,Department of the Interior,Office of Surface Mining,null,100.0,100.0,0,0,1833697,214,30,09,3,2016,2016-09-30,4,2016,1833697,214
Agency,Department of Housing and Urban Development,null,CFO,90.73314982568282,99.38373048479869,11344340,30,111074171,4838,30,09,3,2016,2016-09-30,4,2016,122418511,4868
Bureau,Other Agencies,Chemical Safety Board,null,0.0,0.0,0,0,0,0,30,09,3,2016,2016-09-30,4,2016,0,0
Bureau,Other Agencies,Millennium Challenge Corporation,null,0.0,0.0,0,0,0,0,30,09,3,2016,2016-09-30,4,2016,0,0
Bureau,Legislative Branch - U.S. House/Senate,U.S. House of Representatives,null,0.0,0.0,204998,182,0,0,30,09,3,2016,2016-09-30,4,2016,204998,182
Bureau,The Judiciary,Administrative Office of the U.S. Courts,null,59.25773932340055,38.421052631578945,536105,117,779740,73,30,09,3,2016,2016-09-30,4,2016,1315845,190
Bureau,Department of Labor,Mine Safety and Health Administration,null,92.1574733318441,87.85299806576403,5161876,2198,60657167,15897,30,09,3,2016,2016-09-30,4,2016,65819043,18095
Bureau,Smithsonian Institution,Smithsonian Institution,null,0.0,0.0,0,0,0,0,30,09,3,2016,2016-09-30,4,2016,0,0
Bureau,Other Agencies,Comm. for Purchase from Blind/Handic.,null,0.0,0.0,8945,5,0,0,30,09,3,2016,2016-09-30,4,2016,8945,5
Bureau,Department of Justice,Legal Activities,null,99.89602303462173,99.83045873952594,69748,52,67010494,30619,30,09,3,2016,2016-09-30,4,2016,67080242,30671
Bureau,Commodity Futures Trading Commission,Commodity Futures Trading Commission,null,97.58319855658924,96.82539682539682,9859445,8,398094838,244,30,09,3,2016,2016-09-30,4,2016,407954283,252
Bureau,Department of Commerce,Nat'l Telecomm & Information Admin.,null,0.0,0.0,0,0,0,0,30,09,3,2016,2016-09-30,4,2016,0,0
Bureau,Small Business Administration,Small Business Administration,null,99.29687453290626,99.57490073713089,75805790,485,10705454959,113606,30,09,3,2016,2016-09-30,4,2016,10781260749,114091
Bureau,Department of Transportation,Office of the Inspector General,null,0.0,0.0,12744,2,0,0,30,09,3,2016,2016-09-30,4,2016,12744,2
Bureau,Department of Health & Human Services,Centers for Medicare & Medicaid Services,null,98.22489048482839,96.34012950647532,193783332,68593,10722913939,1805599,30,09,3,2016,2016-09-30,4,2016,10916697271,1874192
Agency,Corp. for National and Community Service,null,Non-CFO,99.6788378872474,94.33962264150944,9815,12,3046274,200,30,09,3,2016,2016-09-30,4,2016,3056089,212
Bureau,National Credit Union Administration,National Credit Union Administration,null,0.0,0.0,0,0,0,0,30,09,3,2016,2016-09-30,4,2016,0,0
Bureau,Pension Benefit Guaranty Corp,Pension Benefit Guaranty Corporation,null,31.728876765787696,31.322505800464036,4884379,592,2270006,270,30,09,3,2016,2016-09-30,4,2016,7154385,862
Bureau,Federal Trade Commission,Federal Trade Commission,null,100.0,100.0,0,0,483163064,56,30,09,3,2016,2016-09-30,4,2016,483163064,56
Bureau,Department of Education,Federal Student Aid,null,46.18308120529657,38.645383880636345,72407148746,15349369,62136318936,9668095,30,09,3,2016,2016-09-30,4,2016,134543467682,25017464
Bureau,Department of Agriculture,Forest Service,null,43.66590333446148,6.16365568544102,50409251,6181,39073414,406,30,09,3,2016,2016-09-30,4,2016,89482665,6587
Agency,Legis Branch-Library of Congress,null,Non-CFO,0.0,0.0,0,0,0,0,30,09,3,2016,2016-09-30,4,2016,0,0
Bureau,Department of Commerce,National Technical Information Service,null,0.0,0.0,15454,31,0,0,30,09,3,2016,2016-09-30,4,2016,15454,31
Bureau,Department of State,Department of State,null,97.97251108643809,98.81812212738016,225322,54,10888031,4515,30,09,3,2016,2016-09-30,4,2016,11113353,4569
Bureau,National Labor Relations Board,National Labor Relations Board,null,0.0,0.0,0,0,0,0,30,09,3,2016,2016-09-30,4,2016,0,0
Bureau,Department of State,Civil Monetary Penalties,null,0.0,0.0,0,0,0,0,30,09,3,2016,2016-09-30,4,2016,0,0
Bureau,Department of the Treasury,Treasury Forfeiture Fund,null,0.0,0.0,0,0,0,0,30,09,3,2016,2016-09-30,4,2016,0,0
Agency,National Science Foundation,null,CFO,100.0,100.0,0,0,946334,14,30,09,3,2016,2016-09-30,4,2016,946334,14
Agency,National Credit Union Administration,null,Non-CFO,0.0,0.0,0,0,0,0,30,09,3,2016,2016-09-30,4,2016,0,0
Bureau,Funds Appropriated to the President,Peace Corps,null,0.0,0.0,0,0,0,0,30,09,3,2016,2016-09-30,4,2016,0,0
Bureau,Other Agencies,Japan-U.S. Friendship Commission,null,0.0,0.0,0,0,0,0,30,09,3,2016,2016-09-30,4,2016,0,0
Bureau,Department of Homeland Security,Office of Biometric Identity Management,null,0.0,0.0,0,0,0,0,30,09,3,2016,2016-09-30,4,2016,0,0
Bureau,Other Agencies,Election Assistance Commission,null,0.0,0.0,0,0,0,0,30,09,3,2016,2016-09-30,4,2016,0,0
Bureau,Other Agencies,Comm. to Elim Child Abuse & Neg. Fatal,null,0.0,0.0,0,0,0,0,30,09,3,2016,2016-09-30,4,2016,0,0
Bureau,Selective Service System,Selective Service System,null,100.0,100.0,0,0,1578,1,30,09,3,2016,2016-09-30,4,2016,1578,1
Agency,Occupational Safety & Health Rev Comm,null,Non-CFO,0.0,0.0,0,0,0,0,30,09,3,2016,2016-09-30,4,2016,0,0
Bureau,Smithsonian Institution,Administrative Conference of the US,null,0.0,0.0,0,0,0,0,30,09,3,2016,2016-09-30,4,2016,0,0
Bureau,Other Agencies,Appraisal Subcommittee,null,0.0,0.0,0,0,0,0,30,09,3,2016,2016-09-30,4,2016,0,0
Bureau,Department of Commerce,Economic and Statistical Analysis,null,0.0,0.0,0,0,0,0,30,09,3,2016,2016-09-30,4,2016,0,0
Agency,Pension Benefit Guaranty Corp,null,Non-CFO,31.728876765787696,31.322505800464036,4884379,592,2270006,270,30,09,3,2016,2016-09-30,4,2016,7154385,862
Bureau,Office of Compliance,Office of Compliance,null,0.0,0.0,0,0,0,0,30,09,3,2016,2016-09-30,4,2016,0,0
Bureau,Department of the Treasury,Interest on Tax/Deposit of Earnings,null,100.0,100.0,0,0,3240,2,30,09,3,2016,2016-09-30,4,2016,3240,2
Agency,Department of Transportation,null,CFO,82.49569033273923,81.63413923681911,10535179,1261,49651022,5605,30,09,3,2016,2016-09-30,4,2016,60186201,6866
Agency,Armed Forces Retirement Home,null,Non-CFO,49.10643720060001,78.0,63107,22,60891,78,30,09,3,2016,2016-09-30,4,2016,123998,100
Bureau,Department of State,International Commissions,null,0.0,0.0,0,0,0,0,30,09,3,2016,2016-09-30,4,2016,0,0
Agency,Federal Trade Commission,null,Non-CFO,100.0,100.0,0,0,483163064,56,30,09,3,2016,2016-09-30,4,2016,483163064,56
Bureau,Railroad Retirement Board,Railroad Retirement Board,null,72.70975384735408,69.46892655367232,6100621,1351,16253963,3074,30,09,3,2016,2016-09-30,4,2016,22354584,4425
Agency,Legislative Branch-CBO,null,Non-CFO,0.0,0.0,0,0,0,0,30,09,3,2016,2016-09-30,4,2016,0,0
Agency,Legislative Branch-GPO,null,Non-CFO,100.0,100.0,0,0,630,3,30,09,3,2016,2016-09-30,4,2016,630,3
Agency,American Battle Monuments Commission,null,Non-CFO,0.0,0.0,0,0,0,0,30,09,3,2016,2016-09-30,4,2016,0,0
Bureau,Other Agencies,National Mediation Board,null,0.0,0.0,0,0,0,0,30,09,3,2016,2016-09-30,4,2016,0,0
Bureau,Department of Veterans Affairs,Medical and Construction,null,78.99748569480715,97.26787813006639,104752904,163818,394010732,5832181,30,09,3,2016,2016-09-30,4,2016,498763636,5995999
Bureau,Legislative Branch-Office of Tech.,Medicaid & CHIP Payment & Access Comm.,null,0.0,0.0,0,0,0,0,30,09,3,2016,2016-09-30,4,2016,0,0
Bureau,Department of State,Passport NSF,null,99.9928081878781,99.99226604795051,144,1,2002133,12929,30,09,3,2016,2016-09-30,4,2016,2002277,12930
Agency,Federal Labor Relations Authority,null,Non-CFO,0.0,0.0,0,0,0,0,30,09,3,2016,2016-09-30,4,2016,0,0
Bureau,Legis Branch-Library of Congress,Library of Congress,null,0.0,0.0,0,0,0,0,30,09,3,2016,2016-09-30,4,2016,0,0
Bureau,Other Agencies,Christopher Columbus Fellowship Found,null,0.0,0.0,0,0,0,0,30,09,3,2016,2016-09-30,4,2016,0,0
Bureau,Other Agencies,Defense Nuclear Facilities Safety Board,null,0.0,0.0,0,0,0,0,30,09,3,2016,2016-09-30,4,2016,0,0
Bureau,Other Agencies,Delta Regional Authority,null,0.0,0.0,0,0,0,0,30,09,3,2016,2016-09-30,4,2016,0,0
Bureau,Other Agencies,Consumer Financial Protection Bureau,null,0.0,0.0,225997,56,0,0,30,09,3,2016,2016-09-30,4,2016,225997,56
Bureau,Department of Health & Human Services,Administration for Community Living,null,0.0,0.0,0,0,0,0,30,09,3,2016,2016-09-30,4,2016,0,0
Bureau,National Credit Union Administration,Nat'l Credit Union Admin. Treasury Acct.,null,0.0,0.0,0,0,0,0,30,09,3,2016,2016-09-30,4,2016,0,0
Bureau,Other Agencies,Recovery and Acct. and Transparency Bd.,null,0.0,0.0,0,0,0,0,30,09,3,2016,2016-09-30,4,2016,0,0
Bureau,Department of Housing and Urban Development,Housing Programs,null,99.78261107821183,99.48591404482829,241989,25,111074171,4838,30,09,3,2016,2016-09-30,4,2016,111316160,4863
Bureau,Smithsonian Institution,National Gallery of Art,null,0.0,0.0,0,0,0,0,30,09,3,2016,2016-09-30,4,2016,0,0
Bureau,Funds Appropriated to the President,African Development Foundation,null,0.0,0.0,0,0,0,0,30,09,3,2016,2016-09-30,4,2016,0,0
Bureau,Department of Homeland Security,Federal Law Enforcement Training Ctr.,null,100.0,100.0,0,0,16969,6,30,09,3,2016,2016-09-30,4,2016,16969,6
Bureau,Department of Commerce,Economic Development Administration,null,0.0,0.0,0,0,0,0,30,09,3,2016,2016-09-30,4,2016,0,0
Bureau,Environmental Protection Agency,Environmental Protection Agency,null,99.56950248924579,98.4375,65388,3,15123550,189,30,09,3,2016,2016-09-30,4,2016,15188938,192
Bureau,Office of Personnel Management,Office of Personnel Management,null,20.513547237489735,34.883720930232556,61396561,1904,15844980,1020,30,09,3,2016,2016-09-30,4,2016,77241541,2924
Bureau,National Foundation  Arts & Humanities,National Endowment for the Humanities,null,0.0,0.0,0,0,0,0,30,09,3,2016,2016-09-30,4,2016,0,0
Bureau,Department of Agriculture,Commodity Credit Corporation,null,99.92088530009414,99.66908147750648,94307,37,119108572,11144,30,09,3,2016,2016-09-30,4,2016,119202879,11181
Bureau,Funds Appropriated to the President,Inter-American Foundation,null,0.0,0.0,0,0,0,0,30,09,3,2016,2016-09-30,4,2016,0,0
Agency,Department of Homeland Security,null,CFO,99.99967468947446,99.99662919454603,1129,2,347051890,59331,30,09,3,2016,2016-09-30,4,2016,347053019,59333
Agency,Selective Service System,null,Non-CFO,100.0,100.0,0,0,1578,1,30,09,3,2016,2016-09-30,4,2016,1578,1
Bureau,Department of the Treasury,Treasury IG for Tax Admin,null,0.0,0.0,0,0,0,0,30,09,3,2016,2016-09-30,4,2016,0,0
Bureau,Department of Housing and Urban Development,"Policy, Development and Research",null,0.0,0.0,0,0,0,0,30,09,3,2016,2016-09-30,4,2016,0,0
Bureau,Department of Homeland Security,U.S. Secret Service,null,0.0,0.0,0,0,0,0,30,09,3,2016,2016-09-30,4,2016,0,0
Bureau,Other Agencies,Archit.&Trans. Barriers Compliance Bd,null,0.0,0.0,0,0,0,0,30,09,3,2016,2016-09-30,4,2016,0,0
Bureau,Department of the Interior,"Bureau of Ocean Energy Mgmt., Reg & Enf",null,0.0,0.0,0,0,0,0,30,09,3,2016,2016-09-30,4,2016,0,0
Agency,Other Agencies/Boards/Commissions,null,Non-CFO,0.0,0.0,143393,8,0,0,30,09,3,2016,2016-09-30,4,2016,143393,8
Bureau,Other Agencies,U.S. Institute of Peace,null,0.0,0.0,4054,5,0,0,30,09,3,2016,2016-09-30,4,2016,4054,5
Agency,Legislative Branch - U.S. House/Senate,null,Non-CFO,0.0,0.0,204998,182,0,0,30,09,3,2016,2016-09-30,4,2016,204998,182
Agency,Legislative Branch-Office of Tech.,null,Non-CFO,0.0,0.0,0,0,0,0,30,09,3,2016,2016-09-30,4,2016,0,0
Agency,Department of Commerce,null,CFO,99.7508511444001,97.53184713375796,15455,31,6187664,1225,30,09,3,2016,2016-09-30,4,2016,6203119,1256
Bureau,Department of Health & Human Services,Administration for Children and Families,null,100.0,100.0,0,0,16046405,1052,30,09,3,2016,2016-09-30,4,2016,16046405,1052
Bureau,Department of Commerce,Office of the Inspector General,null,0.0,0.0,0,0,0,0,30,09,3,2016,2016-09-30,4,2016,0,0
Bureau,Other Agencies,National Capital Planning Commission,null,0.0,0.0,0,0,0,0,30,09,3,2016,2016-09-30,4,2016,0,0
Bureau,Department of Commerce,Bureau of Industry and Security,null,0.0,0.0,0,0,0,0,30,09,3,2016,2016-09-30,4,2016,0,0
Bureau,Other Agencies,U.S. Holocaust Memorial Council,null,0.0,0.0,0,0,0,0,30,09,3,2016,2016-09-30,4,2016,0,0
Bureau,Department of Homeland Security,Domestic Nuclear Detection Office,null,0.0,0.0,0,0,0,0,30,09,3,2016,2016-09-30,4,2016,0,0
Bureau,Corp. for National and Community Service,Corp. for National and Community Service,null,99.6788378872474,94.33962264150944,9815,12,3046274,200,30,09,3,2016,2016-09-30,4,2016,3056089,212
Agency,Department of Veterans Affairs,null,CFO,87.4367517851063,97.27318479505269,134359141,166608,935102663,5943377,30,09,3,2016,2016-09-30,4,2016,1069461804,6109985
Bureau,Department of Transportation,Pipeline Hazardous Material Safety Admin,null,70.75053774454574,56.52173913043478,159915,20,386813,26,30,09,3,2016,2016-09-30,4,2016,546728,46
Bureau,Other Agencies,James Madison Memorial Fellowship,null,0.0,0.0,242354,21,0,0,30,09,3,2016,2016-09-30,4,2016,242354,21
Agency,Department of Agriculture,null,CFO,94.40782574726413,86.81123261492728,82053077,9938,1385230904,65414,30,09,3,2016,2016-09-30,4,2016,1467283981,75352
Agency,Federal Mediation/Conciliation Service,null,Non-CFO,0.0,0.0,0,0,0,0,30,09,3,2016,2016-09-30,4,2016,0,0
Agency,Neighborhood Reinvestment Corporation,null,Non-CFO,0.0,0.0,0,0,0,0,30,09,3,2016,2016-09-30,4,2016,0,0
Bureau,Department of Homeland Security,Info Analysis Infrastructure Prot-NPPD,null,100.0,100.0,0,0,4610,1,30,09,3,2016,2016-09-30,4,2016,4610,1
Bureau,Federal Mediation/Conciliation Service,Federal Mediation/Conciliation Service,null,0.0,0.0,0,0,0,0,30,09,3,2016,2016-09-30,4,2016,0,0
Bureau,Smithsonian Institution,JFK Center for the Performing Arts,null,0.0,0.0,194,3,0,0,30,09,3,2016,2016-09-30,4,2016,194,3
Bureau,National Archives & Records Admin,Nat'l Archives & Records Administration,null,91.26105424413342,87.36842105263158,2510,12,26212,83,30,09,3,2016,2016-09-30,4,2016,28722,95
Bureau,Department of Commerce,International Trade Administration,null,0.0,0.0,0,0,0,0,30,09,3,2016,2016-09-30,4,2016,0,0
Bureau,Department of Health & Human Services,Substance Abuse & Mental Health Admin.,null,100.0,100.0,0,0,576127,10,30,09,3,2016,2016-09-30,4,2016,576127,10
Bureau,Federal Deposit Insurance Corporation,Federal Deposit Insurance Corporation,null,0.0,0.0,0,0,0,0,30,09,3,2016,2016-09-30,4,2016,0,0
Bureau,Other Agencies,John C. Stennis,null,0.0,0.0,0,0,0,0,30,09,3,2016,2016-09-30,4,2016,0,0
Bureau,National Science Foundation,National Science Foundation,null,100.0,100.0,0,0,946334,14,30,09,3,2016,2016-09-30,4,2016,946334,14
Bureau,Department of the Interior,Bureau of Land Management,null,100.0,100.0,0,0,11268699,304,30,09,3,2016,2016-09-30,4,2016,11268699,304
Bureau,Department of Labor,Employee Benefit Security Administration,null,100.0,100.0,0,0,16332448,351,30,09,3,2016,2016-09-30,4,2016,16332448,351
Bureau,Other Agencies,Marine Mammal Commission,null,0.0,0.0,0,0,0,0,30,09,3,2016,2016-09-30,4,2016,0,0
Bureau,Other Agencies,Surface Transportation Board,null,0.0,0.0,0,0,0,0,30,09,3,2016,2016-09-30,4,2016,0,0
Bureau,Department of Education,Departmental Management,null,92.38677223592101,91.57088122605364,44225870,154,536682404,1673,30,09,3,2016,2016-09-30,4,2016,580908274,1827
Bureau,Department of the Interior,Office of Natural Resources Revenue,null,100.0,100.0,0,0,11007826,139,30,09,3,2016,2016-09-30,4,2016,11007826,139
Bureau,Department of Commerce,Patent and Trademark Office,null,100.0,100.0,0,0,163794,410,30,09,3,2016,2016-09-30,4,2016,163794,410
Bureau,Department of Justice,Drug Enforcement Administration,null,100.0,100.0,0,0,273279,14,30,09,3,2016,2016-09-30,4,2016,273279,14
Bureau,Department of the Interior,Fish and Wildlife Service,null,100.0,100.0,0,0,414805,107,30,09,3,2016,2016-09-30,4,2016,414805,107
Bureau,Neighborhood Reinvestment Corporation,Neighborhood Reinvestment Corporation,null,0.0,0.0,0,0,0,0,30,09,3,2016,2016-09-30,4,2016,0,0
Bureau,Department of the Treasury,Tobacco Tax and Trade,null,100.0,100.0,0,0,1000,1,30,09,3,2016,2016-09-30,4,2016,1000,1
Bureau,Department of Transportation,Research Innovative Technology Admin,null,100.0,100.0,0,0,4994,2,30,09,3,2016,2016-09-30,4,2016,4994,2
Bureau,Department of Housing and Urban Development,Community Planning and Development,null,0.0,0.0,11102351,2,0,0,30,09,3,2016,2016-09-30,4,2016,11102351,2
Bureau,Department of Agriculture,U.S. Department of Agriculture,null,53.78177013606995,33.231850117096016,10783080,2851,12547714,1419,30,09,3,2016,2016-09-30,4,2016,23330794,4270
Bureau,Department of Justice,Federal Prison Industries,null,71.78600828836181,80.26315789473684,400997,45,1020273,183,30,09,3,2016,2016-09-30,4,2016,1421270,228
Agency,Department of Justice,null,CFO,98.39931617892381,97.69875138296192,1134311,728,69729840,30907,30,09,3,2016,2016-09-30,4,2016,70864151,31635
Bureau,Tennessee Valley Authority,Tennessee Valley Authority,null,0.0,0.0,0,0,0,0,30,09,3,2016,2016-09-30,4,2016,0,0
Bureau,Other Agencies,Council of Insps. Gen. of Intg. & Effy.,null,0.0,0.0,0,0,0,0,30,09,3,2016,2016-09-30,4,2016,0,0
Bureau,Funds Appropriated to the President,Trade and Development Agency,null,100.0,100.0,0,0,24713,1,30,09,3,2016,2016-09-30,4,2016,24713,1
Bureau,Department of Labor,Employment and Training Administration,null,100.0,100.0,0,0,3034975,4,30,09,3,2016,2016-09-30,4,2016,3034975,4
Bureau,Department of Labor,Departmental Management,null,0.0,0.0,0,0,0,0,30,09,3,2016,2016-09-30,4,2016,0,0
Bureau,Department of Transportation,Surface Transportation Board,null,0.0,0.0,0,0,0,0,30,09,3,2016,2016-09-30,4,2016,0,0
Bureau,Department of the Treasury,International Monetary Funds,null,0.0,0.0,0,0,0,0,30,09,3,2016,2016-09-30,4,2016,0,0
Bureau,Department of the Interior,Office of the Secretary,null,100.0,100.0,0,0,59378,67,30,09,3,2016,2016-09-30,4,2016,59378,67
Bureau,Department of Commerce,General Administration,null,99.97902684563758,100.0,1,0,4767,2,30,09,3,2016,2016-09-30,4,2016,4768,2
Bureau,Department of Transportation,St. Lawrence Seaway Development Corp.,null,0.0,0.0,0,0,0,0,30,09,3,2016,2016-09-30,4,2016,0,0
Bureau,Other Agencies,U.S.  Agency of Global Media,null,0.0,0.0,5250,1,0,0,30,09,3,2016,2016-09-30,4,2016,5250,1
Bureau,U.S. Postal Service,U.S. Postal Service,null,74.39190539337682,0.0,14097000,0,40952000,0,30,09,3,2016,2016-09-30,4,2016,55049000,0
Agency,National Labor Relations Board,null,Non-CFO,0.0,0.0,0,0,0,0,30,09,3,2016,2016-09-30,4,2016,0,0
Bureau,Office of Special Counsel,Office of Special Counsel,null,0.0,0.0,0,0,0,0,30,09,3,2016,2016-09-30,4,2016,0,0
Bureau,Other Agencies,Federal Mine Safety & Health Review Comm,null,0.0,0.0,0,0,0,0,30,09,3,2016,2016-09-30,4,2016,0,0
Bureau,Nuclear Regulatory Commission,Nuclear Regulatory Commission,null,100.0,100.0,0,0,1396554,199,30,09,3,2016,2016-09-30,4,2016,1396554,199
Bureau,Department of Homeland Security,Bureau of Customs & Border Protection,null,100.0,100.0,0,0,6499205,491,30,09,3,2016,2016-09-30,4,2016,6499205,491
Bureau,Department of the Treasury,Interest on Public Debt,null,100.0,100.0,0,0,9028100,3706,30,09,3,2016,2016-09-30,4,2016,9028100,3706
Agency,Department of Defense,null,CFO,50.068558219964,35.17925303928143,1039363492,547161,1042217682,296953,30,09,3,2016,2016-09-30,4,2016,2081581174,844114
Agency,Federal Election Commission,null,Non-CFO,53.23876153617148,17.647058823529413,157071,42,178829,9,30,09,3,2016,2016-09-30,4,2016,335900,51
Agency,Securities & Exchange Commission,null,Non-CFO,99.99316693759488,97.58220502901354,169574,25,2481499551,1009,30,09,3,2016,2016-09-30,4,2016,2481669125,1034
Bureau,Department of the Treasury,Spec Insp Gen-Troubled Asset Rel Prog,null,100.0,100.0,0,0,3916,1,30,09,3,2016,2016-09-30,4,2016,3916,1
Bureau,Department of Transportation,Office of the Secretary,null,100.0,100.0,0,0,572382,20,30,09,3,2016,2016-09-30,4,2016,572382,20
Bureau,Department of Health & Human Services,Health Resources and Services Admin,null,100.0,100.0,0,0,62404217,425,30,09,3,2016,2016-09-30,4,2016,62404217,425
Agency,National Aeronautics and Space Administration,null,CFO,100.0,100.0,0,0,459520,75,30,09,3,2016,2016-09-30,4,2016,459520,75
Agency,Department of the Interior,null,CFO,98.95170830840699,55.0533286571906,420398,21787,39682753,26686,30,09,3,2016,2016-09-30,4,2016,40103151,48473
Agency,National Foundation  Arts & Humanities,null,Non-CFO,0.0,0.0,0,0,0,0,30,09,3,2016,2016-09-30,4,2016,0,0
Bureau,Department of Justice,Federal Bureau of Investigation,null,0.0,0.0,662118,625,0,0,30,09,3,2016,2016-09-30,4,2016,662118,625
Bureau,Department of Justice,Office of Justice Assistance Programs,null,100.0,100.0,0,0,888386,21,30,09,3,2016,2016-09-30,4,2016,888386,21
Bureau,Department of Homeland Security,U.S. Coast Guard,null,100.0,100.0,0,0,49743504,7132,30,09,3,2016,2016-09-30,4,2016,49743504,7132
Bureau,Farm Credit Administration,Farm Credit Administration,null,0.0,0.0,0,0,0,0,30,09,3,2016,2016-09-30,4,2016,0,0
Bureau,Department of Housing and Urban Development,Public and Indian Housing Programs,null,0.0,0.0,0,0,0,0,30,09,3,2016,2016-09-30,4,2016,0,0
Bureau,Department of the Treasury,U.S. Mint,null,100.0,100.0,0,0,40858,9,30,09,3,2016,2016-09-30,4,2016,40858,9
Bureau,Department of Homeland Security,Immigration and Customs Enforcement,null,100.0,100.0,0,0,6504978,354,30,09,3,2016,2016-09-30,4,2016,6504978,354
Agency,Social Security Administration,null,CFO,39.10904267925975,28.486211046648524,3498859016,1801024,2247247089,717405,30,09,3,2016,2016-09-30,4,2016,5746106105,2518429
Agency,Small Business Administration,null,CFO,99.29687453290626,99.57490073713089,75805790,485,10705454959,113606,30,09,3,2016,2016-09-30,4,2016,10781260749,114091
Bureau,Export - Import  Bank,Export-Import Bank,null,0.0,0.0,0,0,0,0,30,09,3,2016,2016-09-30,4,2016,0,0
Bureau,Department of Justice,General Administration,null,0.0,0.0,0,0,0,0,30,09,3,2016,2016-09-30,4,2016,0,0
Bureau,Federal Labor Relations Authority,Federal Labor Relations Authority,null,0.0,0.0,0,0,0,0,30,09,3,2016,2016-09-30,4,2016,0,0
Bureau,American Battle Monuments Commission,American Battle Monuments Commission,null,0.0,0.0,0,0,0,0,30,09,3,2016,2016-09-30,4,2016,0,0
Bureau,National Aeronautics and Space Administration,National Aeronautics and Space Admin,null,100.0,100.0,0,0,459520,75,30,09,3,2016,2016-09-30,4,2016,459520,75
Bureau,Department of Commerce,Nat'l Institute of Standards& Technology,null,100.0,100.0,0,0,766759,10,30,09,3,2016,2016-09-30,4,2016,766759,10
Bureau,Agency for International Development,Agency for International Development,null,100.0,100.0,0,0,15190580,24,30,09,3,2016,2016-09-30,4,2016,15190580,24
Bureau,Department of Veterans Affairs,Housing Credit Assistance,null,3.64119241681851,14.133333333333333,24969638,322,943549,53,30,09,3,2016,2016-09-30,4,2016,25913187,375
Agency,Nuclear Regulatory Commission,null,CFO,100.0,100.0,0,0,1396554,199,30,09,3,2016,2016-09-30,4,2016,1396554,199
Bureau,Other Agencies/Boards/Commissions,Nuclear Waste Technical Review Board,null,0.0,0.0,0,0,0,0,30,09,3,2016,2016-09-30,4,2016,0,0
Bureau,Department of Homeland Security,Science and Technology,null,0.0,0.0,0,0,0,0,30,09,3,2016,2016-09-30,4,2016,0,0
Bureau,Department of Homeland Security,Office of the Inspector General DHS,null,0.0,0.0,1129,2,0,0,30,09,3,2016,2016-09-30,4,2016,1129,2
Bureau,Other Agencies/Boards/Commissions,U.S.-China Security Review Commission,null,0.0,0.0,1747,4,0,0,30,09,3,2016,2016-09-30,4,2016,1747,4
Bureau,Department of Transportation,Federal Highway Administration,null,100.0,100.0,0,0,12725,9,30,09,3,2016,2016-09-30,4,2016,12725,9
Agency,Department of Labor,null,CFO,87.69183839641846,62.088344385748,19978418,13492,142340039,22096,30,09,3,2016,2016-09-30,4,2016,162318457,35588
Bureau,Department of Housing and Urban Development,Management and Administration,null,0.0,0.0,0,3,0,0,30,09,3,2016,2016-09-30,4,2016,0,3
Bureau,Department of the Treasury,Office of Sec International Affairs,null,0.0,0.0,0,0,0,0,30,09,3,2016,2016-09-30,4,2016,0,0
Bureau,Other Agencies,Federal Housing Finance Agency OIG,null,0.0,0.0,0,0,0,0,30,09,3,2016,2016-09-30,4,2016,0,0
Bureau,Department of Labor,Bureau of Labor Statistics,null,100.0,100.0,0,0,10969,1,30,09,3,2016,2016-09-30,4,2016,10969,1
Agency,General Services Administration,null,CFO,90.78569029594941,85.5705335105373,1577252,760,15540167,4507,30,09,3,2016,2016-09-30,4,2016,17117419,5267
Bureau,Other Agencies,Appalachian Regional Commission,null,0.0,0.0,0,0,0,0,30,09,3,2016,2016-09-30,4,2016,0,0
Bureau,Other Agencies,National Council on Disability,null,0.0,0.0,0,0,0,0,30,09,3,2016,2016-09-30,4,2016,0,0
Bureau,Department of Commerce,NOAA,null,100.0,100.0,0,0,5207733,704,30,09,3,2016,2016-09-30,4,2016,5207733,704
Bureau,Other Agencies,Northern Border Regional Commission,null,0.0,0.0,0,0,0,0,30,09,3,2016,2016-09-30,4,2016,0,0
Agency,Agency for International Development,null,CFO,100.0,100.0,0,0,15190580,24,30,09,3,2016,2016-09-30,4,2016,15190580,24
Bureau,Other Agencies,Commission On Fine Arts,null,0.0,0.0,765,1,0,0,30,09,3,2016,2016-09-30,4,2016,765,1
Agency,Department of Energy,null,CFO,100.0,100.0,0,0,11489716,75,30,09,3,2016,2016-09-30,4,2016,11489716,75
Bureau,Other Agencies,National Transportation Safety Board,null,0.0,0.0,0,0,0,0,30,09,3,2016,2016-09-30,4,2016,0,0
Bureau,Department of Homeland Security,Transportation Safety Administration,null,100.0,100.0,0,0,8634460,3606,30,09,3,2016,2016-09-30,4,2016,8634460,3606
Bureau,Other Agencies,U.S. Inst. for Env. Conflict Resolution,null,0.0,0.0,8023,4,0,0,30,09,3,2016,2016-09-30,4,2016,8023,4
Bureau,Other Agencies,District of Columbia Government,null,0.0,0.0,396952,104,0,0,30,09,3,2016,2016-09-30,4,2016,396952,104
Bureau,Occupational Safety & Health Rev Comm,Occupational Safety & Health Rev Comm,null,0.0,0.0,0,0,0,0,30,09,3,2016,2016-09-30,4,2016,0,0
Bureau,Department of Justice,U.S. Marshals Service,null,0.0,0.0,0,0,0,0,30,09,3,2016,2016-09-30,4,2016,0,0
Agency,Overseas Private Investment Corp Accts,null,Non-CFO,0.0,0.0,0,0,0,0,31,12,4,2016,2016-12-31,1,2017,0,0
Agency,Smithsonian Institution,null,Non-CFO,0.0,0.0,0,0,0,0,31,12,4,2016,2016-12-31,1,2017,0,0
Bureau,Other Agencies,Delta Regional Authority,null,0.0,0.0,0,0,0,0,31,12,4,2016,2016-12-31,1,2017,0,0
Bureau,Department of Transportation,Pipeline Hazardous Material Safety Admin,null,100.0,100.0,0,0,371431,25,31,12,4,2016,2016-12-31,1,2017,371431,25
Bureau,Other Agencies,Advisory Council on Hist. Preservation,null,0.0,0.0,0,0,0,0,31,12,4,2016,2016-12-31,1,2017,0,0
Bureau,Department of Labor,Departmental Management,null,0.0,0.0,0,0,0,0,31,12,4,2016,2016-12-31,1,2017,0,0
Agency,Office of Special Counsel,null,Non-CFO,0.0,0.0,0,0,0,0,31,12,4,2016,2016-12-31,1,2017,0,0
Agency,Federal Trade Commission,null,Non-CFO,100.0,100.0,0,0,483157548,56,31,12,4,2016,2016-12-31,1,2017,483157548,56
Bureau,Smithsonian Institution,Smithsonian Institution,null,0.0,0.0,0,0,0,0,31,12,4,2016,2016-12-31,1,2017,0,0
Bureau,Other Agencies,Federal Mine Safety & Health Review Comm,null,0.0,0.0,0,0,0,0,31,12,4,2016,2016-12-31,1,2017,0,0
Bureau,Consumer Product Safety Commission,Consumer Product Safety Commission,null,100.0,100.0,0,0,421,1,31,12,4,2016,2016-12-31,1,2017,421,1
Bureau,Department of Transportation,Federal Railroad Administration,null,100.0,100.0,0,0,254807,21,31,12,4,2016,2016-12-31,1,2017,254807,21
Agency,Federal Deposit Insurance Corporation,null,Non-CFO,0.0,0.0,0,0,0,0,31,12,4,2016,2016-12-31,1,2017,0,0
Bureau,Merit Systems Protection Board,Merit Systems Protection Board,null,0.0,0.0,0,0,0,0,31,12,4,2016,2016-12-31,1,2017,0,0
Bureau,Other Agencies,U.S. Holocaust Memorial Council,null,0.0,0.0,0,0,0,0,31,12,4,2016,2016-12-31,1,2017,0,0
Bureau,Department of Agriculture,Rural Development,null,99.99930394712887,99.99422182417011,3950,2,567481677,34611,31,12,4,2016,2016-12-31,1,2017,567485627,34613
Agency,Federal Communications Commission,null,Non-CFO,100.0,100.0,0,0,189022350,8365,31,12,4,2016,2016-12-31,1,2017,189022350,8365
Bureau,National Labor Relations Board,National Labor Relations Board,null,0.0,0.0,0,0,0,0,31,12,4,2016,2016-12-31,1,2017,0,0
Bureau,Department of Education,Departmental Management,null,97.53635846322366,91.60104986876641,14637236,160,579492867,1745,31,12,4,2016,2016-12-31,1,2017,594130103,1905
Bureau,Occupational Safety & Health Rev Comm,Occupational Safety & Health Rev Comm,null,0.0,0.0,0,0,0,0,31,12,4,2016,2016-12-31,1,2017,0,0
Bureau,Department of Housing and Urban Development,"Policy, Development and Research",null,0.0,0.0,0,0,0,0,31,12,4,2016,2016-12-31,1,2017,0,0
Bureau,Department of Veterans Affairs,Life Insurance,null,100.0,100.0,0,0,463107,80,31,12,4,2016,2016-12-31,1,2017,463107,80
Agency,Legislative Branch-CBO,null,Non-CFO,0.0,0.0,0,0,0,0,31,12,4,2016,2016-12-31,1,2017,0,0
Bureau,Department of Health & Human Services,Office of the Inspector General,null,0.0,0.0,0,0,0,0,31,12,4,2016,2016-12-31,1,2017,0,0
Bureau,Department of Agriculture,Farm Service Agency,null,100.0,100.0,0,0,669942997,12698,31,12,4,2016,2016-12-31,1,2017,669942997,12698
Bureau,Department of Transportation,St. Lawrence Seaway Development Corp.,null,0.0,0.0,0,0,0,0,31,12,4,2016,2016-12-31,1,2017,0,0
Bureau,Legislative Branch-GAO,Government Accountability Office,null,0.0,0.0,0,0,0,0,31,12,4,2016,2016-12-31,1,2017,0,0
Bureau,Department of Transportation,Federal Highway Administration,null,100.0,100.0,0,0,11599,7,31,12,4,2016,2016-12-31,1,2017,11599,7
Agency,Armed Forces Retirement Home,null,Non-CFO,93.23587710604559,96.42857142857143,4641,3,63971,81,31,12,4,2016,2016-12-31,1,2017,68612,84
Agency,National Credit Union Administration,null,Non-CFO,0.0,0.0,0,0,0,0,31,12,4,2016,2016-12-31,1,2017,0,0
Agency,Export - Import  Bank,null,Non-CFO,0.0,0.0,0,0,0,0,31,12,4,2016,2016-12-31,1,2017,0,0
Agency,National Foundation  Arts & Humanities,null,Non-CFO,0.0,0.0,0,0,0,0,31,12,4,2016,2016-12-31,1,2017,0,0
Agency,National Labor Relations Board,null,Non-CFO,0.0,0.0,0,0,0,0,31,12,4,2016,2016-12-31,1,2017,0,0
Agency,Nuclear Regulatory Commission,null,CFO,98.61859097302136,99.4949494949495,13505,1,964120,197,31,12,4,2016,2016-12-31,1,2017,977625,198
Bureau,Department of Defense,Consolidated Report,null,52.56222613267152,28.90577141758749,1108924859,791502,1228716157,321812,31,12,4,2016,2016-12-31,1,2017,2337641016,1113314
Bureau,Department of the Treasury,Internal Revenue Service,null,98.80606225245076,97.76119402985074,3560,3,294613,131,31,12,4,2016,2016-12-31,1,2017,298173,134
Agency,Pension Benefit Guaranty Corp,null,Non-CFO,9.401519492046795,13.663845223700122,3086625,714,320303,113,31,12,4,2016,2016-12-31,1,2017,3406928,827
Agency,Environmental Protection Agency,null,CFO,99.95686293072755,97.5,4192,5,9713668,195,31,12,4,2016,2016-12-31,1,2017,9717860,200
Agency,Railroad Retirement Board,null,Non-CFO,75.33157403883705,56.39620965353864,5392493,2945,16467406,3809,31,12,4,2016,2016-12-31,1,2017,21859899,6754
Bureau,Nuclear Regulatory Commission,Nuclear Regulatory Commission,null,98.61859097302136,99.4949494949495,13505,1,964120,197,31,12,4,2016,2016-12-31,1,2017,977625,198
Bureau,Other Agencies,Federal Housing Finance Agency,null,0.0,0.0,0,0,0,0,31,12,4,2016,2016-12-31,1,2017,0,0
Bureau,Department of State,International Commissions,null,0.0,0.0,0,0,0,0,31,12,4,2016,2016-12-31,1,2017,0,0
Bureau,Other Agencies/Boards/Commissions,U.S. Comm. on Int. Religious Freedom,null,0.0,0.0,209294,5,0,0,31,12,4,2016,2016-12-31,1,2017,209294,5
Bureau,Funds Appropriated to the President,Trade and Development Agency,null,100.0,100.0,0,0,24713,1,31,12,4,2016,2016-12-31,1,2017,24713,1
Bureau,Department of the Treasury,Bureau of Public Debt,null,0.0,0.0,0,0,0,0,31,12,4,2016,2016-12-31,1,2017,0,0
Bureau,Other Agencies,Gulf Coast Ecosystem Restoration Council,null,0.0,0.0,0,0,0,0,31,12,4,2016,2016-12-31,1,2017,0,0
Bureau,Department of the Treasury,Comptroller of the Currency,null,91.6774577199222,47.72727272727273,102447,23,1128511,21,31,12,4,2016,2016-12-31,1,2017,1230958,44
Bureau,Federal Mediation/Conciliation Service,Federal Mediation/Conciliation Service,null,0.0,0.0,0,0,0,0,31,12,4,2016,2016-12-31,1,2017,0,0
Agency,Commodity Futures Trading Commission,null,Non-CFO,95.337871084042,96.42857142857143,19560058,9,399992004,243,31,12,4,2016,2016-12-31,1,2017,419552062,252
Agency,Securities & Exchange Commission,null,Non-CFO,99.99272941097325,97.08624708624708,141063,25,1940045619,833,31,12,4,2016,2016-12-31,1,2017,1940186682,858
Agency,Occupational Safety & Health Rev Comm,null,Non-CFO,0.0,0.0,0,0,0,0,31,12,4,2016,2016-12-31,1,2017,0,0
Bureau,National Archives & Records Admin,Nat'l Archives & Records Administration,null,95.10008258287782,98.80952380952381,1246,1,24183,83,31,12,4,2016,2016-12-31,1,2017,25429,84
Bureau,Department of Health & Human Services,Indian Health Services,null,34.17804526364153,8.992562542258282,34241037,1346,17779656,133,31,12,4,2016,2016-12-31,1,2017,52020693,1479
Agency,Department of State,null,CFO,99.2071811827316,99.56504767746613,148688,78,18605660,17855,31,12,4,2016,2016-12-31,1,2017,18754348,17933
Bureau,Department of Commerce,National Technical Information Service,null,0.0,0.0,16153,42,0,0,31,12,4,2016,2016-12-31,1,2017,16153,42
Bureau,Pension Benefit Guaranty Corp,Pension Benefit Guaranty Corporation,null,9.401519492046795,13.663845223700122,3086625,714,320303,113,31,12,4,2016,2016-12-31,1,2017,3406928,827
Bureau,Department of Housing and Urban Development,Housing Programs,null,99.34745278134466,99.62428317184101,753292,19,114685404,5038,31,12,4,2016,2016-12-31,1,2017,115438696,5057
Bureau,Environmental Protection Agency,Environmental Protection Agency,null,99.95686293072755,97.5,4192,5,9713668,195,31,12,4,2016,2016-12-31,1,2017,9717860,200
Agency,Department of Commerce,null,CFO,99.90822477817497,96.51162790697674,17305,45,18838547,1245,31,12,4,2016,2016-12-31,1,2017,18855852,1290
Bureau,Department of the Treasury,Office of Financial Research,null,100.0,100.0,0,0,36,1,31,12,4,2016,2016-12-31,1,2017,36,1
Bureau,Department of the Interior,Bureau of Indian Affairs,null,91.36251202178866,54.188849452824606,891282,12391,9427482,14657,31,12,4,2016,2016-12-31,1,2017,10318764,27048
Agency,General Services Administration,null,CFO,68.09584579878278,87.2579395817196,6337944,658,13527632,4506,31,12,4,2016,2016-12-31,1,2017,19865576,5164
Agency,Farm Credit Administration,null,Non-CFO,0.0,0.0,0,0,0,0,31,12,4,2016,2016-12-31,1,2017,0,0
Agency,Neighborhood Reinvestment Corporation,null,Non-CFO,0.0,0.0,0,0,0,0,31,12,4,2016,2016-12-31,1,2017,0,0
Bureau,National Aeronautics and Space Administration,National Aeronautics and Space Admin,null,100.0,100.0,0,0,467157,80,31,12,4,2016,2016-12-31,1,2017,467157,80
Bureau,The Judiciary,Administrative Office of the U.S. Courts,null,62.7020580869824,37.5609756097561,516368,128,868073,77,31,12,4,2016,2016-12-31,1,2017,1384441,205
Bureau,Department of Agriculture,Commodity Credit Corporation,null,99.65901024714297,99.92364955144112,400190,8,116961108,10470,31,12,4,2016,2016-12-31,1,2017,117361298,10478
Bureau,Department of State,Passport NSF,null,99.99005358449408,99.99243513125047,205,1,2060839,13218,31,12,4,2016,2016-12-31,1,2017,2061044,13219
Agency,Department of the Treasury,null,CFO,98.52953576359121,99.14473684210526,454990,39,30486939,4521,31,12,4,2016,2016-12-31,1,2017,30941929,4560
Agency,Federal Labor Relations Authority,null,Non-CFO,0.0,0.0,0,0,0,0,31,12,4,2016,2016-12-31,1,2017,0,0
Bureau,Federal Maritime Commission,Salaries and Expenses,null,100.0,100.0,0,0,472598,6,31,12,4,2016,2016-12-31,1,2017,472598,6
Bureau,Department of Homeland Security,Federal Law Enforcement Training Ctr.,null,100.0,100.0,0,0,25859,9,31,12,4,2016,2016-12-31,1,2017,25859,9
Bureau,Department of Transportation,Federal Aviation Administration,null,92.42797818795454,89.52020202020202,362201,83,4421211,709,31,12,4,2016,2016-12-31,1,2017,4783412,792
Agency,Department of the Interior,null,CFO,97.61987806468919,58.69528984299477,891282,12391,36555623,17608,31,12,4,2016,2016-12-31,1,2017,37446905,29999
Agency,Office of Government Ethics,null,Non-CFO,0.0,0.0,0,0,0,0,31,12,4,2016,2016-12-31,1,2017,0,0
Bureau,Department of Justice,Federal Bureau of Investigation,null,0.0,0.0,544726,616,0,0,31,12,4,2016,2016-12-31,1,2017,544726,616
Bureau,Department of the Treasury,U.S. Mint,null,95.6091588098445,90.0,1793,1,39042,9,31,12,4,2016,2016-12-31,1,2017,40835,10
Bureau,Department of Housing and Urban Development,Government National Mortgage Association,null,0.0,0.0,0,0,0,0,31,12,4,2016,2016-12-31,1,2017,0,0
Bureau,Department of Commerce,Bureau of the Census,null,97.44533640839136,97.02970297029702,1152,3,43942,98,31,12,4,2016,2016-12-31,1,2017,45094,101
Agency,Tennessee Valley Authority,null,Non-CFO,0.0,0.0,0,0,0,0,31,12,4,2016,2016-12-31,1,2017,0,0
Agency,Office of Compliance,null,Non-CFO,0.0,0.0,0,0,0,0,31,12,4,2016,2016-12-31,1,2017,0,0
Bureau,Other Agencies,Defense Nuclear Facilities Safety Board,null,0.0,0.0,0,0,0,0,31,12,4,2016,2016-12-31,1,2017,0,0
Bureau,Department of Transportation,Office of the Secretary,null,99.99982553808417,100.0,1,0,573190,18,31,12,4,2016,2016-12-31,1,2017,573191,18
Bureau,Department of State,Department of State,null,99.1105235967667,98.36656767076792,148483,77,16544821,4637,31,12,4,2016,2016-12-31,1,2017,16693304,4714
Agency,Federal Mediation/Conciliation Service,null,Non-CFO,0.0,0.0,0,0,0,0,31,12,4,2016,2016-12-31,1,2017,0,0
Bureau,Armed Forces Retirement Home,Armed Forces Retirement Home,null,93.23587710604559,96.42857142857143,4641,3,63971,81,31,12,4,2016,2016-12-31,1,2017,68612,84
Agency,Department of Justice,null,CFO,97.56482251424273,97.2567655136236,1774069,889,71077664,31518,31,12,4,2016,2016-12-31,1,2017,72851733,32407
Bureau,Department of Commerce,Nat'l Institute of Standards& Technology,null,100.0,100.0,0,0,695500,9,31,12,4,2016,2016-12-31,1,2017,695500,9
Agency,Legislative Branch-GAO,null,Non-CFO,0.0,0.0,0,0,0,0,31,12,4,2016,2016-12-31,1,2017,0,0
Bureau,Equal Employment Opportunity Commission,Equal Employment Opportunity Commission,null,63.670006643046946,17.100371747211895,262506,223,460054,46,31,12,4,2016,2016-12-31,1,2017,722560,269
Bureau,Funds Appropriated to the President,Inter-American Foundation,null,0.0,0.0,0,0,0,0,31,12,4,2016,2016-12-31,1,2017,0,0
Bureau,Office of Special Counsel,Office of Special Counsel,null,0.0,0.0,0,0,0,0,31,12,4,2016,2016-12-31,1,2017,0,0
Bureau,Department of Health & Human Services,Office of the Secretary,null,100.0,100.0,0,0,230,2,31,12,4,2016,2016-12-31,1,2017,230,2
Bureau,Commodity Futures Trading Commission,Commodity Futures Trading Commission,null,95.337871084042,96.42857142857143,19560058,9,399992004,243,31,12,4,2016,2016-12-31,1,2017,419552062,252
Bureau,Department of Health & Human Services,Food and Drug Administration,null,85.02720978967271,16.075388026607538,2620176,3028,14879408,580,31,12,4,2016,2016-12-31,1,2017,17499584,3608
Bureau,Legislative Branch-GPO,Government Publishing Office,null,0.0,0.0,97078,58,0,0,31,12,4,2016,2016-12-31,1,2017,97078,58
Agency,Office of Personnel Management,null,CFO,20.439368279812403,36.28257887517147,62483616,1858,16052231,1058,31,12,4,2016,2016-12-31,1,2017,78535847,2916
Bureau,Department of the Interior,Bureau of Reclamation,null,100.0,100.0,0,0,102590,82,31,12,4,2016,2016-12-31,1,2017,102590,82
Agency,Department of Housing and Urban Development,null,CFO,99.34638133607501,99.52587909917028,754537,24,114685404,5038,31,12,4,2016,2016-12-31,1,2017,115439941,5062
Bureau,Federal Trade Commission,Federal Trade Commission,null,100.0,100.0,0,0,483157548,56,31,12,4,2016,2016-12-31,1,2017,483157548,56
Bureau,Funds Appropriated to the President,Executive Branch,null,0.0,0.0,0,0,0,0,31,12,4,2016,2016-12-31,1,2017,0,0
Bureau,Department of Veterans Affairs,Medical and Construction,null,75.70675647844824,92.0315892080712,128635524,518275,400876000,5985845,31,12,4,2016,2016-12-31,1,2017,529511524,6504120
Agency,Department of Labor,null,CFO,87.01236053169278,72.10324542269812,21115018,8441,141462778,21817,31,12,4,2016,2016-12-31,1,2017,162577796,30258
Agency,Funds Appropriated to the President,null,Non-CFO,100.0,100.0,0,0,24713,1,31,12,4,2016,2016-12-31,1,2017,24713,1
Bureau,Department of Veterans Affairs,Veterans Benefits,null,99.76438543332658,98.59130377035844,1294803,1697,548248045,118769,31,12,4,2016,2016-12-31,1,2017,549542848,120466
Bureau,Corp. for National and Community Service,Corp. for National and Community Service,null,95.62817441904213,91.4027149321267,139442,19,3050118,202,31,12,4,2016,2016-12-31,1,2017,3189560,221
Bureau,Department of Commerce,Bureau of Industry and Security,null,0.0,0.0,0,0,0,0,31,12,4,2016,2016-12-31,1,2017,0,0
Bureau,Other Agencies,Commission On Fine Arts,null,0.0,0.0,765,1,0,0,31,12,4,2016,2016-12-31,1,2017,765,1
Agency,Department of Agriculture,null,CFO,94.0652820984952,89.28612533809059,89118523,7447,1412528640,62061,31,12,4,2016,2016-12-31,1,2017,1501647163,69508
Bureau,Legislative Branch-Office of Tech.,Open World Leadership,null,0.0,0.0,0,0,0,0,31,12,4,2016,2016-12-31,1,2017,0,0
Bureau,Department of Agriculture,Food and Nutrition Service,null,0.05276421999113976,1.0159651669085632,17714780,682,9352,7,31,12,4,2016,2016-12-31,1,2017,17724132,689
Bureau,Department of the Treasury,Treasury IG for Tax Admin,null,0.0,0.0,0,0,0,0,31,12,4,2016,2016-12-31,1,2017,0,0
Bureau,General Services Administration,General Services Administration,null,68.09584579878278,87.2579395817196,6337944,658,13527632,4506,31,12,4,2016,2016-12-31,1,2017,19865576,5164
Bureau,National Foundation  Arts & Humanities,National Endowment for the Humanities,null,0.0,0.0,0,0,0,0,31,12,4,2016,2016-12-31,1,2017,0,0
Bureau,Department of Agriculture,Federal Crop Insurance Corporation,null,100.0,100.0,0,0,129968,309,31,12,4,2016,2016-12-31,1,2017,129968,309
Agency,Department of Defense,null,CFO,52.56222613267152,28.90577141758749,1108924859,791502,1228716157,321812,31,12,4,2016,2016-12-31,1,2017,2337641016,1113314
Bureau,Department of the Treasury,U.S. Treasury IG Office,null,0.0,0.0,0,0,0,0,31,12,4,2016,2016-12-31,1,2017,0,0
Agency,Social Security Administration,null,CFO,26.440629592783147,11.552170668712058,4303436861,2250915,1546853642,293992,31,12,4,2016,2016-12-31,1,2017,5850290503,2544907
Agency,Small Business Administration,null,CFO,99.77445818540832,99.84950564353836,24595880,172,10880645813,114118,31,12,4,2016,2016-12-31,1,2017,10905241693,114290
Bureau,Department of Agriculture,Food Safety and Inspection Service,null,100.0,100.0,0,0,934969,1409,31,12,4,2016,2016-12-31,1,2017,934969,1409
Bureau,Department of the Treasury,Interest on Public Debt,null,0.0,0.0,0,0,0,0,31,12,4,2016,2016-12-31,1,2017,0,0
Bureau,Department of the Interior,Office of the Secretary,null,100.0,100.0,0,0,16885,9,31,12,4,2016,2016-12-31,1,2017,16885,9
Bureau,National Science Foundation,National Science Foundation,null,100.0,100.0,0,0,946334,14,31,12,4,2016,2016-12-31,1,2017,946334,14
Bureau,Department of Transportation,Federal Motor Carrier Safety Admin,null,73.88650519448456,78.96243894222671,11519054,1249,32592445,4688,31,12,4,2016,2016-12-31,1,2017,44111499,5937
Bureau,Department of Agriculture,Agricultural Marketing Service,null,53.52675069510327,59.40959409594096,452629,220,521327,322,31,12,4,2016,2016-12-31,1,2017,973956,542
Agency,Department of Education,null,CFO,61.968638239076576,53.59161284875767,48588111863,11323730,79169900507,13076450,31,12,4,2016,2016-12-31,1,2017,127758012370,24400180
Agency,National Archives & Records Admin,null,Non-CFO,95.10008258287782,98.80952380952381,1246,1,24183,83,31,12,4,2016,2016-12-31,1,2017,25429,84
Agency,Legislative Branch-GPO,null,Non-CFO,0.0,0.0,97078,58,0,0,31,12,4,2016,2016-12-31,1,2017,97078,58
Agency,Legislative Branch - U.S. House/Senate,null,Non-CFO,0.0,0.0,207355,190,0,0,31,12,4,2016,2016-12-31,1,2017,207355,190
Agency,Other Agencies,null,Non-CFO,0.0,0.0,656641,212,0,0,31,12,4,2016,2016-12-31,1,2017,656641,212
Agency,Equal Employment Opportunity Commission,null,Non-CFO,63.670006643046946,17.100371747211895,262506,223,460054,46,31,12,4,2016,2016-12-31,1,2017,722560,269
Agency,Presidio Trust Corporation,null,Non-CFO,99.80786023496479,96.05263157894737,2482,3,1289286,73,31,12,4,2016,2016-12-31,1,2017,1291768,76
Agency,The Judiciary,null,Non-CFO,62.7020580869824,37.5609756097561,516368,128,868073,77,31,12,4,2016,2016-12-31,1,2017,1384441,205
Agency,Corp. for National and Community Service,null,Non-CFO,95.62817441904213,91.4027149321267,139442,19,3050118,202,31,12,4,2016,2016-12-31,1,2017,3189560,221
Bureau,Department of Commerce,Office of the Inspector General,null,0.0,0.0,0,0,0,0,31,12,4,2016,2016-12-31,1,2017,0,0
Bureau,Other Agencies,Surface Transportation Board,null,0.0,0.0,0,0,0,0,31,12,4,2016,2016-12-31,1,2017,0,0
Bureau,National Credit Union Administration,Nat'l Credit Union Admin. Treasury Acct.,null,0.0,0.0,0,0,0,0,31,12,4,2016,2016-12-31,1,2017,0,0
Bureau,Department of the Treasury,Treasury Forfeiture Fund,null,0.0,0.0,0,0,0,0,31,12,4,2016,2016-12-31,1,2017,0,0
Bureau,Department of Health & Human Services,Administration for Community Living,null,0.0,0.0,0,0,0,0,31,12,4,2016,2016-12-31,1,2017,0,0
Agency,U.S. Postal Service,null,Non-CFO,8.290948384996565,21.818261173184357,50709603,17913,4584397,4999,31,12,4,2016,2016-12-31,1,2017,55294000,22912
Bureau,Selective Service System,Selective Service System,null,0.0,0.0,1421,1,0,0,31,12,4,2016,2016-12-31,1,2017,1421,1
Bureau,Department of the Treasury,Spec Insp Gen-Troubled Asset Rel Prog,null,100.0,100.0,0,0,3916,1,31,12,4,2016,2016-12-31,1,2017,3916,1
Bureau,Department of Homeland Security,Info Analysis Infrastructure Prot-NPPD,null,100.0,100.0,0,0,4610,1,31,12,4,2016,2016-12-31,1,2017,4610,1
Bureau,Department of Transportation,Research Innovative Technology Admin,null,100.0,100.0,0,0,5081,2,31,12,4,2016,2016-12-31,1,2017,5081,2
Bureau,Department of Transportation,Maritime Administration,null,94.55247735748534,83.33333333333333,409,1,7099,5,31,12,4,2016,2016-12-31,1,2017,7508,6
Bureau,Department of Labor,Bureau of Labor Statistics,null,100.0,100.0,0,0,10969,1,31,12,4,2016,2016-12-31,1,2017,10969,1
Bureau,Legislative Branch - U.S. House/Senate,U.S. House of Representatives,null,0.0,0.0,207355,190,0,0,31,12,4,2016,2016-12-31,1,2017,207355,190
Bureau,Department of Justice,Federal Prison Industries,null,56.25615801360095,69.58174904942966,797819,80,1026024,183,31,12,4,2016,2016-12-31,1,2017,1823843,263
Bureau,Department of Veterans Affairs,Housing Credit Assistance,null,9.144811430274979,32.82442748091603,6820509,88,686502,43,31,12,4,2016,2016-12-31,1,2017,7507011,131
Bureau,Department of Transportation,National Highway Traffic Safety Admin.,null,99.89096042549525,80.0,8328,1,7629266,4,31,12,4,2016,2016-12-31,1,2017,7637594,5
Bureau,Department of Health & Human Services,National Institutes of Health,null,52.69949698758535,31.010452961672474,4245468,198,4730056,89,31,12,4,2016,2016-12-31,1,2017,8975524,287
Bureau,Department of Justice,Legal Activities,null,99.37467804289169,99.39860629395106,431265,189,68535608,31238,31,12,4,2016,2016-12-31,1,2017,68966873,31427
Bureau,Social Security Administration,Social Security Administration,null,26.440629592783147,11.552170668712058,4303436861,2250915,1546853642,293992,31,12,4,2016,2016-12-31,1,2017,5850290503,2544907
Bureau,Department of Agriculture,Forest Service,null,39.5740543465429,8.171687990094924,60204348,4450,39428926,396,31,12,4,2016,2016-12-31,1,2017,99633274,4846
Bureau,Small Business Administration,Small Business Administration,null,99.77445818540832,99.84950564353836,24595880,172,10880645813,114118,31,12,4,2016,2016-12-31,1,2017,10905241693,114290
Bureau,Department of Education,Federal Student Aid,null,61.80383471716421,53.588649491707876,48570646362,11323568,78590407640,13074705,31,12,4,2016,2016-12-31,1,2017,127161054002,24398273
Bureau,Other Agencies,Federal Housing Finance Agency OIG,null,0.0,0.0,0,0,0,0,31,12,4,2016,2016-12-31,1,2017,0,0
Bureau,National Credit Union Administration,National Credit Union Administration,null,0.0,0.0,0,0,0,0,31,12,4,2016,2016-12-31,1,2017,0,0
Agency,Legis Branch-Library of Congress,null,Non-CFO,0.0,0.0,0,0,0,0,31,12,4,2016,2016-12-31,1,2017,0,0
Bureau,Other Agencies,Denali Commission,null,0.0,0.0,611,1,0,0,31,12,4,2016,2016-12-31,1,2017,611,1
Bureau,Department of Commerce,General Administration,null,100.0,100.0,0,0,4660,1,31,12,4,2016,2016-12-31,1,2017,4660,1
Agency,Legislative Branch-Office of Tech.,null,Non-CFO,0.0,0.0,0,0,0,0,31,12,4,2016,2016-12-31,1,2017,0,0
Bureau,Legislative Branch-Office of Tech.,Medicaid & CHIP Payment & Access Comm.,null,0.0,0.0,0,0,0,0,31,12,4,2016,2016-12-31,1,2017,0,0
Bureau,Department of Justice,General Administration,null,0.0,0.0,0,0,0,0,31,12,4,2016,2016-12-31,1,2017,0,0
Bureau,Other Agencies,Council of Insps. Gen. of Intg. & Effy.,null,0.0,0.0,0,0,0,0,31,12,4,2016,2016-12-31,1,2017,0,0
Bureau,Other Agencies,National Capital Planning Commission,null,0.0,0.0,0,0,0,0,31,12,4,2016,2016-12-31,1,2017,0,0
Bureau,Department of Justice,Bureau of ATF and Explosives,null,99.06525191280497,63.63636363636363,259,4,27449,7,31,12,4,2016,2016-12-31,1,2017,27708,11
Bureau,Other Agencies,District of Columbia Government,null,0.0,0.0,174318,122,0,0,31,12,4,2016,2016-12-31,1,2017,174318,122
Bureau,Legis Branch-Library of Congress,Library of Congress,null,0.0,0.0,0,0,0,0,31,12,4,2016,2016-12-31,1,2017,0,0
Agency,Department of Veterans Affairs,null,CFO,87.15600948914691,92.13995549038681,140042727,520770,950293854,6104765,31,12,4,2016,2016-12-31,1,2017,1090336581,6625535
Agency,Other Agencies/Boards/Commissions,null,Non-CFO,0.0,0.0,211041,9,0,0,31,12,4,2016,2016-12-31,1,2017,211041,9
Bureau,Funds Appropriated to the President,Peace Corps,null,0.0,0.0,0,0,0,0,31,12,4,2016,2016-12-31,1,2017,0,0
Bureau,Tennessee Valley Authority,Tennessee Valley Authority,null,0.0,0.0,0,0,0,0,31,12,4,2016,2016-12-31,1,2017,0,0
Bureau,Agency for International Development,Agency for International Development,null,100.0,100.0,0,0,15398074,25,31,12,4,2016,2016-12-31,1,2017,15398074,25
Bureau,Department of the Interior,Geological Survey,null,100.0,100.0,0,0,86773,125,31,12,4,2016,2016-12-31,1,2017,86773,125
Bureau,Neighborhood Reinvestment Corporation,Neighborhood Reinvestment Corporation,null,0.0,0.0,0,0,0,0,31,12,4,2016,2016-12-31,1,2017,0,0
Agency,U.S. Court of Appeals / Veterans Claims,null,Non-CFO,0.0,0.0,40,1,0,0,31,12,4,2016,2016-12-31,1,2017,40,1
Agency,Consumer Product Safety Commission,null,Non-CFO,100.0,100.0,0,0,421,1,31,12,4,2016,2016-12-31,1,2017,421,1
Agency,Federal Election Commission,null,Non-CFO,62.04224342800385,20.930232558139537,113882,34,186141,9,31,12,4,2016,2016-12-31,1,2017,300023,43
Bureau,Department of Commerce,Minority Business Development Agency,null,0.0,0.0,0,0,0,0,31,12,4,2016,2016-12-31,1,2017,0,0
Bureau,Federal Labor Relations Authority,Federal Labor Relations Authority,null,0.0,0.0,0,0,0,0,31,12,4,2016,2016-12-31,1,2017,0,0
Bureau,Department of Labor,Employment Standards Administration,null,62.80421386246917,22.37532008291672,16517869,6366,27890035,1835,31,12,4,2016,2016-12-31,1,2017,44407904,8201
Bureau,American Battle Monuments Commission,American Battle Monuments Commission,null,0.0,0.0,0,0,0,0,31,12,4,2016,2016-12-31,1,2017,0,0
Bureau,Department of the Treasury,International Monetary Funds,null,0.0,0.0,0,0,0,0,31,12,4,2016,2016-12-31,1,2017,0,0
Bureau,Department of Energy,Energy Consolidated Reports,null,100.0,100.0,0,0,10473953,43,31,12,4,2016,2016-12-31,1,2017,10473953,43
Bureau,Department of the Treasury,Departmental Offices,null,99.92029028889326,98.46153846153847,12662,10,15872479,640,31,12,4,2016,2016-12-31,1,2017,15885141,650
Agency,Federal Maritime Commission,null,Non-CFO,100.0,100.0,0,0,472598,6,31,12,4,2016,2016-12-31,1,2017,472598,6
Agency,American Battle Monuments Commission,null,Non-CFO,0.0,0.0,0,0,0,0,31,12,4,2016,2016-12-31,1,2017,0,0
Agency,Merit Systems Protection Board,null,Non-CFO,0.0,0.0,0,0,0,0,31,12,4,2016,2016-12-31,1,2017,0,0
Bureau,Funds Appropriated to the President,Defense Security Assistance Agency,null,0.0,0.0,0,0,0,0,31,12,4,2016,2016-12-31,1,2017,0,0
Bureau,Department of the Interior,Office of Surface Mining,null,100.0,100.0,0,0,1835848,213,31,12,4,2016,2016-12-31,1,2017,1835848,213
Bureau,U.S. Postal Service,U.S. Postal Service,null,8.290948384996565,21.818261173184357,50709603,17913,4584397,4999,31,12,4,2016,2016-12-31,1,2017,55294000,22912
Bureau,Department of the Treasury,Treasury Franchise Fund,null,0.0,0.0,0,0,0,0,31,12,4,2016,2016-12-31,1,2017,0,0
Agency,Selective Service System,null,Non-CFO,0.0,0.0,1421,1,0,0,31,12,4,2016,2016-12-31,1,2017,1421,1
Agency,Department of Transportation,null,CFO,79.68894760629001,80.42265923099501,11889994,1334,46649533,5480,31,12,4,2016,2016-12-31,1,2017,58539527,6814
Bureau,Other Agencies,U.S.  Agency of Global Media,null,0.0,0.0,0,0,0,0,31,12,4,2016,2016-12-31,1,2017,0,0
Bureau,Department of the Treasury,Community Dev Financial Inst Fund,null,91.15629653998946,80.0,250000,1,2576870,4,31,12,4,2016,2016-12-31,1,2017,2826870,5
Bureau,Securities & Exchange Commission,Securities and Exchange Commission,null,99.99272941097325,97.08624708624708,141063,25,1940045619,833,31,12,4,2016,2016-12-31,1,2017,1940186682,858
Bureau,Department of Commerce,International Trade Administration,null,0.0,0.0,0,0,0,0,31,12,4,2016,2016-12-31,1,2017,0,0
Bureau,Farm Credit Administration,Farm Credit Administration,null,0.0,0.0,0,0,0,0,31,12,4,2016,2016-12-31,1,2017,0,0
Bureau,Department of the Interior,Office of Natural Resources Revenue,null,100.0,100.0,0,0,8126812,161,31,12,4,2016,2016-12-31,1,2017,8126812,161
Bureau,Other Agencies,U.S. Inst. for Env. Conflict Resolution,null,0.0,0.0,8023,4,0,0,31,12,4,2016,2016-12-31,1,2017,8023,4
Bureau,Department of Homeland Security,Bureau of Customs & Border Protection,null,100.0,100.0,0,0,6551791,497,31,12,4,2016,2016-12-31,1,2017,6551791,497
Bureau,Presidio Trust Corporation,Presidio Trust Corporation,null,99.80786023496479,96.05263157894737,2482,3,1289286,73,31,12,4,2016,2016-12-31,1,2017,1291768,76
Bureau,National Foundation  Arts & Humanities,National Endowment for the Arts,null,0.0,0.0,0,0,0,0,31,12,4,2016,2016-12-31,1,2017,0,0
Bureau,Other Agencies,Millennium Challenge Corporation,null,0.0,0.0,0,0,0,0,31,12,4,2016,2016-12-31,1,2017,0,0
Bureau,Department of the Treasury,Bureau of the Fiscal Service,null,100.0,100.0,0,0,8839215,3691,31,12,4,2016,2016-12-31,1,2017,8839215,3691
Bureau,Department of Homeland Security,Office of the Inspector General DHS,null,85.49955791335101,75.0,328,1,1934,3,31,12,4,2016,2016-12-31,1,2017,2262,4
Bureau,Department of Energy,Bonneville Power Administration,null,100.0,100.0,0,0,1102709,26,31,12,4,2016,2016-12-31,1,2017,1102709,26
Bureau,Department of Health & Human Services,Program Support Center,null,100.0,100.0,0,0,3528611,535,31,12,4,2016,2016-12-31,1,2017,3528611,535
Bureau,Department of Homeland Security,Immigration and Customs Enforcement,null,100.0,100.0,0,0,6688306,365,31,12,4,2016,2016-12-31,1,2017,6688306,365
Bureau,Department of Health & Human Services,Centers for Medicare & Medicaid Services,null,95.41240455052943,95.46315180410099,520718120,86956,10829849421,1829705,31,12,4,2016,2016-12-31,1,2017,11350567541,1916661
Bureau,Department of State,Civil Monetary Penalties,null,0.0,0.0,0,0,0,0,31,12,4,2016,2016-12-31,1,2017,0,0
Bureau,Department of Agriculture,U.S. Department of Agriculture,null,62.33695843354536,46.86544342507645,10342626,2085,17118316,1839,31,12,4,2016,2016-12-31,1,2017,27460942,3924
Bureau,Department of the Interior,Fish and Wildlife Service,null,100.0,100.0,0,0,548725,104,31,12,4,2016,2016-12-31,1,2017,548725,104
Bureau,Department of Health & Human Services,Substance Abuse & Mental Health Admin.,null,100.0,100.0,0,0,587257,11,31,12,4,2016,2016-12-31,1,2017,587257,11
Bureau,Department of Homeland Security,Management Headquarters,null,0.0,0.0,0,0,0,0,31,12,4,2016,2016-12-31,1,2017,0,0
Bureau,Department of the Interior,National Park Service,null,100.0,100.0,0,0,4846168,1942,31,12,4,2016,2016-12-31,1,2017,4846168,1942
Bureau,Department of Commerce,Nat'l Telecomm & Information Admin.,null,0.0,0.0,0,0,0,0,31,12,4,2016,2016-12-31,1,2017,0,0
Bureau,Department of the Interior,"Bureau of Ocean Energy Mgmt., Reg & Enf",null,0.0,0.0,0,0,0,0,31,12,4,2016,2016-12-31,1,2017,0,0
Bureau,Federal Deposit Insurance Corporation,Federal Deposit Insurance Corporation,null,0.0,0.0,0,0,0,0,31,12,4,2016,2016-12-31,1,2017,0,0
Bureau,Department of the Treasury,Office of Sec International Affairs,null,0.0,0.0,0,0,0,0,31,12,4,2016,2016-12-31,1,2017,0,0
Bureau,Office of Personnel Management,Office of Personnel Management,null,20.439368279812403,36.28257887517147,62483616,1858,16052231,1058,31,12,4,2016,2016-12-31,1,2017,78535847,2916
Bureau,Other Agencies/Boards/Commissions,Medicare Payment Advisory Commission,null,0.0,0.0,0,0,0,0,31,12,4,2016,2016-12-31,1,2017,0,0
Bureau,Department of the Treasury,Office of the Secretary,null,0.0,0.0,0,0,0,0,31,12,4,2016,2016-12-31,1,2017,0,0
Bureau,Department of Transportation,Federal Transit Administration,null,100.0,100.0,0,0,783404,1,31,12,4,2016,2016-12-31,1,2017,783404,1
Bureau,Federal Communications Commission,Federal Communications Commission,null,100.0,100.0,0,0,189022350,8365,31,12,4,2016,2016-12-31,1,2017,189022350,8365
Bureau,Department of the Treasury,Tobacco Tax and Trade,null,100.0,100.0,0,0,1000,1,31,12,4,2016,2016-12-31,1,2017,1000,1
Bureau,Other Agencies,Consumer Financial Protection Bureau,null,0.0,0.0,217571,53,0,0,31,12,4,2016,2016-12-31,1,2017,217571,53
Bureau,Department of Homeland Security,Citizenship and Immigration Services,null,100.0,99.82285208148804,0,2,910914,1127,31,12,4,2016,2016-12-31,1,2017,910914,1129
Bureau,Department of Labor,Occupational Safety and Health Admin,null,95.8604883489449,90.23380418899173,1423339,401,32960886,3705,31,12,4,2016,2016-12-31,1,2017,34384225,4106
Bureau,Department of Housing and Urban Development,Public and Indian Housing Programs,null,0.0,0.0,0,0,0,0,31,12,4,2016,2016-12-31,1,2017,0,0
Bureau,Other Agencies,Comm. for Purchase from Blind/Handic.,null,0.0,0.0,8945,5,0,0,31,12,4,2016,2016-12-31,1,2017,8945,5
Bureau,Department of Education,Office of Postsecondary Education,null,0.0,0.0,2828265,2,0,0,31,12,4,2016,2016-12-31,1,2017,2828265,2
Bureau,Department of Homeland Security,Transportation Safety Administration,null,100.0,100.0,0,0,9118427,3719,31,12,4,2016,2016-12-31,1,2017,9118427,3719
Bureau,Department of Homeland Security,Office of Biometric Identity Management,null,0.0,0.0,0,0,0,0,31,12,4,2016,2016-12-31,1,2017,0,0
Bureau,Overseas Private Investment Corp Accts,Overseas Private Investment Corp Accts,null,0.0,0.0,0,0,0,0,31,12,4,2016,2016-12-31,1,2017,0,0
Bureau,Department of the Treasury,D.C. Pension Program,null,100.0,100.0,0,0,160179,16,31,12,4,2016,2016-12-31,1,2017,160179,16
Bureau,Federal Election Commission,Federal Election Commission,null,62.04224342800385,20.930232558139537,113882,34,186141,9,31,12,4,2016,2016-12-31,1,2017,300023,43
Bureau,Department of Health & Human Services,Centers for Disease Control,null,0.6058307048926094,16.0,4394089,42,26783,8,31,12,4,2016,2016-12-31,1,2017,4420872,50
Agency,National Science Foundation,null,CFO,100.0,100.0,0,0,946334,14,31,12,4,2016,2016-12-31,1,2017,946334,14
Bureau,Other Agencies,National Transportation Safety Board,null,0.0,0.0,0,0,0,0,31,12,4,2016,2016-12-31,1,2017,0,0
Bureau,Department of the Treasury,Interest on Tax/Deposit of Earnings,null,100.0,100.0,0,0,3240,2,31,12,4,2016,2016-12-31,1,2017,3240,2
Bureau,Department of Justice,Drug Enforcement Administration,null,100.0,100.0,0,0,274859,15,31,12,4,2016,2016-12-31,1,2017,274859,15
Bureau,Department of the Treasury,Financial Crimes Enforcement Network,null,100.0,100.0,0,0,1567838,4,31,12,4,2016,2016-12-31,1,2017,1567838,4
Bureau,Other Agencies/Boards/Commissions,U.S.-China Security Review Commission,null,0.0,0.0,1747,4,0,0,31,12,4,2016,2016-12-31,1,2017,1747,4
Bureau,Other Agencies,National Mediation Board,null,0.0,0.0,0,0,0,0,31,12,4,2016,2016-12-31,1,2017,0,0
Bureau,Other Agencies,Morris K. Udall Scholarship,null,0.0,0.0,0,0,0,0,31,12,4,2016,2016-12-31,1,2017,0,0
Bureau,Department of Transportation,Office of the Inspector General,null,0.0,0.0,1,0,0,0,31,12,4,2016,2016-12-31,1,2017,1,0
Bureau,U.S. Court of Appeals / Veterans Claims,U.S. Court of Appeals / Veterans Claims,null,0.0,0.0,40,1,0,0,31,12,4,2016,2016-12-31,1,2017,40,1
Agency,Department of Homeland Security,null,CFO,99.99985789974154,99.99323512997006,492,4,346233924,59125,31,12,4,2016,2016-12-31,1,2017,346234416,59129
Bureau,Smithsonian Institution,JFK Center for the Performing Arts,null,0.0,0.0,0,0,0,0,31,12,4,2016,2016-12-31,1,2017,0,0
Bureau,Farm Credit Administration,Farm Credit System Insurance Corporation,null,0.0,0.0,0,0,0,0,31,12,4,2016,2016-12-31,1,2017,0,0
Bureau,Department of Health & Human Services,Health Resources and Services Admin,null,100.0,100.0,0,0,67250861,457,31,12,4,2016,2016-12-31,1,2017,67250861,457
Bureau,Smithsonian Institution,Administrative Conference of the US,null,0.0,0.0,0,0,0,0,31,12,4,2016,2016-12-31,1,2017,0,0
Bureau,Department of Commerce,Economic Development Administration,null,0.0,0.0,0,0,0,0,31,12,4,2016,2016-12-31,1,2017,0,0
Bureau,Other Agencies,Archit.&Trans. Barriers Compliance Bd,null,0.0,0.0,0,0,0,0,31,12,4,2016,2016-12-31,1,2017,0,0
Bureau,Other Agencies,Chemical Safety Board,null,0.0,0.0,0,0,0,0,31,12,4,2016,2016-12-31,1,2017,0,0
Bureau,Department of Transportation,Surface Transportation Board,null,0.0,0.0,0,0,0,0,31,12,4,2016,2016-12-31,1,2017,0,0
Bureau,Department of Housing and Urban Development,Management and Administration,null,0.0,0.0,1245,5,0,0,31,12,4,2016,2016-12-31,1,2017,1245,5
Bureau,Department of Commerce,Patent and Trademark Office,null,100.0,100.0,0,0,185385,367,31,12,4,2016,2016-12-31,1,2017,185385,367
Bureau,Department of Labor,Employment and Training Administration,null,100.0,100.0,0,0,2927115,2,31,12,4,2016,2016-12-31,1,2017,2927115,2
Bureau,Department of Labor,Mine Safety and Health Administration,null,95.08039669505011,90.49025734249844,3173810,1674,61339725,15929,31,12,4,2016,2016-12-31,1,2017,64513535,17603
Agency,Department of Health & Human Services,null,CFO,95.08912589015907,95.24102540649034,566218890,91570,10963681436,1832584,31,12,4,2016,2016-12-31,1,2017,11529900326,1924154
Bureau,Funds Appropriated to the President,African Development Foundation,null,0.0,0.0,0,0,0,0,31,12,4,2016,2016-12-31,1,2017,0,0
Bureau,Department of Veterans Affairs,Administration and Cemeteries,null,0.6098866244918996,3.794037940379404,3291891,710,20200,28,31,12,4,2016,2016-12-31,1,2017,3312091,738
Bureau,Department of Health & Human Services,Administration for Children and Families,null,100.0,100.0,0,0,25049153,1064,31,12,4,2016,2016-12-31,1,2017,25049153,1064
Bureau,Department of the Treasury,Bureau of Engraving and Printing,null,0.0,0.0,84528,1,0,0,31,12,4,2016,2016-12-31,1,2017,84528,1
Bureau,Department of Justice,Office of Justice Assistance Programs,null,100.0,100.0,0,0,659486,8,31,12,4,2016,2016-12-31,1,2017,659486,8
Bureau,Department of Homeland Security,U.S. Coast Guard,null,100.0,100.0,0,0,46478687,7212,31,12,4,2016,2016-12-31,1,2017,46478687,7212
Bureau,Department of Homeland Security,Emergency Preparedness & Resp,null,100.0,100.0,0,0,276453396,46192,31,12,4,2016,2016-12-31,1,2017,276453396,46192
Bureau,Department of Housing and Urban Development,Community Planning and Development,null,0.0,0.0,0,0,0,0,31,12,4,2016,2016-12-31,1,2017,0,0
Bureau,Department of Homeland Security,Domestic Nuclear Detection Office,null,0.0,0.0,164,1,0,0,31,12,4,2016,2016-12-31,1,2017,164,1
Bureau,Other Agencies,James Madison Memorial Fellowship,null,0.0,0.0,242354,21,0,0,31,12,4,2016,2016-12-31,1,2017,242354,21
Bureau,Department of the Interior,Bureau of Safety and Environmental Enf.,null,100.0,100.0,0,0,5874,1,31,12,4,2016,2016-12-31,1,2017,5874,1
Bureau,Department of Labor,Employee Benefit Security Administration,null,100.0,100.0,0,0,16334048,345,31,12,4,2016,2016-12-31,1,2017,16334048,345
Agency,Agency for International Development,null,CFO,100.0,100.0,0,0,15398074,25,31,12,4,2016,2016-12-31,1,2017,15398074,25
Bureau,Department of the Interior,Bureau of Land Management,null,100.0,100.0,0,0,11558466,314,31,12,4,2016,2016-12-31,1,2017,11558466,314
Bureau,Office of Government Ethics,Office of Government Ethics,null,0.0,0.0,0,0,0,0,31,12,4,2016,2016-12-31,1,2017,0,0
Bureau,Export - Import  Bank,Export-Import Bank,null,0.0,0.0,0,0,0,0,31,12,4,2016,2016-12-31,1,2017,0,0
Bureau,Other Agencies,Election Assistance Commission,null,0.0,0.0,0,0,0,0,31,12,4,2016,2016-12-31,1,2017,0,0
Bureau,Other Agencies,National Council on Disability,null,0.0,0.0,0,0,0,0,31,12,4,2016,2016-12-31,1,2017,0,0
Bureau,Other Agencies,Architect of the Capitol,null,0.0,0.0,0,0,0,0,31,12,4,2016,2016-12-31,1,2017,0,0
Bureau,Other Agencies,U.S. Institute of Peace,null,0.0,0.0,4054,5,0,0,31,12,4,2016,2016-12-31,1,2017,4054,5
Bureau,Department of Homeland Security,Office of Health Affairs,null,0.0,0.0,0,0,0,0,31,12,4,2016,2016-12-31,1,2017,0,0
Bureau,Legislative Branch-CBO,Congressional Budget Office,null,0.0,0.0,0,0,0,0,31,12,4,2016,2016-12-31,1,2017,0,0
Bureau,Smithsonian Institution,National Gallery of Art,null,0.0,0.0,0,0,0,0,31,12,4,2016,2016-12-31,1,2017,0,0
Bureau,Department of Justice,Federal Prison System,null,100.0,100.0,0,0,554238,67,31,12,4,2016,2016-12-31,1,2017,554238,67
Agency,National Aeronautics and Space Administration,null,CFO,100.0,100.0,0,0,467157,80,31,12,4,2016,2016-12-31,1,2017,467157,80
Agency,Department of Energy,null,CFO,100.0,100.0,0,0,11576662,69,31,12,4,2016,2016-12-31,1,2017,11576662,69
Bureau,Department of Homeland Security,U.S. Secret Service,null,0.0,0.0,0,0,0,0,31,12,4,2016,2016-12-31,1,2017,0,0
Bureau,Department of Justice,U.S. Marshals Service,null,0.0,0.0,0,0,0,0,31,12,4,2016,2016-12-31,1,2017,0,0
Bureau,Railroad Retirement Board,Railroad Retirement Board,null,75.33157403883705,56.39620965353864,5392493,2945,16467406,3809,31,12,4,2016,2016-12-31,1,2017,21859899,6754
Bureau,Department of Commerce,NOAA,null,100.0,100.0,0,0,17909060,770,31,12,4,2016,2016-12-31,1,2017,17909060,770
Bureau,Office of Compliance,Office of Compliance,null,0.0,0.0,0,0,0,0,31,12,4,2016,2016-12-31,1,2017,0,0
Bureau,Department of Commerce,Economic and Statistical Analysis,null,0.0,0.0,0,0,0,0,31,12,4,2016,2016-12-31,1,2017,0,0
Bureau,Department of Homeland Security,Science and Technology,null,0.0,0.0,0,0,0,0,31,12,4,2016,2016-12-31,1,2017,0,0
Agency,Tennessee Valley Authority,null,Non-CFO,0.0,0.0,0,0,0,0,31,03,1,2017,2017-03-31,2,2017,0,0
Bureau,Department of the Treasury,Treasury IG for Tax Admin,null,0.0,0.0,0,0,0,0,31,03,1,2017,2017-03-31,2,2017,0,0
Agency,Neighborhood Reinvestment Corporation,null,Non-CFO,0.0,0.0,0,0,0,0,31,03,1,2017,2017-03-31,2,2017,0,0
Agency,Farm Credit Administration,null,Non-CFO,0.0,0.0,0,0,0,0,31,03,1,2017,2017-03-31,2,2017,0,0
Agency,Selective Service System,null,Non-CFO,0.0,0.0,1265,1,0,0,31,03,1,2017,2017-03-31,2,2017,1265,1
Bureau,Department of Commerce,International Trade Administration,null,0.0,0.0,0,0,0,0,31,03,1,2017,2017-03-31,2,2017,0,0
Bureau,Other Agencies,Delta Regional Authority,null,0.0,0.0,0,0,0,0,31,03,1,2017,2017-03-31,2,2017,0,0
Bureau,Other Agencies,Gulf Coast Ecosystem Restoration Council,null,0.0,0.0,0,0,0,0,31,03,1,2017,2017-03-31,2,2017,0,0
Bureau,National Credit Union Administration,Nat'l Credit Union Admin. Treasury Acct.,null,0.0,0.0,0,0,0,0,31,03,1,2017,2017-03-31,2,2017,0,0
Bureau,Other Agencies,Advisory Council on Hist. Preservation,null,0.0,0.0,0,0,0,0,31,03,1,2017,2017-03-31,2,2017,0,0
Bureau,Selective Service System,Selective Service System,null,0.0,0.0,1265,1,0,0,31,03,1,2017,2017-03-31,2,2017,1265,1
Agency,Overseas Private Investment Corp Accts,null,Non-CFO,0.0,0.0,0,0,0,0,31,03,1,2017,2017-03-31,2,2017,0,0
Bureau,Department of Homeland Security,Domestic Nuclear Detection Office,null,0.0,0.0,0,0,0,0,31,03,1,2017,2017-03-31,2,2017,0,0
Bureau,Legislative Branch-Office of Tech.,Open World Leadership,null,0.0,0.0,0,0,0,0,31,03,1,2017,2017-03-31,2,2017,0,0
Bureau,Other Agencies,Election Assistance Commission,null,0.0,0.0,0,0,0,0,31,03,1,2017,2017-03-31,2,2017,0,0
Bureau,Federal Labor Relations Authority,Federal Labor Relations Authority,null,0.0,0.0,0,0,0,0,31,03,1,2017,2017-03-31,2,2017,0,0
Bureau,Department of Justice,Bureau of ATF and Explosives,null,97.4128752927816,50.0,729,7,27449,7,31,03,1,2017,2017-03-31,2,2017,28178,14
Bureau,Department of Agriculture,Food Safety and Inspection Service,null,100.0,100.0,0,0,966187,1314,31,03,1,2017,2017-03-31,2,2017,966187,1314
Agency,Federal Labor Relations Authority,null,Non-CFO,0.0,0.0,0,0,0,0,31,03,1,2017,2017-03-31,2,2017,0,0
Agency,Office of Personnel Management,null,CFO,44.76734862623791,54.79308538501834,20269290,863,16428731,1046,31,03,1,2017,2017-03-31,2,2017,36698021,1909
Bureau,Department of Agriculture,Agricultural Marketing Service,null,65.70543444188505,41.13009198423128,364317,448,698000,313,31,03,1,2017,2017-03-31,2,2017,1062317,761
Bureau,Department of Homeland Security,Info Analysis Infrastructure Prot-NPPD,null,100.0,100.0,0,0,4610,1,31,03,1,2017,2017-03-31,2,2017,4610,1
Bureau,Department of Transportation,National Highway Traffic Safety Admin.,null,100.0,100.0,0,0,7637782,3,31,03,1,2017,2017-03-31,2,2017,7637782,3
Bureau,Department of Homeland Security,Office of Health Affairs,null,0.0,0.0,0,0,0,0,31,03,1,2017,2017-03-31,2,2017,0,0
Bureau,Funds Appropriated to the President,Peace Corps,null,0.0,0.0,0,0,0,0,31,03,1,2017,2017-03-31,2,2017,0,0
Bureau,Department of Commerce,General Administration,null,100.0,100.0,0,0,4660,1,31,03,1,2017,2017-03-31,2,2017,4660,1
Bureau,Department of the Treasury,Comptroller of the Currency,null,99.56197771645265,73.17073170731707,5303,11,1205366,30,31,03,1,2017,2017-03-31,2,2017,1210669,41
Bureau,Department of Veterans Affairs,Housing Credit Assistance,null,53.27634509572627,77.35849056603773,602067,12,686503,41,31,03,1,2017,2017-03-31,2,2017,1288570,53
Bureau,Other Agencies,Denali Commission,null,0.0,0.0,0,0,0,0,31,03,1,2017,2017-03-31,2,2017,0,0
Bureau,Other Agencies,Defense Nuclear Facilities Safety Board,null,0.0,0.0,0,0,0,0,31,03,1,2017,2017-03-31,2,2017,0,0
Bureau,Department of the Treasury,Bureau of the Fiscal Service,null,100.0,95.02699630576869,0,175,8809066,3344,31,03,1,2017,2017-03-31,2,2017,8809066,3519
Bureau,Department of the Treasury,Office of Sec International Affairs,null,0.0,0.0,0,0,0,0,31,03,1,2017,2017-03-31,2,2017,0,0
Bureau,Presidio Trust Corporation,Presidio Trust Corporation,null,97.92107566654276,94.73684210526316,27574,4,1298785,72,31,03,1,2017,2017-03-31,2,2017,1326359,76
Agency,Department of Transportation,null,CFO,79.41650450377938,80.07739716210406,13175225,1390,50833461,5587,31,03,1,2017,2017-03-31,2,2017,64008686,6977
Bureau,Department of the Interior,Bureau of Reclamation,null,100.0,100.0,0,0,91160,79,31,03,1,2017,2017-03-31,2,2017,91160,79
Agency,Export - Import  Bank,null,Non-CFO,0.0,0.0,0,0,0,0,31,03,1,2017,2017-03-31,2,2017,0,0
Agency,Department of Justice,null,CFO,98.78882556282413,99.05120955073829,868550,302,70842838,31528,31,03,1,2017,2017-03-31,2,2017,71711388,31830
Agency,National Credit Union Administration,null,Non-CFO,100.0,100.0,0,0,4821,2,31,03,1,2017,2017-03-31,2,2017,4821,2
Bureau,Other Agencies/Boards/Commissions,Medicare Payment Advisory Commission,null,0.0,0.0,0,0,0,0,31,03,1,2017,2017-03-31,2,2017,0,0
Bureau,National Labor Relations Board,National Labor Relations Board,null,0.0,0.0,0,0,0,0,31,03,1,2017,2017-03-31,2,2017,0,0
Agency,National Archives & Records Admin,null,Non-CFO,100.0,100.0,0,0,40513,84,31,03,1,2017,2017-03-31,2,2017,40513,84
Bureau,Legislative Branch-Office of Tech.,Medicaid & CHIP Payment & Access Comm.,null,0.0,0.0,0,0,0,0,31,03,1,2017,2017-03-31,2,2017,0,0
Bureau,The Judiciary,Administrative Office of the U.S. Courts,null,55.139418676297225,30.8411214953271,629782,148,774083,66,31,03,1,2017,2017-03-31,2,2017,1403865,214
Agency,Armed Forces Retirement Home,null,Non-CFO,100.0,100.0,0,0,60891,78,31,03,1,2017,2017-03-31,2,2017,60891,78
Bureau,Department of Justice,General Administration,null,0.0,0.0,0,0,0,0,31,03,1,2017,2017-03-31,2,2017,0,0
Agency,Legislative Branch-GPO,null,Non-CFO,0.0,0.0,121286,95,0,0,31,03,1,2017,2017-03-31,2,2017,121286,95
Bureau,Department of the Interior,Bureau of Indian Affairs,null,92.15330144384014,84.88653015961029,767491,3816,9013578,21433,31,03,1,2017,2017-03-31,2,2017,9781069,25249
Bureau,Other Agencies,Archit.&Trans. Barriers Compliance Bd,null,0.0,0.0,0,0,0,0,31,03,1,2017,2017-03-31,2,2017,0,0
Bureau,Department of Health & Human Services,Food and Drug Administration,null,94.89180301744497,21.69779286926995,757774,2306,14076697,639,31,03,1,2017,2017-03-31,2,2017,14834471,2945
Bureau,Department of Agriculture,U.S. Department of Agriculture,null,64.03865207160429,49.78120978120978,10472202,1951,18648514,1934,31,03,1,2017,2017-03-31,2,2017,29120716,3885
Bureau,Other Agencies,Council of Insps. Gen. of Intg. & Effy.,null,0.0,0.0,0,0,0,0,31,03,1,2017,2017-03-31,2,2017,0,0
Bureau,Office of Compliance,Office of Compliance,null,0.0,0.0,0,0,0,0,31,03,1,2017,2017-03-31,2,2017,0,0
Bureau,Department of the Treasury,Departmental Offices,null,99.93756270984957,98.32572298325724,11053,11,17691509,646,31,03,1,2017,2017-03-31,2,2017,17702562,657
Bureau,Department of Commerce,Patent and Trademark Office,null,100.0,100.0,0,0,208711,371,31,03,1,2017,2017-03-31,2,2017,208711,371
Bureau,Department of Justice,Federal Prison Industries,null,72.33111405270184,80.61674008810573,394638,44,1031650,183,31,03,1,2017,2017-03-31,2,2017,1426288,227
Bureau,Commodity Futures Trading Commission,Commodity Futures Trading Commission,null,92.18067507435788,97.37609329446065,46763438,9,551286118,334,31,03,1,2017,2017-03-31,2,2017,598049556,343
Bureau,Department of Education,Departmental Management,null,97.05864556984055,73.51694915254237,17778042,625,586638815,1735,31,03,1,2017,2017-03-31,2,2017,604416857,2360
Agency,Other Agencies/Boards/Commissions,null,Non-CFO,0.0,0.0,182973,7,0,0,31,03,1,2017,2017-03-31,2,2017,182973,7
Agency,Legislative Branch - U.S. House/Senate,null,Non-CFO,0.0,0.0,223150,193,0,0,31,03,1,2017,2017-03-31,2,2017,223150,193
Bureau,Legislative Branch-CBO,Congressional Budget Office,null,0.0,0.0,0,0,0,0,31,03,1,2017,2017-03-31,2,2017,0,0
Bureau,Department of Homeland Security,Office of Biometric Identity Management,null,0.0,0.0,0,0,0,0,31,03,1,2017,2017-03-31,2,2017,0,0
Agency,Federal Election Commission,null,Non-CFO,44.30885531966921,14.583333333333334,214084,41,170329,7,31,03,1,2017,2017-03-31,2,2017,384413,48
Bureau,National Archives & Records Admin,Nat'l Archives & Records Administration,null,100.0,100.0,0,0,40513,84,31,03,1,2017,2017-03-31,2,2017,40513,84
Bureau,Department of the Treasury,Bureau of Engraving and Printing,null,100.0,100.0,0,0,84528,1,31,03,1,2017,2017-03-31,2,2017,84528,1
Bureau,Funds Appropriated to the President,African Development Foundation,null,0.0,0.0,0,0,0,0,31,03,1,2017,2017-03-31,2,2017,0,0
Bureau,Other Agencies,James Madison Memorial Fellowship,null,0.0,0.0,221913,22,0,0,31,03,1,2017,2017-03-31,2,2017,221913,22
Bureau,Agency for International Development,Agency for International Development,null,99.77674104892021,95.1219512195122,53332,2,23834624,39,31,03,1,2017,2017-03-31,2,2017,23887956,41
Bureau,Other Agencies,Federal Housing Finance Agency OIG,null,0.0,0.0,0,0,0,0,31,03,1,2017,2017-03-31,2,2017,0,0
Agency,Department of Veterans Affairs,null,CFO,91.29663864197774,98.13280423211803,92259553,115177,967785517,6053271,31,03,1,2017,2017-03-31,2,2017,1060045070,6168448
Bureau,American Battle Monuments Commission,American Battle Monuments Commission,null,0.0,0.0,0,0,0,0,31,03,1,2017,2017-03-31,2,2017,0,0
Agency,Federal Maritime Commission,null,Non-CFO,100.0,100.0,0,0,472598,6,31,03,1,2017,2017-03-31,2,2017,472598,6
Bureau,Department of Transportation,Federal Railroad Administration,null,100.0,100.0,0,0,258142,20,31,03,1,2017,2017-03-31,2,2017,258142,20
Bureau,Railroad Retirement Board,Railroad Retirement Board,null,56.152375182932516,49.04754529967477,13054574,3290,16718017,3167,31,03,1,2017,2017-03-31,2,2017,29772591,6457
Agency,Department of Housing and Urban Development,null,CFO,99.49974861582851,99.4574694826584,601822,28,119702093,5133,31,03,1,2017,2017-03-31,2,2017,120303915,5161
Bureau,Department of the Interior,"Bureau of Ocean Energy Mgmt., Reg & Enf",null,0.0,0.0,0,0,0,0,31,03,1,2017,2017-03-31,2,2017,0,0
Bureau,Department of Defense,Consolidated Report,null,50.80564421098185,23.17301672362465,1190153713,1022193,1229135439,308320,31,03,1,2017,2017-03-31,2,2017,2419289152,1330513
Bureau,Merit Systems Protection Board,Merit Systems Protection Board,null,0.0,0.0,0,0,0,0,31,03,1,2017,2017-03-31,2,2017,0,0
Bureau,National Credit Union Administration,National Credit Union Administration,null,100.0,100.0,0,0,4821,2,31,03,1,2017,2017-03-31,2,2017,4821,2
Bureau,Corp. for National and Community Service,Corp. for National and Community Service,null,99.70576752808996,92.66055045871559,9059,16,3069799,202,31,03,1,2017,2017-03-31,2,2017,3078858,218
Bureau,Department of Education,Federal Student Aid,null,60.132364184957,49.8026869765718,48818002981,12277432,73632205021,12180913,31,03,1,2017,2017-03-31,2,2017,122450208002,24458345
Bureau,Other Agencies,National Capital Planning Commission,null,0.0,0.0,0,0,0,0,31,03,1,2017,2017-03-31,2,2017,0,0
Agency,Equal Employment Opportunity Commission,null,Non-CFO,90.32081411062039,46.666666666666664,49136,56,458510,49,31,03,1,2017,2017-03-31,2,2017,507646,105
Bureau,Department of Labor,Occupational Safety and Health Admin,null,95.66562352760084,90.61992105874158,1584198,404,34965419,3903,31,03,1,2017,2017-03-31,2,2017,36549617,4307
Agency,Other Agencies,null,Non-CFO,0.03588561593821247,1.0526315789473684,559912,94,201,1,31,03,1,2017,2017-03-31,2,2017,560113,95
Bureau,Office of Government Ethics,Office of Government Ethics,null,0.0,0.0,0,0,0,0,31,03,1,2017,2017-03-31,2,2017,0,0
Bureau,Office of Personnel Management,Office of Personnel Management,null,44.76734862623791,54.79308538501834,20269290,863,16428731,1046,31,03,1,2017,2017-03-31,2,2017,36698021,1909
Agency,Department of Agriculture,null,CFO,96.96456173030285,81.16235316437685,43994903,11915,1405380742,51336,31,03,1,2017,2017-03-31,2,2017,1449375645,63251
Bureau,Department of Transportation,Federal Motor Carrier Safety Admin,null,74.3293820932957,78.44672866699298,12442271,1321,36026648,4808,31,03,1,2017,2017-03-31,2,2017,48468919,6129
Agency,Presidio Trust Corporation,null,Non-CFO,97.92107566654276,94.73684210526316,27574,4,1298785,72,31,03,1,2017,2017-03-31,2,2017,1326359,76
Bureau,Securities & Exchange Commission,Securities and Exchange Commission,null,99.993491573772,97.05583756345177,144832,29,2225155032,956,31,03,1,2017,2017-03-31,2,2017,2225299864,985
Agency,Department of Defense,null,CFO,50.80564421098185,23.17301672362465,1190153713,1022193,1229135439,308320,31,03,1,2017,2017-03-31,2,2017,2419289152,1330513
Agency,Corp. for National and Community Service,null,Non-CFO,99.70576752808996,92.66055045871559,9059,16,3069799,202,31,03,1,2017,2017-03-31,2,2017,3078858,218
Agency,Pension Benefit Guaranty Corp,null,Non-CFO,10.92199025492137,23.086124401913874,3899291,643,478098,193,31,03,1,2017,2017-03-31,2,2017,4377389,836
Bureau,Department of Homeland Security,U.S. Secret Service,null,0.0,0.0,0,0,0,0,31,03,1,2017,2017-03-31,2,2017,0,0
Bureau,Department of Veterans Affairs,Administration and Cemeteries,null,0.7327540222410753,3.6241610738255035,3126410,718,23078,27,31,03,1,2017,2017-03-31,2,2017,3149488,745
Agency,Social Security Administration,null,CFO,26.1260220036288,11.238341089493856,4334907107,2248750,1533068633,284720,31,03,1,2017,2017-03-31,2,2017,5867975740,2533470
Agency,Railroad Retirement Board,null,Non-CFO,56.152375182932516,49.04754529967477,13054574,3290,16718017,3167,31,03,1,2017,2017-03-31,2,2017,29772591,6457
Bureau,Department of Health & Human Services,Indian Health Services,null,37.026332256383405,7.6440387906446094,30704745,1619,18053325,134,31,03,1,2017,2017-03-31,2,2017,48758070,1753
Bureau,Department of the Treasury,Treasury Forfeiture Fund,null,0.0,0.0,0,0,0,0,31,03,1,2017,2017-03-31,2,2017,0,0
Bureau,Department of Health & Human Services,Centers for Disease Control,null,0.623096731123925,28.571428571428573,4349736,20,27273,8,31,03,1,2017,2017-03-31,2,2017,4377009,28
Agency,U.S. Postal Service,null,Non-CFO,89.1876085168601,64.67879113860221,5916000,21014,48799000,38480,31,03,1,2017,2017-03-31,2,2017,54715000,59494
Bureau,Department of Transportation,Research Innovative Technology Admin,null,99.98054096127652,100.0,1,0,5138,2,31,03,1,2017,2017-03-31,2,2017,5139,2
Agency,Federal Communications Commission,null,Non-CFO,100.0,100.0,0,0,190789671,9126,31,03,1,2017,2017-03-31,2,2017,190789671,9126
Agency,Federal Trade Commission,null,Non-CFO,100.0,100.0,0,0,483144518,56,31,03,1,2017,2017-03-31,2,2017,483144518,56
Bureau,Department of Commerce,Bureau of Industry and Security,null,0.0,0.0,0,0,0,0,31,03,1,2017,2017-03-31,2,2017,0,0
Bureau,Department of Housing and Urban Development,Community Planning and Development,null,0.0,0.0,0,0,0,0,31,03,1,2017,2017-03-31,2,2017,0,0
Bureau,Funds Appropriated to the President,Trade and Development Agency,null,0.0,0.0,0,0,0,0,31,03,1,2017,2017-03-31,2,2017,0,0
Agency,Commodity Futures Trading Commission,null,Non-CFO,92.18067507435788,97.37609329446065,46763438,9,551286118,334,31,03,1,2017,2017-03-31,2,2017,598049556,343
Bureau,Department of Agriculture,Forest Service,null,75.2293442577007,4.415874790385691,13443426,8550,40828153,395,31,03,1,2017,2017-03-31,2,2017,54271579,8945
Bureau,Other Agencies,Commission On Fine Arts,null,0.0,0.0,0,0,0,0,31,03,1,2017,2017-03-31,2,2017,0,0
Bureau,Farm Credit Administration,Farm Credit Administration,null,0.0,0.0,0,0,0,0,31,03,1,2017,2017-03-31,2,2017,0,0
Bureau,Department of Commerce,Nat'l Telecomm & Information Admin.,null,0.0,0.0,0,0,0,0,31,03,1,2017,2017-03-31,2,2017,0,0
Bureau,Pension Benefit Guaranty Corp,Pension Benefit Guaranty Corporation,null,10.92199025492137,23.086124401913874,3899291,643,478098,193,31,03,1,2017,2017-03-31,2,2017,4377389,836
Bureau,Department of Transportation,Federal Aviation Administration,null,85.79419142892276,91.01717305151915,732437,68,4423461,689,31,03,1,2017,2017-03-31,2,2017,5155898,757
Bureau,Department of Transportation,Maritime Administration,null,93.04054054054055,83.33333333333333,515,1,6885,5,31,03,1,2017,2017-03-31,2,2017,7400,6
Bureau,Department of the Treasury,Internal Revenue Service,null,98.92746379211707,97.5609756097561,3562,3,328548,120,31,03,1,2017,2017-03-31,2,2017,332110,123
Bureau,Department of Homeland Security,Science and Technology,null,0.0,0.0,0,0,0,0,31,03,1,2017,2017-03-31,2,2017,0,0
Bureau,Department of Transportation,Federal Highway Administration,null,100.0,100.0,0,0,13187,9,31,03,1,2017,2017-03-31,2,2017,13187,9
Bureau,Department of Justice,Legal Activities,null,99.95425048974117,99.90717920814262,31305,29,68395657,31214,31,03,1,2017,2017-03-31,2,2017,68426962,31243
Bureau,Department of the Treasury,U.S. Treasury IG Office,null,0.0,0.0,0,0,0,0,31,03,1,2017,2017-03-31,2,2017,0,0
Bureau,Department of the Interior,Office of the Secretary,null,100.0,100.0,0,0,19635,11,31,03,1,2017,2017-03-31,2,2017,19635,11
Bureau,Federal Election Commission,Federal Election Commission,null,44.30885531966921,14.583333333333334,214084,41,170329,7,31,03,1,2017,2017-03-31,2,2017,384413,48
Bureau,Department of Transportation,Surface Transportation Board,null,0.0,0.0,0,0,0,0,31,03,1,2017,2017-03-31,2,2017,0,0
Bureau,Department of Housing and Urban Development,Public and Indian Housing Programs,null,0.0,0.0,0,0,0,0,31,03,1,2017,2017-03-31,2,2017,0,0
Bureau,Department of Justice,Federal Bureau of Investigation,null,12.394800127677208,7.112970711297071,441878,222,62519,17,31,03,1,2017,2017-03-31,2,2017,504397,239
Bureau,Department of Labor,Employment Standards Administration,null,52.48013502111861,22.769263069494016,32726845,7357,36142974,2169,31,03,1,2017,2017-03-31,2,2017,68869819,9526
Bureau,Department of the Treasury,Interest on Public Debt,null,0.0,0.0,0,0,0,0,31,03,1,2017,2017-03-31,2,2017,0,0
Bureau,Equal Employment Opportunity Commission,Equal Employment Opportunity Commission,null,90.32081411062039,46.666666666666664,49136,56,458510,49,31,03,1,2017,2017-03-31,2,2017,507646,105
Bureau,Department of Homeland Security,Management Headquarters,null,0.0,0.0,0,0,0,0,31,03,1,2017,2017-03-31,2,2017,0,0
Bureau,Department of Housing and Urban Development,Housing Programs,null,99.50254667202968,99.53461314717859,598439,24,119702093,5133,31,03,1,2017,2017-03-31,2,2017,120300532,5157
Bureau,U.S. Court of Appeals / Veterans Claims,U.S. Court of Appeals / Veterans Claims,null,0.0,0.0,40,1,0,0,31,03,1,2017,2017-03-31,2,2017,40,1
Agency,Securities & Exchange Commission,null,Non-CFO,99.993491573772,97.05583756345177,144832,29,2225155032,956,31,03,1,2017,2017-03-31,2,2017,2225299864,985
Bureau,Department of Health & Human Services,Office of the Secretary,null,100.0,100.0,0,0,230,2,31,03,1,2017,2017-03-31,2,2017,230,2
Bureau,Consumer Product Safety Commission,Consumer Product Safety Commission,null,100.0,100.0,0,0,427,1,31,03,1,2017,2017-03-31,2,2017,427,1
Agency,American Battle Monuments Commission,null,Non-CFO,0.0,0.0,0,0,0,0,31,03,1,2017,2017-03-31,2,2017,0,0
Bureau,Department of Commerce,Economic and Statistical Analysis,null,0.0,0.0,0,0,0,0,31,03,1,2017,2017-03-31,2,2017,0,0
Bureau,Nuclear Regulatory Commission,Nuclear Regulatory Commission,null,100.0,100.0,0,0,868109,183,31,03,1,2017,2017-03-31,2,2017,868109,183
Bureau,Department of Homeland Security,Citizenship and Immigration Services,null,100.0,100.0,0,0,906891,1107,31,03,1,2017,2017-03-31,2,2017,906891,1107
Bureau,Department of Veterans Affairs,Medical and Construction,null,83.0865930359854,98.13981343689885,87236523,112750,428546744,5948470,31,03,1,2017,2017-03-31,2,2017,515783267,6061220
Bureau,Department of Veterans Affairs,Veterans Benefits,null,99.75996489997979,98.40432534085566,1294553,1697,538023655,104653,31,03,1,2017,2017-03-31,2,2017,539318208,106350
Bureau,Other Agencies,U.S. Inst. for Env. Conflict Resolution,null,0.9602981224021786,16.666666666666668,20730,5,201,1,31,03,1,2017,2017-03-31,2,2017,20931,6
Agency,Legislative Branch-CBO,null,Non-CFO,0.0,0.0,0,0,0,0,31,03,1,2017,2017-03-31,2,2017,0,0
Bureau,Legis Branch-Library of Congress,Library of Congress,null,0.0,0.0,0,0,0,0,31,03,1,2017,2017-03-31,2,2017,0,0
Bureau,Department of Homeland Security,Office of the Inspector General DHS,null,100.0,100.0,0,0,1519,3,31,03,1,2017,2017-03-31,2,2017,1519,3
Bureau,National Foundation  Arts & Humanities,National Endowment for the Arts,null,0.0,0.0,0,0,0,0,31,03,1,2017,2017-03-31,2,2017,0,0
Agency,Nuclear Regulatory Commission,null,CFO,100.0,100.0,0,0,868109,183,31,03,1,2017,2017-03-31,2,2017,868109,183
Agency,National Science Foundation,null,CFO,100.0,100.0,0,0,949294,17,31,03,1,2017,2017-03-31,2,2017,949294,17
Agency,General Services Administration,null,CFO,70.96071968822021,84.64081092992508,5350578,697,13074734,3841,31,03,1,2017,2017-03-31,2,2017,18425312,4538
Agency,Federal Deposit Insurance Corporation,null,Non-CFO,0.0,0.0,0,0,0,0,31,03,1,2017,2017-03-31,2,2017,0,0
Agency,Occupational Safety & Health Rev Comm,null,Non-CFO,0.0,0.0,0,0,0,0,31,03,1,2017,2017-03-31,2,2017,0,0
Agency,Funds Appropriated to the President,null,Non-CFO,0.0,0.0,0,0,0,0,31,03,1,2017,2017-03-31,2,2017,0,0
Agency,U.S. Court of Appeals / Veterans Claims,null,Non-CFO,0.0,0.0,40,1,0,0,31,03,1,2017,2017-03-31,2,2017,40,1
Agency,Consumer Product Safety Commission,null,Non-CFO,100.0,100.0,0,0,427,1,31,03,1,2017,2017-03-31,2,2017,427,1
Bureau,Smithsonian Institution,Smithsonian Institution,null,0.0,0.0,0,0,0,0,31,03,1,2017,2017-03-31,2,2017,0,0
Bureau,U.S. Postal Service,U.S. Postal Service,null,89.1876085168601,64.67879113860221,5916000,21014,48799000,38480,31,03,1,2017,2017-03-31,2,2017,54715000,59494
Bureau,Department of Health & Human Services,Centers for Medicare & Medicaid Services,null,98.04691720248837,95.39179871550702,205562896,87759,10319484801,1816650,31,03,1,2017,2017-03-31,2,2017,10525047697,1904409
Agency,Department of Labor,null,CFO,79.79505465920172,70.74823499747856,38179273,9281,150780768,22447,31,03,1,2017,2017-03-31,2,2017,188960041,31728
Agency,The Judiciary,null,Non-CFO,55.139418676297225,30.8411214953271,629782,148,774083,66,31,03,1,2017,2017-03-31,2,2017,1403865,214
Bureau,Other Agencies,U.S.  Agency of Global Media,null,0.0,0.0,0,0,0,0,31,03,1,2017,2017-03-31,2,2017,0,0
Agency,Office of Special Counsel,null,Non-CFO,0.0,0.0,0,0,0,0,31,03,1,2017,2017-03-31,2,2017,0,0
Bureau,Department of Agriculture,Federal Crop Insurance Corporation,null,100.0,99.6951219512195,0,1,138676,327,31,03,1,2017,2017-03-31,2,2017,138676,328
Bureau,Department of the Treasury,International Monetary Funds,null,0.0,0.0,0,0,0,0,31,03,1,2017,2017-03-31,2,2017,0,0
Bureau,Department of Homeland Security,Immigration and Customs Enforcement,null,100.0,100.0,0,0,7091716,349,31,03,1,2017,2017-03-31,2,2017,7091716,349
Agency,Department of State,null,CFO,93.49647803156243,98.95524799396844,1307853,194,18802066,18375,31,03,1,2017,2017-03-31,2,2017,20109919,18569
Bureau,Funds Appropriated to the President,Inter-American Foundation,null,0.0,0.0,0,0,0,0,31,03,1,2017,2017-03-31,2,2017,0,0
Bureau,Department of Health & Human Services,Program Support Center,null,100.0,100.0,0,0,3524675,518,31,03,1,2017,2017-03-31,2,2017,3524675,518
Bureau,Department of the Treasury,U.S. Mint,null,100.0,100.0,0,0,34592,8,31,03,1,2017,2017-03-31,2,2017,34592,8
Bureau,Department of Justice,Federal Prison System,null,100.0,100.0,0,0,765279,76,31,03,1,2017,2017-03-31,2,2017,765279,76
Bureau,Department of Health & Human Services,Office of the Inspector General,null,0.0,0.0,0,0,0,0,31,03,1,2017,2017-03-31,2,2017,0,0
Bureau,Department of Labor,Departmental Management,null,0.0,0.0,0,0,0,0,31,03,1,2017,2017-03-31,2,2017,0,0
Bureau,Department of Transportation,Office of the Inspector General,null,100.0,100.0,0,0,2235,1,31,03,1,2017,2017-03-31,2,2017,2235,1
Bureau,General Services Administration,General Services Administration,null,70.96071968822021,84.64081092992508,5350578,697,13074734,3841,31,03,1,2017,2017-03-31,2,2017,18425312,4538
Agency,Small Business Administration,null,CFO,99.54949354568177,99.61030278505956,49492572,443,10936492540,113235,31,03,1,2017,2017-03-31,2,2017,10985985112,113678
Bureau,Other Agencies,District of Columbia Government,null,0.0,0.0,0,0,0,0,31,03,1,2017,2017-03-31,2,2017,0,0
Bureau,National Foundation  Arts & Humanities,National Endowment for the Humanities,null,0.0,0.0,0,0,0,0,31,03,1,2017,2017-03-31,2,2017,0,0
Bureau,Armed Forces Retirement Home,Armed Forces Retirement Home,null,100.0,100.0,0,0,60891,78,31,03,1,2017,2017-03-31,2,2017,60891,78
Bureau,Department of Agriculture,Commodity Credit Corporation,null,99.64709050272941,99.81551606952131,410113,19,115799001,10280,31,03,1,2017,2017-03-31,2,2017,116209114,10299
Bureau,Department of Transportation,Pipeline Hazardous Material Safety Admin,null,99.99973432165677,100.0,1,0,376394,25,31,03,1,2017,2017-03-31,2,2017,376395,25
Bureau,Department of Health & Human Services,Administration for Children and Families,null,100.0,100.0,0,0,29677094,1053,31,03,1,2017,2017-03-31,2,2017,29677094,1053
Bureau,Department of Homeland Security,Emergency Preparedness & Resp,null,100.0,100.0,0,0,272043110,44527,31,03,1,2017,2017-03-31,2,2017,272043110,44527
Agency,Department of the Treasury,null,CFO,99.93625953218887,95.43170397441754,19918,200,31228676,4178,31,03,1,2017,2017-03-31,2,2017,31248594,4378
Bureau,Department of Transportation,St. Lawrence Seaway Development Corp.,null,0.0,0.0,0,0,0,0,31,03,1,2017,2017-03-31,2,2017,0,0
Bureau,Department of the Treasury,Bureau of Public Debt,null,0.0,0.0,0,0,0,0,31,03,1,2017,2017-03-31,2,2017,0,0
Bureau,Other Agencies,Morris K. Udall Scholarship,null,0.0,0.0,982,1,0,0,31,03,1,2017,2017-03-31,2,2017,982,1
Bureau,Department of Housing and Urban Development,Management and Administration,null,0.0,0.0,3,1,0,0,31,03,1,2017,2017-03-31,2,2017,3,1
Bureau,Smithsonian Institution,JFK Center for the Performing Arts,null,0.0,0.0,0,0,0,0,31,03,1,2017,2017-03-31,2,2017,0,0
Bureau,Other Agencies,Millennium Challenge Corporation,null,0.0,0.0,0,0,0,0,31,03,1,2017,2017-03-31,2,2017,0,0
Bureau,Smithsonian Institution,National Gallery of Art,null,0.0,0.0,0,0,0,0,31,03,1,2017,2017-03-31,2,2017,0,0
Bureau,Department of Energy,Energy Consolidated Reports,null,100.0,100.0,0,0,10484688,43,31,03,1,2017,2017-03-31,2,2017,10484688,43
Bureau,Other Agencies,Consumer Financial Protection Bureau,null,0.0,0.0,303288,56,0,0,31,03,1,2017,2017-03-31,2,2017,303288,56
Agency,National Labor Relations Board,null,Non-CFO,0.0,0.0,0,0,0,0,31,03,1,2017,2017-03-31,2,2017,0,0
Agency,Smithsonian Institution,null,Non-CFO,0.0,0.0,0,0,0,0,31,03,1,2017,2017-03-31,2,2017,0,0
Bureau,Other Agencies,U.S. Institute of Peace,null,0.0,0.0,4054,5,0,0,31,03,1,2017,2017-03-31,2,2017,4054,5
Bureau,Other Agencies,Federal Housing Finance Agency,null,0.0,0.0,0,0,0,0,31,03,1,2017,2017-03-31,2,2017,0,0
Bureau,Overseas Private Investment Corp Accts,Overseas Private Investment Corp Accts,null,0.0,0.0,0,0,0,0,31,03,1,2017,2017-03-31,2,2017,0,0
Bureau,Other Agencies,U.S. Holocaust Memorial Council,null,0.0,0.0,0,0,0,0,31,03,1,2017,2017-03-31,2,2017,0,0
Bureau,Social Security Administration,Social Security Administration,null,26.1260220036288,11.238341089493856,4334907107,2248750,1533068633,284720,31,03,1,2017,2017-03-31,2,2017,5867975740,2533470
Agency,National Foundation  Arts & Humanities,null,Non-CFO,0.0,0.0,0,0,0,0,31,03,1,2017,2017-03-31,2,2017,0,0
Bureau,Smithsonian Institution,Administrative Conference of the US,null,0.0,0.0,0,0,0,0,31,03,1,2017,2017-03-31,2,2017,0,0
Bureau,Office of Special Counsel,Office of Special Counsel,null,0.0,0.0,0,0,0,0,31,03,1,2017,2017-03-31,2,2017,0,0
Bureau,Federal Trade Commission,Federal Trade Commission,null,100.0,100.0,0,0,483144518,56,31,03,1,2017,2017-03-31,2,2017,483144518,56
Bureau,Funds Appropriated to the President,Executive Branch,null,0.0,0.0,0,0,0,0,31,03,1,2017,2017-03-31,2,2017,0,0
Bureau,Other Agencies,Architect of the Capitol,null,0.0,0.0,0,0,0,0,31,03,1,2017,2017-03-31,2,2017,0,0
Bureau,Department of the Treasury,Financial Crimes Enforcement Network,null,100.0,100.0,0,0,67326,3,31,03,1,2017,2017-03-31,2,2017,67326,3
Bureau,Department of Commerce,Nat'l Institute of Standards& Technology,null,100.0,100.0,0,0,673065,8,31,03,1,2017,2017-03-31,2,2017,673065,8
Bureau,Funds Appropriated to the President,Defense Security Assistance Agency,null,0.0,0.0,0,0,0,0,31,03,1,2017,2017-03-31,2,2017,0,0
Bureau,Occupational Safety & Health Rev Comm,Occupational Safety & Health Rev Comm,null,0.0,0.0,0,0,0,0,31,03,1,2017,2017-03-31,2,2017,0,0
Bureau,Federal Communications Commission,Federal Communications Commission,null,100.0,100.0,0,0,190789671,9126,31,03,1,2017,2017-03-31,2,2017,190789671,9126
Bureau,Other Agencies,Federal Mine Safety & Health Review Comm,null,0.0,0.0,0,0,0,0,31,03,1,2017,2017-03-31,2,2017,0,0
Bureau,Department of Health & Human Services,Administration for Community Living,null,0.0,0.0,0,0,0,0,31,03,1,2017,2017-03-31,2,2017,0,0
Bureau,Department of Housing and Urban Development,Government National Mortgage Association,null,0.0,0.0,3380,3,0,0,31,03,1,2017,2017-03-31,2,2017,3380,3
Bureau,Other Agencies,Comm. for Purchase from Blind/Handic.,null,0.0,0.0,8945,5,0,0,31,03,1,2017,2017-03-31,2,2017,8945,5
Bureau,Department of Commerce,Bureau of the Census,null,100.0,100.0,0,0,41155,95,31,03,1,2017,2017-03-31,2,2017,41155,95
Bureau,Department of Justice,Office of Justice Assistance Programs,null,100.0,100.0,0,0,285451,16,31,03,1,2017,2017-03-31,2,2017,285451,16
Bureau,National Aeronautics and Space Administration,National Aeronautics and Space Admin,null,100.0,100.0,0,0,455512,73,31,03,1,2017,2017-03-31,2,2017,455512,73
Bureau,Small Business Administration,Small Business Administration,null,99.54949354568177,99.61030278505956,49492572,443,10936492540,113235,31,03,1,2017,2017-03-31,2,2017,10985985112,113678
Bureau,Department of Veterans Affairs,Life Insurance,null,100.0,100.0,0,0,505537,80,31,03,1,2017,2017-03-31,2,2017,505537,80
Bureau,Department of the Interior,Bureau of Land Management,null,100.0,100.0,0,0,11658582,286,31,03,1,2017,2017-03-31,2,2017,11658582,286
Bureau,Department of Agriculture,Rural Development,null,100.0,100.0,0,0,549789352,24403,31,03,1,2017,2017-03-31,2,2017,549789352,24403
Bureau,Department of State,Civil Monetary Penalties,null,0.0,0.0,0,0,0,0,31,03,1,2017,2017-03-31,2,2017,0,0
Bureau,Other Agencies,Surface Transportation Board,null,0.0,0.0,0,0,0,0,31,03,1,2017,2017-03-31,2,2017,0,0
Bureau,Export - Import  Bank,Export-Import Bank,null,0.0,0.0,0,0,0,0,31,03,1,2017,2017-03-31,2,2017,0,0
Bureau,Department of the Treasury,Office of Financial Research,null,100.0,100.0,0,0,36,1,31,03,1,2017,2017-03-31,2,2017,36,1
Agency,Merit Systems Protection Board,null,Non-CFO,0.0,0.0,0,0,0,0,31,03,1,2017,2017-03-31,2,2017,0,0
Bureau,Department of State,International Commissions,null,0.0,0.0,0,0,0,0,31,03,1,2017,2017-03-31,2,2017,0,0
Agency,Legis Branch-Library of Congress,null,Non-CFO,0.0,0.0,0,0,0,0,31,03,1,2017,2017-03-31,2,2017,0,0
Bureau,Federal Mediation/Conciliation Service,Federal Mediation/Conciliation Service,null,0.0,0.0,0,0,0,0,31,03,1,2017,2017-03-31,2,2017,0,0
Bureau,Neighborhood Reinvestment Corporation,Neighborhood Reinvestment Corporation,null,0.0,0.0,0,0,0,0,31,03,1,2017,2017-03-31,2,2017,0,0
Bureau,Department of the Treasury,Spec Insp Gen-Troubled Asset Rel Prog,null,100.0,100.0,0,0,3916,1,31,03,1,2017,2017-03-31,2,2017,3916,1
Agency,National Aeronautics and Space Administration,null,CFO,100.0,100.0,0,0,455512,73,31,03,1,2017,2017-03-31,2,2017,455512,73
Bureau,Federal Deposit Insurance Corporation,Federal Deposit Insurance Corporation,null,0.0,0.0,0,0,0,0,31,03,1,2017,2017-03-31,2,2017,0,0
Bureau,Department of Education,Office of Postsecondary Education,null,0.0,0.0,0,0,0,0,31,03,1,2017,2017-03-31,2,2017,0,0
Bureau,Department of the Interior,Bureau of Safety and Environmental Enf.,null,100.0,100.0,0,0,5874,1,31,03,1,2017,2017-03-31,2,2017,5874,1
Bureau,Department of the Interior,Geological Survey,null,100.0,100.0,0,0,88742,77,31,03,1,2017,2017-03-31,2,2017,88742,77
Bureau,National Science Foundation,National Science Foundation,null,100.0,100.0,0,0,949294,17,31,03,1,2017,2017-03-31,2,2017,949294,17
Bureau,Department of Transportation,Office of the Secretary,null,100.0,100.0,0,0,1299199,22,31,03,1,2017,2017-03-31,2,2017,1299199,22
Bureau,Department of the Interior,Office of Natural Resources Revenue,null,100.0,100.0,0,0,9029223,166,31,03,1,2017,2017-03-31,2,2017,9029223,166
Bureau,Department of Commerce,NOAA,null,100.0,100.0,0,0,18057790,715,31,03,1,2017,2017-03-31,2,2017,18057790,715
Bureau,Department of Homeland Security,Bureau of Customs & Border Protection,null,100.0,100.0,0,0,6402992,490,31,03,1,2017,2017-03-31,2,2017,6402992,490
Agency,Department of Education,null,CFO,60.31373783881944,49.8049749588166,48835781023,12278057,74218843836,12182648,31,03,1,2017,2017-03-31,2,2017,123054624859,24460705
Bureau,Department of Commerce,Minority Business Development Agency,null,0.0,0.0,0,0,0,0,31,03,1,2017,2017-03-31,2,2017,0,0
Bureau,Legislative Branch-GPO,Government Publishing Office,null,0.0,0.0,121286,95,0,0,31,03,1,2017,2017-03-31,2,2017,121286,95
Bureau,Department of Labor,Employee Benefit Security Administration,null,100.0,100.0,0,0,16514407,355,31,03,1,2017,2017-03-31,2,2017,16514407,355
Agency,Department of the Interior,null,CFO,97.97861441150258,86.3874719081083,767491,3816,37201069,24217,31,03,1,2017,2017-03-31,2,2017,37968560,28033
Agency,Department of Homeland Security,null,CFO,100.0,100.0,0,0,353423419,58662,31,03,1,2017,2017-03-31,2,2017,353423419,58662
Bureau,Other Agencies/Boards/Commissions,U.S.-China Security Review Commission,null,0.0,0.0,1747,4,0,0,31,03,1,2017,2017-03-31,2,2017,1747,4
Bureau,Legislative Branch - U.S. House/Senate,U.S. House of Representatives,null,0.0,0.0,223150,193,0,0,31,03,1,2017,2017-03-31,2,2017,223150,193
Bureau,Other Agencies/Boards/Commissions,U.S. Comm. on Int. Religious Freedom,null,0.0,0.0,181226,3,0,0,31,03,1,2017,2017-03-31,2,2017,181226,3
Bureau,Department of Health & Human Services,Substance Abuse & Mental Health Admin.,null,100.0,100.0,0,0,596280,11,31,03,1,2017,2017-03-31,2,2017,596280,11
Agency,Agency for International Development,null,CFO,99.77674104892021,95.1219512195122,53332,2,23834624,39,31,03,1,2017,2017-03-31,2,2017,23887956,41
Bureau,Department of the Treasury,Interest on Tax/Deposit of Earnings,null,100.0,100.0,0,0,3240,2,31,03,1,2017,2017-03-31,2,2017,3240,2
Bureau,Department of Commerce,National Technical Information Service,null,0.0,0.0,16263,42,0,0,31,03,1,2017,2017-03-31,2,2017,16263,42
Bureau,Department of Housing and Urban Development,"Policy, Development and Research",null,0.0,0.0,0,0,0,0,31,03,1,2017,2017-03-31,2,2017,0,0
Bureau,Federal Maritime Commission,Salaries and Expenses,null,100.0,100.0,0,0,472598,6,31,03,1,2017,2017-03-31,2,2017,472598,6
Bureau,Department of the Interior,Fish and Wildlife Service,null,100.0,100.0,0,0,538760,96,31,03,1,2017,2017-03-31,2,2017,538760,96
Bureau,Department of Labor,Employment and Training Administration,null,100.0,100.0,0,0,2927114,2,31,03,1,2017,2017-03-31,2,2017,2927114,2
Bureau,Environmental Protection Agency,Environmental Protection Agency,null,100.0,100.0,0,0,9448300,196,31,03,1,2017,2017-03-31,2,2017,9448300,196
Bureau,Department of State,Department of State,null,92.73479513109231,96.36027143738433,1304843,177,16655325,4686,31,03,1,2017,2017-03-31,2,2017,17960168,4863
Bureau,Department of Agriculture,Farm Service Agency,null,100.0,100.0,0,0,678503442,12363,31,03,1,2017,2017-03-31,2,2017,678503442,12363
Bureau,Department of Health & Human Services,Health Resources and Services Admin,null,100.0,100.0,0,0,67746519,461,31,03,1,2017,2017-03-31,2,2017,67746519,461
Agency,Department of Health & Human Services,null,CFO,97.70270713981921,95.19108633465376,245904170,91922,10458180375,1819570,31,03,1,2017,2017-03-31,2,2017,10704084545,1911492
Bureau,Department of the Treasury,Tobacco Tax and Trade,null,100.0,100.0,0,0,1000,1,31,03,1,2017,2017-03-31,2,2017,1000,1
Bureau,Department of the Treasury,D.C. Pension Program,null,100.0,100.0,0,0,160179,16,31,03,1,2017,2017-03-31,2,2017,160179,16
Bureau,Department of the Interior,Office of Surface Mining,null,100.0,100.0,0,0,1885850,209,31,03,1,2017,2017-03-31,2,2017,1885850,209
Bureau,Department of Agriculture,Food and Nutrition Service,null,0.048756716668749756,0.7345225603357818,19304845,946,9417,7,31,03,1,2017,2017-03-31,2,2017,19314262,953
Bureau,Department of Labor,Mine Safety and Health Administration,null,93.96420069462177,91.3326110509209,3868230,1520,60219885,16017,31,03,1,2017,2017-03-31,2,2017,64088115,17537
Agency,Legislative Branch-Office of Tech.,null,Non-CFO,0.0,0.0,0,0,0,0,31,03,1,2017,2017-03-31,2,2017,0,0
Bureau,Department of Homeland Security,Federal Law Enforcement Training Ctr.,null,100.0,100.0,0,0,22847,9,31,03,1,2017,2017-03-31,2,2017,22847,9
Bureau,Department of Justice,Drug Enforcement Administration,null,100.0,100.0,0,0,274833,15,31,03,1,2017,2017-03-31,2,2017,274833,15
Bureau,Department of Transportation,Federal Transit Administration,null,100.0,100.0,0,0,784390,3,31,03,1,2017,2017-03-31,2,2017,784390,3
Bureau,Department of Commerce,Economic Development Administration,null,100.0,100.0,0,0,1307589,1,31,03,1,2017,2017-03-31,2,2017,1307589,1
Bureau,Department of the Treasury,Community Dev Financial Inst Fund,null,100.0,100.0,0,0,2839370,5,31,03,1,2017,2017-03-31,2,2017,2839370,5
Agency,Department of Commerce,null,CFO,99.91992312068112,96.59367396593674,16263,42,20292970,1191,31,03,1,2017,2017-03-31,2,2017,20309233,1233
Agency,Office of Compliance,null,Non-CFO,0.0,0.0,0,0,0,0,31,03,1,2017,2017-03-31,2,2017,0,0
Bureau,Other Agencies,Chemical Safety Board,null,0.0,0.0,0,0,0,0,31,03,1,2017,2017-03-31,2,2017,0,0
Bureau,Department of the Treasury,Office of the Secretary,null,0.0,0.0,0,0,0,0,31,03,1,2017,2017-03-31,2,2017,0,0
Agency,Federal Mediation/Conciliation Service,null,Non-CFO,0.0,0.0,0,0,0,0,31,03,1,2017,2017-03-31,2,2017,0,0
Agency,Office of Government Ethics,null,Non-CFO,0.0,0.0,0,0,0,0,31,03,1,2017,2017-03-31,2,2017,0,0
Bureau,Other Agencies,National Transportation Safety Board,null,0.0,0.0,0,0,0,0,31,03,1,2017,2017-03-31,2,2017,0,0
Bureau,Department of the Interior,National Park Service,null,100.0,100.0,0,0,4869665,1859,31,03,1,2017,2017-03-31,2,2017,4869665,1859
Bureau,Department of Health & Human Services,National Institutes of Health,null,52.438760829614075,30.128205128205128,4529019,218,4993481,94,31,03,1,2017,2017-03-31,2,2017,9522500,312
Bureau,Department of Labor,Bureau of Labor Statistics,null,100.0,100.0,0,0,10969,1,31,03,1,2017,2017-03-31,2,2017,10969,1
Bureau,Department of the Treasury,Treasury Franchise Fund,null,0.0,0.0,0,0,0,0,31,03,1,2017,2017-03-31,2,2017,0,0
Agency,Legislative Branch-GAO,null,Non-CFO,0.0,0.0,0,0,0,0,31,03,1,2017,2017-03-31,2,2017,0,0
Bureau,Farm Credit Administration,Farm Credit System Insurance Corporation,null,0.0,0.0,0,0,0,0,31,03,1,2017,2017-03-31,2,2017,0,0
Bureau,Department of Homeland Security,U.S. Coast Guard,null,100.0,100.0,0,0,57384268,8614,31,03,1,2017,2017-03-31,2,2017,57384268,8614
Bureau,Other Agencies,National Council on Disability,null,0.0,0.0,0,0,0,0,31,03,1,2017,2017-03-31,2,2017,0,0
Bureau,Tennessee Valley Authority,Tennessee Valley Authority,null,0.0,0.0,0,0,0,0,31,03,1,2017,2017-03-31,2,2017,0,0
Bureau,Other Agencies,National Mediation Board,null,0.0,0.0,0,0,0,0,31,03,1,2017,2017-03-31,2,2017,0,0
Agency,Department of Energy,null,CFO,100.0,100.0,0,0,11602877,73,31,03,1,2017,2017-03-31,2,2017,11602877,73
Bureau,Department of State,Passport NSF,null,99.85998378416849,99.87596672989932,3010,17,2146741,13689,31,03,1,2017,2017-03-31,2,2017,2149751,13706
Agency,Environmental Protection Agency,null,CFO,100.0,100.0,0,0,9448300,196,31,03,1,2017,2017-03-31,2,2017,9448300,196
Bureau,Legislative Branch-GAO,Government Accountability Office,null,0.0,0.0,0,0,0,0,31,03,1,2017,2017-03-31,2,2017,0,0
Bureau,Department of Commerce,Office of the Inspector General,null,0.0,0.0,0,0,0,0,31,03,1,2017,2017-03-31,2,2017,0,0
Bureau,Department of Energy,Bonneville Power Administration,null,100.0,100.0,0,0,1118189,30,31,03,1,2017,2017-03-31,2,2017,1118189,30
Bureau,Department of Justice,U.S. Marshals Service,null,0.0,0.0,0,0,0,0,31,03,1,2017,2017-03-31,2,2017,0,0
Bureau,Department of Homeland Security,Transportation Safety Administration,null,100.0,100.0,0,0,9565466,3562,31,03,1,2017,2017-03-31,2,2017,9565466,3562
Bureau,Department of Homeland Security,Domestic Nuclear Detection Office,null,0.0,0.0,0,0,0,0,30,06,2,2017,2017-06-30,3,2017,0,0
Agency,Overseas Private Investment Corp Accts,null,Non-CFO,0.0,0.0,0,0,0,0,30,06,2,2017,2017-06-30,3,2017,0,0
Bureau,Office of Government Ethics,Office of Government Ethics,null,0.0,0.0,0,0,0,0,30,06,2,2017,2017-06-30,3,2017,0,0
Bureau,American Battle Monuments Commission,American Battle Monuments Commission,null,0.0,0.0,0,0,0,0,30,06,2,2017,2017-06-30,3,2017,0,0
Agency,Occupational Safety & Health Rev Comm,null,Non-CFO,0.0,0.0,0,0,0,0,30,06,2,2017,2017-06-30,3,2017,0,0
Bureau,Other Agencies/Boards/Commissions,U.S.-China Security Review Commission,null,0.0,0.0,0,0,0,0,30,06,2,2017,2017-06-30,3,2017,0,0
Bureau,Department of Housing and Urban Development,Community Planning and Development,null,0.0,0.0,0,0,0,0,30,06,2,2017,2017-06-30,3,2017,0,0
Bureau,Department of the Treasury,Office of the Secretary,null,0.0,0.0,0,0,0,0,30,06,2,2017,2017-06-30,3,2017,0,0
Bureau,Funds Appropriated to the President,Inter-American Foundation,null,0.0,0.0,0,0,0,0,30,06,2,2017,2017-06-30,3,2017,0,0
Agency,Office of Government Ethics,null,Non-CFO,0.0,0.0,0,0,0,0,30,06,2,2017,2017-06-30,3,2017,0,0
Bureau,Department of Housing and Urban Development,Public and Indian Housing Programs,null,0.0,0.0,0,0,0,0,30,06,2,2017,2017-06-30,3,2017,0,0
Agency,Commodity Futures Trading Commission,null,Non-CFO,99.2663583500422,99.1044776119403,4039120,3,546518499,332,30,06,2,2017,2017-06-30,3,2017,550557619,335
Bureau,Department of the Treasury,Treasury IG for Tax Admin,null,0.0,0.0,0,0,0,0,30,06,2,2017,2017-06-30,3,2017,0,0
Agency,Consumer Product Safety Commission,null,Non-CFO,100.0,100.0,0,0,433,1,30,06,2,2017,2017-06-30,3,2017,433,1
Bureau,Funds Appropriated to the President,Defense Security Assistance Agency,null,0.0,0.0,0,0,0,0,30,06,2,2017,2017-06-30,3,2017,0,0
Agency,Selective Service System,null,Non-CFO,0.0,0.0,1265,1,0,0,30,06,2,2017,2017-06-30,3,2017,1265,1
Agency,Securities & Exchange Commission,null,Non-CFO,99.99975054441957,99.12472647702407,5283,8,2117806630,906,30,06,2,2017,2017-06-30,3,2017,2117811913,914
Bureau,Department of Homeland Security,Science and Technology,null,0.0,0.0,0,0,0,0,30,06,2,2017,2017-06-30,3,2017,0,0
Agency,Department of Labor,null,CFO,49.223488709646396,20.981636817048287,101660454,34855,98551123,9255,30,06,2,2017,2017-06-30,3,2017,200211577,44110
Agency,Smithsonian Institution,null,Non-CFO,0.0,0.0,1378,7,0,0,30,06,2,2017,2017-06-30,3,2017,1378,7
Bureau,Department of Commerce,Economic and Statistical Analysis,null,0.0,0.0,0,0,0,0,30,06,2,2017,2017-06-30,3,2017,0,0
Bureau,Department of State,Civil Monetary Penalties,null,0.0,0.0,0,0,0,0,30,06,2,2017,2017-06-30,3,2017,0,0
Bureau,National Aeronautics and Space Administration,National Aeronautics and Space Admin,null,98.35140369304321,98.71794871794872,7738,1,461631,77,30,06,2,2017,2017-06-30,3,2017,469369,78
Bureau,Department of Health & Human Services,National Institutes of Health,null,54.6694273614131,30.03095975232198,4219061,226,5088258,97,30,06,2,2017,2017-06-30,3,2017,9307319,323
Bureau,Department of Education,Office of Postsecondary Education,null,0.0,0.0,0,0,0,0,30,06,2,2017,2017-06-30,3,2017,0,0
Bureau,Department of Justice,Federal Prison System,null,99.9998380052616,100.0,1,0,617303,73,30,06,2,2017,2017-06-30,3,2017,617304,73
Agency,Department of Veterans Affairs,null,CFO,89.02133260604433,98.07379867431776,121905858,122269,988482622,6225406,30,06,2,2017,2017-06-30,3,2017,1110388480,6347675
Bureau,Tennessee Valley Authority,Tennessee Valley Authority,null,0.0,0.0,0,0,0,0,30,06,2,2017,2017-06-30,3,2017,0,0
Bureau,Department of the Interior,Office of the Secretary,null,100.0,100.0,0,0,20630,12,30,06,2,2017,2017-06-30,3,2017,20630,12
Bureau,Department of Health & Human Services,Indian Health Services,null,36.46252675420113,5.9734513274336285,32492830,2125,18646802,135,30,06,2,2017,2017-06-30,3,2017,51139632,2260
Bureau,Smithsonian Institution,National Gallery of Art,null,0.0,0.0,0,0,0,0,30,06,2,2017,2017-06-30,3,2017,0,0
Bureau,Merit Systems Protection Board,Merit Systems Protection Board,null,0.0,0.0,0,0,0,0,30,06,2,2017,2017-06-30,3,2017,0,0
Bureau,Department of the Interior,Bureau of Indian Affairs,null,97.80437895839103,85.06383322559793,209844,3697,9347543,21055,30,06,2,2017,2017-06-30,3,2017,9557387,24752
Agency,National Credit Union Administration,null,Non-CFO,100.0,100.0,0,0,4821,2,30,06,2,2017,2017-06-30,3,2017,4821,2
Bureau,Funds Appropriated to the President,Peace Corps,null,0.0,0.0,0,0,0,0,30,06,2,2017,2017-06-30,3,2017,0,0
Bureau,Department of Homeland Security,Transportation Safety Administration,null,100.0,100.0,0,0,10574214,3662,30,06,2,2017,2017-06-30,3,2017,10574214,3662
Agency,National Archives & Records Admin,null,Non-CFO,98.37568899078094,96.51162790697674,666,3,40336,83,30,06,2,2017,2017-06-30,3,2017,41002,86
Bureau,Legislative Branch-Office of Tech.,Open World Leadership,null,0.0,0.0,0,0,0,0,30,06,2,2017,2017-06-30,3,2017,0,0
Bureau,Department of the Treasury,International Monetary Funds,null,0.0,0.0,0,0,0,0,30,06,2,2017,2017-06-30,3,2017,0,0
Bureau,Other Agencies,Federal Mine Safety & Health Review Comm,null,0.0,0.0,0,0,0,0,30,06,2,2017,2017-06-30,3,2017,0,0
Bureau,Department of the Treasury,U.S. Treasury IG Office,null,0.0,0.0,0,0,0,0,30,06,2,2017,2017-06-30,3,2017,0,0
Bureau,Department of Labor,Employment Standards Administration,null,58.75710416710509,30.043349877489476,28907156,11135,41182869,4782,30,06,2,2017,2017-06-30,3,2017,70090025,15917
Bureau,Department of Justice,U.S. Marshals Service,null,0.0,0.0,0,0,0,0,30,06,2,2017,2017-06-30,3,2017,0,0
Bureau,National Archives & Records Admin,Nat'l Archives & Records Administration,null,98.37568899078094,96.51162790697674,666,3,40336,83,30,06,2,2017,2017-06-30,3,2017,41002,86
Bureau,Equal Employment Opportunity Commission,Equal Employment Opportunity Commission,null,2.263017405028766,3.5580524344569286,671888,515,15557,19,30,06,2,2017,2017-06-30,3,2017,687445,534
Bureau,Other Agencies,Denali Commission,null,0.0,0.0,0,0,0,0,30,06,2,2017,2017-06-30,3,2017,0,0
Agency,Armed Forces Retirement Home,null,Non-CFO,99.68563435526202,98.87640449438203,218,1,69128,88,30,06,2,2017,2017-06-30,3,2017,69346,89
Bureau,Department of Health & Human Services,Office of the Secretary,null,100.0,100.0,0,0,30,1,30,06,2,2017,2017-06-30,3,2017,30,1
Bureau,Department of Housing and Urban Development,Housing Programs,null,99.74906899177284,99.92637585127922,316427,4,125784768,5429,30,06,2,2017,2017-06-30,3,2017,126101195,5433
Bureau,National Science Foundation,National Science Foundation,null,100.0,100.0,0,0,784861,10,30,06,2,2017,2017-06-30,3,2017,784861,10
Bureau,Department of Labor,Employee Benefit Security Administration,null,100.0,100.0,0,0,16810272,353,30,06,2,2017,2017-06-30,3,2017,16810272,353
Bureau,Department of State,Department of State,null,97.17827238397678,98.9854153455929,497931,48,17148386,4683,30,06,2,2017,2017-06-30,3,2017,17646317,4731
Agency,Legislative Branch-GPO,null,Non-CFO,0.0,0.0,122638,115,0,0,30,06,2,2017,2017-06-30,3,2017,122638,115
Agency,Other Agencies/Boards/Commissions,null,Non-CFO,0.0,0.0,181226,3,0,0,30,06,2,2017,2017-06-30,3,2017,181226,3
Agency,Federal Election Commission,null,Non-CFO,60.42736683172751,22.0,154636,39,236129,11,30,06,2,2017,2017-06-30,3,2017,390765,50
Bureau,General Services Administration,General Services Administration,null,82.19796539113311,12.697234082049379,3165399,4703,14615709,684,30,06,2,2017,2017-06-30,3,2017,17781108,5387
Agency,Federal Maritime Commission,null,Non-CFO,0.0,0.0,472549,5,0,0,30,06,2,2017,2017-06-30,3,2017,472549,5
Bureau,Department of Homeland Security,U.S. Secret Service,null,0.0,0.0,0,0,0,0,30,06,2,2017,2017-06-30,3,2017,0,0
Bureau,Federal Trade Commission,Federal Trade Commission,null,100.0,100.0,0,0,483141105,56,30,06,2,2017,2017-06-30,3,2017,483141105,56
Agency,Department of Defense,null,CFO,52.47723372987104,23.3139181813668,1142509018,1003909,1261620850,305206,30,06,2,2017,2017-06-30,3,2017,2404129868,1309115
Bureau,Legislative Branch-GAO,Government Accountability Office,null,0.0,0.0,0,0,0,0,30,06,2,2017,2017-06-30,3,2017,0,0
Bureau,Department of the Interior,"Bureau of Ocean Energy Mgmt., Reg & Enf",null,0.0,0.0,0,0,0,0,30,06,2,2017,2017-06-30,3,2017,0,0
Bureau,National Foundation  Arts & Humanities,National Endowment for the Humanities,null,0.0,0.0,0,0,0,0,30,06,2,2017,2017-06-30,3,2017,0,0
Bureau,Department of the Treasury,Departmental Offices,null,99.92870103509051,98.54227405247813,12749,10,17868296,676,30,06,2,2017,2017-06-30,3,2017,17881045,686
Agency,Federal Mediation/Conciliation Service,null,Non-CFO,0.0,0.0,0,0,0,0,30,06,2,2017,2017-06-30,3,2017,0,0
Bureau,Other Agencies,Federal Housing Finance Agency OIG,null,0.0,0.0,0,0,0,0,30,06,2,2017,2017-06-30,3,2017,0,0
Bureau,Department of the Treasury,Bureau of Public Debt,null,0.0,0.0,0,0,0,0,30,06,2,2017,2017-06-30,3,2017,0,0
Bureau,Department of Veterans Affairs,Medical and Construction,null,82.64387067112985,98.09867818835211,93253353,118582,444040137,6118237,30,06,2,2017,2017-06-30,3,2017,537293490,6236819
Bureau,Department of Transportation,St. Lawrence Seaway Development Corp.,null,0.0,0.0,0,0,0,0,30,06,2,2017,2017-06-30,3,2017,0,0
Bureau,Neighborhood Reinvestment Corporation,Neighborhood Reinvestment Corporation,null,0.0,0.0,0,0,0,0,30,06,2,2017,2017-06-30,3,2017,0,0
Bureau,Funds Appropriated to the President,African Development Foundation,null,0.0,0.0,0,0,0,0,30,06,2,2017,2017-06-30,3,2017,0,0
Agency,Equal Employment Opportunity Commission,null,Non-CFO,2.263017405028766,3.5580524344569286,671888,515,15557,19,30,06,2,2017,2017-06-30,3,2017,687445,534
Bureau,Commodity Futures Trading Commission,Commodity Futures Trading Commission,null,99.2663583500422,99.1044776119403,4039120,3,546518499,332,30,06,2,2017,2017-06-30,3,2017,550557619,335
Agency,Other Agencies,null,Non-CFO,10.25936238605774,1.9704433497536946,659416,199,75386,4,30,06,2,2017,2017-06-30,3,2017,734802,203
Bureau,Other Agencies,Federal Housing Finance Agency,null,0.0,0.0,0,0,0,0,30,06,2,2017,2017-06-30,3,2017,0,0
Bureau,Department of Justice,General Administration,null,0.0,0.0,0,0,0,0,30,06,2,2017,2017-06-30,3,2017,0,0
Bureau,Department of Homeland Security,Office of Health Affairs,null,0.0,0.0,0,0,0,0,30,06,2,2017,2017-06-30,3,2017,0,0
Bureau,Armed Forces Retirement Home,Armed Forces Retirement Home,null,99.68563435526202,98.87640449438203,218,1,69128,88,30,06,2,2017,2017-06-30,3,2017,69346,89
Agency,Department of Health & Human Services,null,CFO,97.51995589784349,97.20929028675366,259531786,47440,10205273488,1652486,30,06,2,2017,2017-06-30,3,2017,10464805274,1699926
Bureau,Department of Commerce,Nat'l Telecomm & Information Admin.,null,0.0,0.0,0,0,0,0,30,06,2,2017,2017-06-30,3,2017,0,0
Bureau,Other Agencies,Archit.&Trans. Barriers Compliance Bd,null,0.0,0.0,0,0,0,0,30,06,2,2017,2017-06-30,3,2017,0,0
Bureau,Other Agencies,Defense Nuclear Facilities Safety Board,null,0.0,0.0,0,0,0,0,30,06,2,2017,2017-06-30,3,2017,0,0
Bureau,Other Agencies,U.S.  Agency of Global Media,null,94.55373570243043,33.333333333333336,4233,4,73490,2,30,06,2,2017,2017-06-30,3,2017,77723,6
Bureau,Department of Education,Departmental Management,null,98.21421588426965,93.29430548163917,11289243,126,620883644,1753,30,06,2,2017,2017-06-30,3,2017,632172887,1879
Bureau,Department of Agriculture,Agricultural Marketing Service,null,43.95916890710623,53.275862068965516,610325,271,478747,309,30,06,2,2017,2017-06-30,3,2017,1089072,580
Bureau,Consumer Product Safety Commission,Consumer Product Safety Commission,null,100.0,100.0,0,0,433,1,30,06,2,2017,2017-06-30,3,2017,433,1
Bureau,Securities & Exchange Commission,Securities and Exchange Commission,null,99.99975054441957,99.12472647702407,5283,8,2117806630,906,30,06,2,2017,2017-06-30,3,2017,2117811913,914
Bureau,Department of the Interior,Geological Survey,null,100.0,100.0,0,0,85938,75,30,06,2,2017,2017-06-30,3,2017,85938,75
Bureau,Other Agencies,Morris K. Udall Scholarship,null,100.0,100.0,0,0,982,1,30,06,2,2017,2017-06-30,3,2017,982,1
Bureau,Department of the Interior,Bureau of Reclamation,null,100.0,100.0,0,0,88598,75,30,06,2,2017,2017-06-30,3,2017,88598,75
Bureau,Social Security Administration,Social Security Administration,null,25.585060870703078,11.008521755247743,4434609885,2275812,1524690676,281525,30,06,2,2017,2017-06-30,3,2017,5959300561,2557337
Agency,Department of Education,null,CFO,51.77835689838561,47.219170652778544,65036969386,12899669,69833941688,11540396,30,06,2,2017,2017-06-30,3,2017,134870911074,24440065
Bureau,Department of the Treasury,Tobacco Tax and Trade,null,100.0,100.0,0,0,1000,1,30,06,2,2017,2017-06-30,3,2017,1000,1
Bureau,Legislative Branch-GPO,Government Publishing Office,null,0.0,0.0,122638,115,0,0,30,06,2,2017,2017-06-30,3,2017,122638,115
Agency,National Aeronautics and Space Administration,null,CFO,98.35140369304321,98.71794871794872,7738,1,461631,77,30,06,2,2017,2017-06-30,3,2017,469369,78
Agency,Department of Commerce,null,CFO,100.0,100.0,0,0,7111346,1437,30,06,2,2017,2017-06-30,3,2017,7111346,1437
Bureau,Department of Transportation,Office of the Inspector General,null,100.0,100.0,0,0,1327,1,30,06,2,2017,2017-06-30,3,2017,1327,1
Bureau,Other Agencies,U.S. Inst. for Env. Conflict Resolution,null,62.64564770390678,33.333333333333336,545,2,914,1,30,06,2,2017,2017-06-30,3,2017,1459,3
Bureau,Department of Veterans Affairs,Housing Credit Assistance,null,14.385487729145252,14.84480431848853,19568356,1262,3287998,220,30,06,2,2017,2017-06-30,3,2017,22856354,1482
Agency,Environmental Protection Agency,null,CFO,100.0,100.0,0,0,9426375,199,30,06,2,2017,2017-06-30,3,2017,9426375,199
Agency,Pension Benefit Guaranty Corp,null,Non-CFO,29.774814900300417,40.990990990990994,1947225,393,825605,273,30,06,2,2017,2017-06-30,3,2017,2772830,666
Agency,Corp. for National and Community Service,null,Non-CFO,99.70552568378334,93.05555555555556,9060,15,3067609,201,30,06,2,2017,2017-06-30,3,2017,3076669,216
Bureau,Department of the Treasury,Office of Sec International Affairs,null,0.0,0.0,0,0,0,0,30,06,2,2017,2017-06-30,3,2017,0,0
Agency,Federal Deposit Insurance Corporation,null,Non-CFO,0.0,0.0,0,0,0,0,30,06,2,2017,2017-06-30,3,2017,0,0
Agency,Legis Branch-Library of Congress,null,Non-CFO,0.0,0.0,0,0,0,0,30,06,2,2017,2017-06-30,3,2017,0,0
Bureau,Department of Education,Federal Student Aid,null,51.5596756784047,47.21562803393018,65025680143,12899543,69213058044,11538643,30,06,2,2017,2017-06-30,3,2017,134238738187,24438186
Agency,Department of Energy,null,CFO,100.0,100.0,0,0,15816543,75,30,06,2,2017,2017-06-30,3,2017,15816543,75
Agency,Railroad Retirement Board,null,Non-CFO,91.2056924000378,90.183908045977,1604011,427,16635185,3923,30,06,2,2017,2017-06-30,3,2017,18239196,4350
Bureau,Other Agencies,Advisory Council on Hist. Preservation,null,0.0,0.0,0,0,0,0,30,06,2,2017,2017-06-30,3,2017,0,0
Bureau,Federal Labor Relations Authority,Federal Labor Relations Authority,null,0.0,0.0,0,0,0,0,30,06,2,2017,2017-06-30,3,2017,0,0
Agency,U.S. Postal Service,null,Non-CFO,65.74921097742674,82.5028817503643,21379000,8045,41040000,37934,30,06,2,2017,2017-06-30,3,2017,62419000,45979
Bureau,Other Agencies,James Madison Memorial Fellowship,null,0.0,0.0,212774,23,0,0,30,06,2,2017,2017-06-30,3,2017,212774,23
Bureau,Department of the Interior,National Park Service,null,100.0,100.0,0,0,5093831,1784,30,06,2,2017,2017-06-30,3,2017,5093831,1784
Agency,Department of State,null,CFO,97.52883863388865,99.7593202023675,498071,49,19657270,20310,30,06,2,2017,2017-06-30,3,2017,20155341,20359
Bureau,Department of Health & Human Services,Centers for Medicare & Medicaid Services,null,98.10255984585307,97.45902714507032,194715037,43005,10067270648,1649457,30,06,2,2017,2017-06-30,3,2017,10261985685,1692462
Bureau,Small Business Administration,Small Business Administration,null,99.6301412600804,99.72682651721433,41042487,310,11055758148,113171,30,06,2,2017,2017-06-30,3,2017,11096800635,113481
Agency,Funds Appropriated to the President,null,Non-CFO,0.0,0.0,0,0,0,0,30,06,2,2017,2017-06-30,3,2017,0,0
Agency,Department of the Treasury,null,CFO,99.10358843850102,99.39252336448598,284437,26,31446189,4254,30,06,2,2017,2017-06-30,3,2017,31730626,4280
Agency,American Battle Monuments Commission,null,Non-CFO,0.0,0.0,0,0,0,0,30,06,2,2017,2017-06-30,3,2017,0,0
Bureau,Pension Benefit Guaranty Corp,Pension Benefit Guaranty Corporation,null,29.774814900300417,40.990990990990994,1947225,393,825605,273,30,06,2,2017,2017-06-30,3,2017,2772830,666
Agency,National Foundation  Arts & Humanities,null,Non-CFO,0.0,0.0,0,0,0,0,30,06,2,2017,2017-06-30,3,2017,0,0
Bureau,Funds Appropriated to the President,Trade and Development Agency,null,0.0,0.0,0,0,0,0,30,06,2,2017,2017-06-30,3,2017,0,0
Bureau,Corp. for National and Community Service,Corp. for National and Community Service,null,99.70552568378334,93.05555555555556,9060,15,3067609,201,30,06,2,2017,2017-06-30,3,2017,3076669,216
Agency,Farm Credit Administration,null,Non-CFO,0.0,0.0,0,0,0,0,30,06,2,2017,2017-06-30,3,2017,0,0
Agency,Office of Compliance,null,Non-CFO,0.0,0.0,0,0,0,0,30,06,2,2017,2017-06-30,3,2017,0,0
Bureau,Department of Transportation,Federal Aviation Administration,null,94.24170864260638,94.70588235294117,259546,36,4247798,644,30,06,2,2017,2017-06-30,3,2017,4507344,680
Bureau,Department of the Treasury,Office of Financial Research,null,100.0,100.0,0,0,36,1,30,06,2,2017,2017-06-30,3,2017,36,1
Bureau,Department of Labor,Mine Safety and Health Administration,null,0.08519523680602475,0.10763159243503664,71263645,19490,60765,21,30,06,2,2017,2017-06-30,3,2017,71324410,19511
Bureau,Department of the Treasury,Internal Revenue Service,null,98.89771528128065,97.27272727272727,3562,3,319585,107,30,06,2,2017,2017-06-30,3,2017,323147,110
Agency,Department of the Interior,null,CFO,99.45198702364272,86.54511045601777,209844,3697,38081950,23780,30,06,2,2017,2017-06-30,3,2017,38291794,27477
Agency,Department of Justice,null,CFO,99.17521513355186,99.36311727426742,605807,203,72844498,31671,30,06,2,2017,2017-06-30,3,2017,73450305,31874
Agency,Legislative Branch-Office of Tech.,null,Non-CFO,0.0,0.0,0,0,0,0,30,06,2,2017,2017-06-30,3,2017,0,0
Bureau,Department of Agriculture,U.S. Department of Agriculture,null,65.33983300867388,47.93414103758931,8977325,1676,16923661,1543,30,06,2,2017,2017-06-30,3,2017,25900986,3219
Bureau,Department of the Treasury,Spec Insp Gen-Troubled Asset Rel Prog,null,100.0,100.0,0,0,3916,1,30,06,2,2017,2017-06-30,3,2017,3916,1
Agency,U.S. Court of Appeals / Veterans Claims,null,Non-CFO,0.0,0.0,40,1,0,0,30,06,2,2017,2017-06-30,3,2017,40,1
Bureau,Department of Justice,Federal Bureau of Investigation,null,56.398376583701875,24.82758620689655,167701,109,216920,36,30,06,2,2017,2017-06-30,3,2017,384621,145
Agency,Federal Communications Commission,null,Non-CFO,100.0,100.0,0,0,191381502,10950,30,06,2,2017,2017-06-30,3,2017,191381502,10950
Agency,Department of Transportation,null,CFO,67.63575864501456,80.24437122460186,25685952,1439,53679270,5845,30,06,2,2017,2017-06-30,3,2017,79365222,7284
Bureau,Other Agencies,National Council on Disability,null,0.0,0.0,0,0,0,0,30,06,2,2017,2017-06-30,3,2017,0,0
Bureau,Federal Election Commission,Federal Election Commission,null,60.42736683172751,22.0,154636,39,236129,11,30,06,2,2017,2017-06-30,3,2017,390765,50
Bureau,Department of Veterans Affairs,Administration and Cemeteries,null,0.2800005272404809,3.4255599472990776,7792391,733,21880,26,30,06,2,2017,2017-06-30,3,2017,7814271,759
Agency,Federal Trade Commission,null,Non-CFO,100.0,100.0,0,0,483141105,56,30,06,2,2017,2017-06-30,3,2017,483141105,56
Bureau,Department of Homeland Security,Info Analysis Infrastructure Prot-NPPD,null,100.0,100.0,0,0,4610,1,30,06,2,2017,2017-06-30,3,2017,4610,1
Bureau,National Credit Union Administration,National Credit Union Administration,null,100.0,100.0,0,0,4821,2,30,06,2,2017,2017-06-30,3,2017,4821,2
Bureau,Department of Transportation,Research Innovative Technology Admin,null,100.0,100.0,0,0,5996,3,30,06,2,2017,2017-06-30,3,2017,5996,3
Bureau,Department of Health & Human Services,Centers for Disease Control,null,6.521733880413546,15.384615384615385,387072,44,27005,8,30,06,2,2017,2017-06-30,3,2017,414077,52
Bureau,Office of Personnel Management,Office of Personnel Management,null,50.043410201605965,57.364756293519015,17243632,796,17273600,1071,30,06,2,2017,2017-06-30,3,2017,34517232,1867
Bureau,Department of Labor,Occupational Safety and Health Admin,null,96.18514900821756,49.19529185683401,1489653,4230,37559133,4096,30,06,2,2017,2017-06-30,3,2017,39048786,8326
Bureau,Department of Health & Human Services,Food and Drug Administration,null,38.97848965246134,24.806487283450057,27717786,2040,17705190,673,30,06,2,2017,2017-06-30,3,2017,45422976,2713
Bureau,Other Agencies/Boards/Commissions,Medicare Payment Advisory Commission,null,0.0,0.0,0,0,0,0,30,06,2,2017,2017-06-30,3,2017,0,0
Bureau,Department of Health & Human Services,Substance Abuse & Mental Health Admin.,null,100.0,100.0,0,0,603506,10,30,06,2,2017,2017-06-30,3,2017,603506,10
Bureau,Occupational Safety & Health Rev Comm,Occupational Safety & Health Rev Comm,null,0.0,0.0,0,0,0,0,30,06,2,2017,2017-06-30,3,2017,0,0
Bureau,U.S. Postal Service,U.S. Postal Service,null,65.74921097742674,82.5028817503643,21379000,8045,41040000,37934,30,06,2,2017,2017-06-30,3,2017,62419000,45979
Bureau,Department of Homeland Security,Federal Law Enforcement Training Ctr.,null,100.0,100.0,0,0,23376,8,30,06,2,2017,2017-06-30,3,2017,23376,8
Bureau,Department of Veterans Affairs,Veterans Benefits,null,99.76163946407775,98.4410846070925,1291758,1692,540642751,106845,30,06,2,2017,2017-06-30,3,2017,541934509,108537
Bureau,Department of Homeland Security,Office of the Inspector General DHS,null,100.0,100.0,0,0,1734,3,30,06,2,2017,2017-06-30,3,2017,1734,3
Bureau,Other Agencies/Boards/Commissions,U.S. Comm. on Int. Religious Freedom,null,0.0,0.0,181226,3,0,0,30,06,2,2017,2017-06-30,3,2017,181226,3
Bureau,Other Agencies,Surface Transportation Board,null,0.0,0.0,0,0,0,0,30,06,2,2017,2017-06-30,3,2017,0,0
Bureau,The Judiciary,Administrative Office of the U.S. Courts,null,99.53720226656272,98.64864864864865,6743,3,1450265,219,30,06,2,2017,2017-06-30,3,2017,1457008,222
Bureau,Presidio Trust Corporation,Presidio Trust Corporation,null,97.55055731827767,93.50649350649351,32686,5,1301740,72,30,06,2,2017,2017-06-30,3,2017,1334426,77
Bureau,Department of Transportation,Surface Transportation Board,null,0.0,0.0,13770,0,0,0,30,06,2,2017,2017-06-30,3,2017,13770,0
Bureau,Department of Commerce,Bureau of the Census,null,100.0,100.0,0,0,190968,264,30,06,2,2017,2017-06-30,3,2017,190968,264
Bureau,Department of the Treasury,Comptroller of the Currency,null,85.01957709488205,67.74193548387096,180358,10,1023600,21,30,06,2,2017,2017-06-30,3,2017,1203958,31
Agency,Department of Housing and Urban Development,null,CFO,99.66878066136992,99.7794523065613,418008,12,125784768,5429,30,06,2,2017,2017-06-30,3,2017,126202776,5441
Agency,Federal Labor Relations Authority,null,Non-CFO,0.0,0.0,0,0,0,0,30,06,2,2017,2017-06-30,3,2017,0,0
Bureau,Nuclear Regulatory Commission,Nuclear Regulatory Commission,null,100.0,100.0,0,0,846325,174,30,06,2,2017,2017-06-30,3,2017,846325,174
Agency,National Labor Relations Board,null,Non-CFO,0.0,0.0,0,0,0,0,30,06,2,2017,2017-06-30,3,2017,0,0
Agency,Legislative Branch-CBO,null,Non-CFO,0.0,0.0,0,0,0,0,30,06,2,2017,2017-06-30,3,2017,0,0
Bureau,Department of Commerce,International Trade Administration,null,0.0,0.0,0,0,0,0,30,06,2,2017,2017-06-30,3,2017,0,0
Bureau,Department of Commerce,General Administration,null,100.0,100.0,0,0,4660,1,30,06,2,2017,2017-06-30,3,2017,4660,1
Bureau,Department of State,Passport NSF,null,99.99442014105884,99.99360122856412,140,1,2508884,15627,30,06,2,2017,2017-06-30,3,2017,2509024,15628
Agency,Office of Personnel Management,null,CFO,50.043410201605965,57.364756293519015,17243632,796,17273600,1071,30,06,2,2017,2017-06-30,3,2017,34517232,1867
Agency,Presidio Trust Corporation,null,Non-CFO,97.55055731827767,93.50649350649351,32686,5,1301740,72,30,06,2,2017,2017-06-30,3,2017,1334426,77
Bureau,Funds Appropriated to the President,Executive Branch,null,0.0,0.0,0,0,0,0,30,06,2,2017,2017-06-30,3,2017,0,0
Bureau,Department of Agriculture,Rural Development,null,99.99958216559985,99.99005403971753,2420,3,579174402,30160,30,06,2,2017,2017-06-30,3,2017,579176822,30163
Bureau,Department of Homeland Security,Emergency Preparedness & Resp,null,100.0,100.0,0,0,272125881,44010,30,06,2,2017,2017-06-30,3,2017,272125881,44010
Agency,The Judiciary,null,Non-CFO,99.53720226656272,98.64864864864865,6743,3,1450265,219,30,06,2,2017,2017-06-30,3,2017,1457008,222
Bureau,Other Agencies,Consumer Financial Protection Bureau,null,0.0,0.0,303366,58,0,0,30,06,2,2017,2017-06-30,3,2017,303366,58
Bureau,Department of Energy,Bonneville Power Administration,null,100.0,100.0,0,0,1118189,30,30,06,2,2017,2017-06-30,3,2017,1118189,30
Bureau,Department of Justice,Drug Enforcement Administration,null,100.0,100.0,0,0,283300,18,30,06,2,2017,2017-06-30,3,2017,283300,18
Agency,Tennessee Valley Authority,null,Non-CFO,0.0,0.0,0,0,0,0,30,06,2,2017,2017-06-30,3,2017,0,0
Bureau,Department of Transportation,Federal Motor Carrier Safety Admin,null,60.41725758147397,78.4551597051597,25412636,1403,38788666,5109,30,06,2,2017,2017-06-30,3,2017,64201302,6512
Agency,Department of Homeland Security,null,CFO,100.0,100.0,0,0,355899356,58408,30,06,2,2017,2017-06-30,3,2017,355899356,58408
Bureau,National Credit Union Administration,Nat'l Credit Union Admin. Treasury Acct.,null,0.0,0.0,0,0,0,0,30,06,2,2017,2017-06-30,3,2017,0,0
Bureau,Overseas Private Investment Corp Accts,Overseas Private Investment Corp Accts,null,0.0,0.0,0,0,0,0,30,06,2,2017,2017-06-30,3,2017,0,0
Bureau,Export - Import  Bank,Export-Import Bank,null,0.0,0.0,0,0,0,0,30,06,2,2017,2017-06-30,3,2017,0,0
Bureau,Department of the Interior,Fish and Wildlife Service,null,100.0,100.0,0,0,541427,95,30,06,2,2017,2017-06-30,3,2017,541427,95
Bureau,Department of Transportation,Federal Transit Administration,null,100.0,100.0,0,0,784415,3,30,06,2,2017,2017-06-30,3,2017,784415,3
Bureau,Department of the Treasury,Bureau of the Fiscal Service,null,100.0,100.0,0,0,9191228,3418,30,06,2,2017,2017-06-30,3,2017,9191228,3418
Bureau,Federal Communications Commission,Federal Communications Commission,null,100.0,100.0,0,0,191381502,10950,30,06,2,2017,2017-06-30,3,2017,191381502,10950
Agency,Legislative Branch - U.S. House/Senate,null,Non-CFO,0.0,0.0,212296,190,0,0,30,06,2,2017,2017-06-30,3,2017,212296,190
Bureau,Other Agencies,Delta Regional Authority,null,0.0,0.0,0,0,0,0,30,06,2,2017,2017-06-30,3,2017,0,0
Bureau,Department of the Treasury,Financial Crimes Enforcement Network,null,100.0,100.0,0,0,67326,3,30,06,2,2017,2017-06-30,3,2017,67326,3
Agency,Department of Agriculture,null,CFO,97.6193550956255,83.68449645410898,35538740,11112,1457281123,56995,30,06,2,2017,2017-06-30,3,2017,1492819863,68107
Agency,Legislative Branch-GAO,null,Non-CFO,0.0,0.0,0,0,0,0,30,06,2,2017,2017-06-30,3,2017,0,0
Bureau,Department of Agriculture,Forest Service,null,91.04871525990814,5.129099790648988,4789192,8157,48713653,441,30,06,2,2017,2017-06-30,3,2017,53502845,8598
Bureau,Department of Energy,Energy Consolidated Reports,null,100.0,100.0,0,0,14698354,45,30,06,2,2017,2017-06-30,3,2017,14698354,45
Bureau,Department of Labor,Employment and Training Administration,null,100.0,100.0,0,0,2927114,2,30,06,2,2017,2017-06-30,3,2017,2927114,2
Bureau,Department of Health & Human Services,Program Support Center,null,100.0,100.0,0,0,3540799,507,30,06,2,2017,2017-06-30,3,2017,3540799,507
Bureau,Department of Health & Human Services,Office of the Inspector General,null,0.0,0.0,0,0,0,0,30,06,2,2017,2017-06-30,3,2017,0,0
Bureau,Department of Housing and Urban Development,Government National Mortgage Association,null,0.0,0.0,0,0,0,0,30,06,2,2017,2017-06-30,3,2017,0,0
Bureau,Department of Agriculture,Commodity Credit Corporation,null,100.0,100.0,0,0,130250796,10070,30,06,2,2017,2017-06-30,3,2017,130250796,10070
Bureau,Department of Commerce,Minority Business Development Agency,null,0.0,0.0,0,0,0,0,30,06,2,2017,2017-06-30,3,2017,0,0
Bureau,Department of Housing and Urban Development,Management and Administration,null,0.0,0.0,101581,8,0,0,30,06,2,2017,2017-06-30,3,2017,101581,8
Agency,Agency for International Development,null,CFO,100.0,100.0,0,0,23941063,37,30,06,2,2017,2017-06-30,3,2017,23941063,37
Agency,Merit Systems Protection Board,null,Non-CFO,0.0,0.0,0,0,0,0,30,06,2,2017,2017-06-30,3,2017,0,0
Bureau,Other Agencies,Council of Insps. Gen. of Intg. & Effy.,null,0.0,0.0,0,0,0,0,30,06,2,2017,2017-06-30,3,2017,0,0
Bureau,Department of the Treasury,Treasury Forfeiture Fund,null,0.0,0.0,0,0,0,0,30,06,2,2017,2017-06-30,3,2017,0,0
Bureau,Department of Justice,Federal Prison Industries,null,72.77973329366954,76.25,387974,57,1037339,183,30,06,2,2017,2017-06-30,3,2017,1425313,240
Bureau,Office of Special Counsel,Office of Special Counsel,null,0.0,0.0,0,0,0,0,30,06,2,2017,2017-06-30,3,2017,0,0
Bureau,Smithsonian Institution,Administrative Conference of the US,null,0.0,0.0,0,0,0,0,30,06,2,2017,2017-06-30,3,2017,0,0
Bureau,Department of Transportation,Federal Railroad Administration,null,100.0,100.0,0,0,251099,18,30,06,2,2017,2017-06-30,3,2017,251099,18
Agency,Nuclear Regulatory Commission,null,CFO,100.0,100.0,0,0,846325,174,30,06,2,2017,2017-06-30,3,2017,846325,174
Agency,Social Security Administration,null,CFO,25.585060870703078,11.008521755247743,4434609885,2275812,1524690676,281525,30,06,2,2017,2017-06-30,3,2017,5959300561,2557337
Bureau,Legislative Branch-Office of Tech.,Medicaid & CHIP Payment & Access Comm.,null,0.0,0.0,0,0,0,0,30,06,2,2017,2017-06-30,3,2017,0,0
Bureau,Department of the Treasury,Interest on Tax/Deposit of Earnings,null,0.0,0.0,3240,2,0,0,30,06,2,2017,2017-06-30,3,2017,3240,2
Bureau,Department of Health & Human Services,Administration for Community Living,null,0.0,0.0,0,0,0,0,30,06,2,2017,2017-06-30,3,2017,0,0
Bureau,Department of Homeland Security,Management Headquarters,null,0.0,0.0,0,0,0,0,30,06,2,2017,2017-06-30,3,2017,0,0
Bureau,Department of the Treasury,U.S. Mint,null,100.0,100.0,0,0,33876,7,30,06,2,2017,2017-06-30,3,2017,33876,7
Bureau,Department of the Treasury,Treasury Franchise Fund,null,0.0,0.0,0,0,0,0,30,06,2,2017,2017-06-30,3,2017,0,0
Bureau,Department of Homeland Security,Office of Biometric Identity Management,null,0.0,0.0,0,0,0,0,30,06,2,2017,2017-06-30,3,2017,0,0
Bureau,Department of Agriculture,Federal Crop Insurance Corporation,null,100.0,100.0,0,0,146252,348,30,06,2,2017,2017-06-30,3,2017,146252,348
Bureau,Agency for International Development,Agency for International Development,null,100.0,100.0,0,0,23941063,37,30,06,2,2017,2017-06-30,3,2017,23941063,37
Bureau,Federal Deposit Insurance Corporation,Federal Deposit Insurance Corporation,null,0.0,0.0,0,0,0,0,30,06,2,2017,2017-06-30,3,2017,0,0
Bureau,National Labor Relations Board,National Labor Relations Board,null,0.0,0.0,0,0,0,0,30,06,2,2017,2017-06-30,3,2017,0,0
Bureau,Federal Mediation/Conciliation Service,Federal Mediation/Conciliation Service,null,0.0,0.0,0,0,0,0,30,06,2,2017,2017-06-30,3,2017,0,0
Bureau,Department of Health & Human Services,Health Resources and Services Admin,null,100.0,100.0,0,0,72295563,483,30,06,2,2017,2017-06-30,3,2017,72295563,483
Bureau,Department of Defense,Consolidated Report,null,52.47723372987104,23.3139181813668,1142509018,1003909,1261620850,305206,30,06,2,2017,2017-06-30,3,2017,2404129868,1309115
Bureau,Department of Labor,Bureau of Labor Statistics,null,100.0,100.0,0,0,10970,1,30,06,2,2017,2017-06-30,3,2017,10970,1
Bureau,Department of the Treasury,Bureau of Engraving and Printing,null,0.0,0.0,84528,1,0,0,30,06,2,2017,2017-06-30,3,2017,84528,1
Bureau,Legislative Branch - U.S. House/Senate,U.S. House of Representatives,null,0.0,0.0,212296,190,0,0,30,06,2,2017,2017-06-30,3,2017,212296,190
Bureau,Department of Health & Human Services,Administration for Children and Families,null,100.0,100.0,0,0,20095687,1115,30,06,2,2017,2017-06-30,3,2017,20095687,1115
Bureau,Other Agencies,Architect of the Capitol,null,0.0,0.0,0,0,0,0,30,06,2,2017,2017-06-30,3,2017,0,0
Bureau,Department of Justice,Office of Justice Assistance Programs,null,100.0,100.0,0,0,285222,16,30,06,2,2017,2017-06-30,3,2017,285222,16
Bureau,Department of Transportation,Office of the Secretary,null,100.0,100.0,0,0,1559116,22,30,06,2,2017,2017-06-30,3,2017,1559116,22
Bureau,Department of Transportation,National Highway Traffic Safety Admin.,null,100.0,100.0,0,0,7638813,4,30,06,2,2017,2017-06-30,3,2017,7638813,4
Bureau,Department of Commerce,Bureau of Industry and Security,null,0.0,0.0,0,0,0,0,30,06,2,2017,2017-06-30,3,2017,0,0
Bureau,Department of Veterans Affairs,Life Insurance,null,100.0,100.0,0,0,489856,78,30,06,2,2017,2017-06-30,3,2017,489856,78
Bureau,Department of Commerce,Nat'l Institute of Standards& Technology,null,100.0,100.0,0,0,669970,6,30,06,2,2017,2017-06-30,3,2017,669970,6
Bureau,Department of Agriculture,Food Safety and Inspection Service,null,100.0,100.0,0,0,945997,1548,30,06,2,2017,2017-06-30,3,2017,945997,1548
Bureau,Department of the Treasury,Community Dev Financial Inst Fund,null,100.0,100.0,0,0,2799370,5,30,06,2,2017,2017-06-30,3,2017,2799370,5
Bureau,Department of Agriculture,Food and Nutrition Service,null,0.04448508058639811,0.691699604743083,21159478,1005,9417,7,30,06,2,2017,2017-06-30,3,2017,21168895,1012
Bureau,Department of Transportation,Maritime Administration,null,100.0,100.0,0,0,10573,7,30,06,2,2017,2017-06-30,3,2017,10573,7
Bureau,Department of Homeland Security,Bureau of Customs & Border Protection,null,100.0,100.0,0,0,6603306,489,30,06,2,2017,2017-06-30,3,2017,6603306,489
Bureau,Department of Justice,Bureau of ATF and Explosives,null,96.16026711185309,54.54545454545455,966,5,24192,6,30,06,2,2017,2017-06-30,3,2017,25158,11
Bureau,Department of Homeland Security,Immigration and Customs Enforcement,null,100.0,100.0,0,0,7346702,334,30,06,2,2017,2017-06-30,3,2017,7346702,334
Bureau,Environmental Protection Agency,Environmental Protection Agency,null,100.0,100.0,0,0,9426375,199,30,06,2,2017,2017-06-30,3,2017,9426375,199
Bureau,Department of Commerce,Economic Development Administration,null,100.0,100.0,0,0,1307589,1,30,06,2,2017,2017-06-30,3,2017,1307589,1
Bureau,Department of the Interior,Bureau of Land Management,null,100.0,100.0,0,0,12322051,284,30,06,2,2017,2017-06-30,3,2017,12322051,284
Bureau,Department of Justice,Legal Activities,null,99.93019249194941,99.89799496350132,49165,32,70380222,31339,30,06,2,2017,2017-06-30,3,2017,70429387,31371
Bureau,U.S. Court of Appeals / Veterans Claims,U.S. Court of Appeals / Veterans Claims,null,0.0,0.0,40,1,0,0,30,06,2,2017,2017-06-30,3,2017,40,1
Bureau,Other Agencies,Comm. for Purchase from Blind/Handic.,null,0.0,0.0,8945,5,0,0,30,06,2,2017,2017-06-30,3,2017,8945,5
Bureau,Department of the Interior,Bureau of Safety and Environmental Enf.,null,100.0,100.0,0,0,4053,1,30,06,2,2017,2017-06-30,3,2017,4053,1
Bureau,Department of Homeland Security,Citizenship and Immigration Services,null,100.0,100.0,0,0,880934,1062,30,06,2,2017,2017-06-30,3,2017,880934,1062
Bureau,Legislative Branch-CBO,Congressional Budget Office,null,0.0,0.0,0,0,0,0,30,06,2,2017,2017-06-30,3,2017,0,0
Bureau,National Foundation  Arts & Humanities,National Endowment for the Arts,null,0.0,0.0,0,0,0,0,30,06,2,2017,2017-06-30,3,2017,0,0
Bureau,Other Agencies,U.S. Institute of Peace,null,0.0,0.0,4054,5,0,0,30,06,2,2017,2017-06-30,3,2017,4054,5
Bureau,Other Agencies,National Capital Planning Commission,null,0.0,0.0,0,0,0,0,30,06,2,2017,2017-06-30,3,2017,0,0
Bureau,Department of Labor,Departmental Management,null,0.0,0.0,0,0,0,0,30,06,2,2017,2017-06-30,3,2017,0,0
Bureau,Department of Commerce,Patent and Trademark Office,null,100.0,100.0,0,0,266233,431,30,06,2,2017,2017-06-30,3,2017,266233,431
Agency,Neighborhood Reinvestment Corporation,null,Non-CFO,0.0,0.0,0,0,0,0,30,06,2,2017,2017-06-30,3,2017,0,0
Agency,Small Business Administration,null,CFO,99.6301412600804,99.72682651721433,41042487,310,11055758148,113171,30,06,2,2017,2017-06-30,3,2017,11096800635,113481
Bureau,Other Agencies,Millennium Challenge Corporation,null,0.0,0.0,0,0,0,0,30,06,2,2017,2017-06-30,3,2017,0,0
Bureau,Farm Credit Administration,Farm Credit Administration,null,0.0,0.0,0,0,0,0,30,06,2,2017,2017-06-30,3,2017,0,0
Bureau,Farm Credit Administration,Farm Credit System Insurance Corporation,null,0.0,0.0,0,0,0,0,30,06,2,2017,2017-06-30,3,2017,0,0
Bureau,Department of Transportation,Pipeline Hazardous Material Safety Admin,null,100.0,100.0,0,0,379658,25,30,06,2,2017,2017-06-30,3,2017,379658,25
Bureau,Smithsonian Institution,JFK Center for the Performing Arts,null,0.0,0.0,0,0,0,0,30,06,2,2017,2017-06-30,3,2017,0,0
Bureau,Federal Maritime Commission,Salaries and Expenses,null,0.0,0.0,472549,5,0,0,30,06,2,2017,2017-06-30,3,2017,472549,5
Bureau,Department of the Treasury,Interest on Public Debt,null,0.0,0.0,0,0,0,0,30,06,2,2017,2017-06-30,3,2017,0,0
Bureau,Legis Branch-Library of Congress,Library of Congress,null,0.0,0.0,0,0,0,0,30,06,2,2017,2017-06-30,3,2017,0,0
Bureau,Department of Commerce,NOAA,null,100.0,100.0,0,0,4656220,696,30,06,2,2017,2017-06-30,3,2017,4656220,696
Bureau,Department of Homeland Security,U.S. Coast Guard,null,100.0,100.0,0,0,58338599,8839,30,06,2,2017,2017-06-30,3,2017,58338599,8839
Bureau,Department of Agriculture,Farm Service Agency,null,100.0,100.0,0,0,680638198,12569,30,06,2,2017,2017-06-30,3,2017,680638198,12569
Bureau,Department of the Interior,Office of Surface Mining,null,100.0,100.0,0,0,1843096,208,30,06,2,2017,2017-06-30,3,2017,1843096,208
Bureau,Other Agencies,Election Assistance Commission,null,0.0,0.0,0,0,0,0,30,06,2,2017,2017-06-30,3,2017,0,0
Agency,National Science Foundation,null,CFO,100.0,100.0,0,0,784861,10,30,06,2,2017,2017-06-30,3,2017,784861,10
Agency,Export - Import  Bank,null,Non-CFO,0.0,0.0,0,0,0,0,30,06,2,2017,2017-06-30,3,2017,0,0
Bureau,Other Agencies,National Mediation Board,null,0.0,0.0,0,0,0,0,30,06,2,2017,2017-06-30,3,2017,0,0
Bureau,Other Agencies,National Transportation Safety Board,null,0.0,0.0,0,0,0,0,30,06,2,2017,2017-06-30,3,2017,0,0
Agency,Office of Special Counsel,null,Non-CFO,0.0,0.0,0,0,0,0,30,06,2,2017,2017-06-30,3,2017,0,0
Bureau,Other Agencies,U.S. Holocaust Memorial Council,null,0.0,0.0,0,0,0,0,30,06,2,2017,2017-06-30,3,2017,0,0
Bureau,Department of Housing and Urban Development,"Policy, Development and Research",null,0.0,0.0,0,0,0,0,30,06,2,2017,2017-06-30,3,2017,0,0
Bureau,Department of Commerce,National Technical Information Service,null,100.0,100.0,0,0,15706,38,30,06,2,2017,2017-06-30,3,2017,15706,38
Bureau,Smithsonian Institution,Smithsonian Institution,null,0.0,0.0,1378,7,0,0,30,06,2,2017,2017-06-30,3,2017,1378,7
Agency,General Services Administration,null,CFO,82.19796539113311,12.697234082049379,3165399,4703,14615709,684,30,06,2,2017,2017-06-30,3,2017,17781108,5387
Bureau,Selective Service System,Selective Service System,null,0.0,0.0,1265,1,0,0,30,06,2,2017,2017-06-30,3,2017,1265,1
Bureau,Railroad Retirement Board,Railroad Retirement Board,null,91.2056924000378,90.183908045977,1604011,427,16635185,3923,30,06,2,2017,2017-06-30,3,2017,18239196,4350
Bureau,Department of Commerce,Office of the Inspector General,null,0.0,0.0,0,0,0,0,30,06,2,2017,2017-06-30,3,2017,0,0
Bureau,Other Agencies,District of Columbia Government,null,0.0,0.0,125499,102,0,0,30,06,2,2017,2017-06-30,3,2017,125499,102
Bureau,Department of Transportation,Federal Highway Administration,null,100.0,100.0,0,0,11809,9,30,06,2,2017,2017-06-30,3,2017,11809,9
Bureau,Office of Compliance,Office of Compliance,null,0.0,0.0,0,0,0,0,30,06,2,2017,2017-06-30,3,2017,0,0
Bureau,Other Agencies,Commission On Fine Arts,null,0.0,0.0,0,0,0,0,30,06,2,2017,2017-06-30,3,2017,0,0
Bureau,Department of the Treasury,D.C. Pension Program,null,100.0,100.0,0,0,137956,14,30,06,2,2017,2017-06-30,3,2017,137956,14
Bureau,Other Agencies,Gulf Coast Ecosystem Restoration Council,null,0.0,0.0,0,0,0,0,30,06,2,2017,2017-06-30,3,2017,0,0
Bureau,Department of the Interior,Office of Natural Resources Revenue,null,100.0,100.0,0,0,8734783,191,30,06,2,2017,2017-06-30,3,2017,8734783,191
Bureau,Other Agencies,Chemical Safety Board,null,0.0,0.0,0,0,0,0,30,06,2,2017,2017-06-30,3,2017,0,0
Bureau,Department of State,International Commissions,null,0.0,0.0,0,0,0,0,30,06,2,2017,2017-06-30,3,2017,0,0
Bureau,Funds Appropriated to the President,Peace Corps,null,0.0,0.0,0,0,0,0,30,09,3,2017,2017-09-30,4,2017,0,0
Agency,Department of Homeland Security,null,CFO,100.0,100.0,0,0,362283222,59199,30,09,3,2017,2017-09-30,4,2017,362283222,59199
Agency,Department of the Interior,null,CFO,99.87392408965076,99.34272300469483,40460,126,32051317,19044,30,09,3,2017,2017-09-30,4,2017,32091777,19170
Bureau,Funds Appropriated to the President,Trade and Development Agency,null,0.0,0.0,0,0,0,0,30,09,3,2017,2017-09-30,4,2017,0,0
Bureau,Department of Homeland Security,Office of Health Affairs,null,0.0,0.0,0,0,0,0,30,09,3,2017,2017-09-30,4,2017,0,0
Bureau,Other Agencies,Millennium Challenge Corporation,null,0.0,0.0,0,0,0,0,30,09,3,2017,2017-09-30,4,2017,0,0
Bureau,Department of Labor,Departmental Management,null,0.0,0.0,0,0,0,0,30,09,3,2017,2017-09-30,4,2017,0,0
Agency,Legislative Branch-Office of Tech.,null,Non-CFO,0.0,0.0,0,0,0,0,30,09,3,2017,2017-09-30,4,2017,0,0
Agency,General Services Administration,null,CFO,70.07039944030258,63.87225548902195,2573626,362,6025306,640,30,09,3,2017,2017-09-30,4,2017,8598932,1002
Bureau,Other Agencies,Advisory Council on Hist. Preservation,null,0.0,0.0,0,0,0,0,30,09,3,2017,2017-09-30,4,2017,0,0
Bureau,Office of Special Counsel,Office of Special Counsel,null,0.0,0.0,0,0,0,0,30,09,3,2017,2017-09-30,4,2017,0,0
Bureau,Department of the Treasury,Interest on Public Debt,null,0.0,0.0,0,0,0,0,30,09,3,2017,2017-09-30,4,2017,0,0
Bureau,Export - Import  Bank,Export-Import Bank,null,0.0,0.0,0,0,0,0,30,09,3,2017,2017-09-30,4,2017,0,0
Bureau,Legislative Branch-CBO,Congressional Budget Office,null,0.0,0.0,0,0,0,0,30,09,3,2017,2017-09-30,4,2017,0,0
Bureau,Department of the Treasury,Treasury IG for Tax Admin,null,0.0,0.0,0,0,0,0,30,09,3,2017,2017-09-30,4,2017,0,0
Bureau,Department of the Treasury,U.S. Treasury IG Office,null,0.0,0.0,0,0,0,0,30,09,3,2017,2017-09-30,4,2017,0,0
Bureau,Department of Health & Human Services,Food and Drug Administration,null,46.778900233282286,22.408963585434172,22698823,2493,19951222,720,30,09,3,2017,2017-09-30,4,2017,42650045,3213
Bureau,Farm Credit Administration,Farm Credit System Insurance Corporation,null,0.0,0.0,0,0,0,0,30,09,3,2017,2017-09-30,4,2017,0,0
Bureau,Department of Homeland Security,Domestic Nuclear Detection Office,null,0.0,0.0,0,0,0,0,30,09,3,2017,2017-09-30,4,2017,0,0
Bureau,Department of Health & Human Services,Office of the Inspector General,null,0.0,0.0,0,0,0,0,30,09,3,2017,2017-09-30,4,2017,0,0
Bureau,Department of the Treasury,International Monetary Funds,null,0.0,0.0,0,0,0,0,30,09,3,2017,2017-09-30,4,2017,0,0
Bureau,Other Agencies,National Council on Disability,null,0.0,0.0,0,0,0,0,30,09,3,2017,2017-09-30,4,2017,0,0
Bureau,American Battle Monuments Commission,American Battle Monuments Commission,null,0.0,0.0,0,0,0,0,30,09,3,2017,2017-09-30,4,2017,0,0
Bureau,Department of Transportation,Maritime Administration,null,83.57619165225982,75.0,1330,2,6768,6,30,09,3,2017,2017-09-30,4,2017,8098,8
Bureau,Department of Health & Human Services,Centers for Medicare & Medicaid Services,null,98.37758492088489,97.53949914954055,165824683,41560,10055029717,1647527,30,09,3,2017,2017-09-30,4,2017,10220854400,1689087
Agency,Department of Agriculture,null,CFO,97.41788899905687,94.64019851116625,39787395,3564,1501098918,62931,30,09,3,2017,2017-09-30,4,2017,1540886313,66495
Bureau,National Credit Union Administration,Nat'l Credit Union Admin. Treasury Acct.,null,0.0,0.0,0,0,0,0,30,09,3,2017,2017-09-30,4,2017,0,0
Bureau,Department of Labor,Mine Safety and Health Administration,null,93.87221297986436,90.93350458287115,3819313,1553,58508457,15576,30,09,3,2017,2017-09-30,4,2017,62327770,17129
Agency,Social Security Administration,null,CFO,25.543421306049765,10.996990131325727,4555472022,2312405,1562821488,285715,30,09,3,2017,2017-09-30,4,2017,6118293510,2598120
Agency,Department of Health & Human Services,null,CFO,98.1049498449921,97.26332424348843,197187194,46445,10208194082,1650687,30,09,3,2017,2017-09-30,4,2017,10405381276,1697132
Agency,Small Business Administration,null,CFO,99.76050689690015,99.78049765571497,26892761,250,11202140832,113644,30,09,3,2017,2017-09-30,4,2017,11229033593,113894
Bureau,Department of the Treasury,Comptroller of the Currency,null,99.97768164713325,95.83333333333333,230,1,1030312,23,30,09,3,2017,2017-09-30,4,2017,1030542,24
Agency,Department of Education,null,CFO,48.17275844656579,44.246987335556604,72645016043,14033956,67522613693,11137699,30,09,3,2017,2017-09-30,4,2017,140167629736,25171655
Bureau,Department of Homeland Security,Bureau of Customs & Border Protection,null,100.0,100.0,0,0,7730509,599,30,09,3,2017,2017-09-30,4,2017,7730509,599
Bureau,Department of Commerce,Economic and Statistical Analysis,null,0.0,0.0,0,0,0,0,30,09,3,2017,2017-09-30,4,2017,0,0
Bureau,Other Agencies/Boards/Commissions,U.S. Comm. on Int. Religious Freedom,null,0.0,0.0,181226,4,0,0,30,09,3,2017,2017-09-30,4,2017,181226,4
Bureau,Department of Transportation,Federal Highway Administration,null,100.0,100.0,0,0,12195,9,30,09,3,2017,2017-09-30,4,2017,12195,9
Bureau,Department of State,International Commissions,null,0.0,0.0,0,0,0,0,30,09,3,2017,2017-09-30,4,2017,0,0
Bureau,Department of Veterans Affairs,Veterans Benefits,null,99.75937819156864,98.48986680034375,1288878,1687,534355837,110025,30,09,3,2017,2017-09-30,4,2017,535644715,111712
Bureau,Other Agencies,Federal Housing Finance Agency OIG,null,0.0,0.0,0,0,0,0,30,09,3,2017,2017-09-30,4,2017,0,0
Bureau,Selective Service System,Selective Service System,null,0.0,0.0,1187,1,0,0,30,09,3,2017,2017-09-30,4,2017,1187,1
Bureau,Department of the Treasury,Interest on Tax/Deposit of Earnings,null,100.0,100.0,0,0,3240,2,30,09,3,2017,2017-09-30,4,2017,3240,2
Bureau,Small Business Administration,Small Business Administration,null,99.76050689690015,99.78049765571497,26892761,250,11202140832,113644,30,09,3,2017,2017-09-30,4,2017,11229033593,113894
Bureau,Department of Commerce,Bureau of Industry and Security,null,0.0,0.0,3533,1,0,0,30,09,3,2017,2017-09-30,4,2017,3533,1
Bureau,Department of Agriculture,Food Safety and Inspection Service,null,99.80718934823312,99.86666666666666,1557,1,805971,749,30,09,3,2017,2017-09-30,4,2017,807528,750
Bureau,Department of Agriculture,Agricultural Marketing Service,null,95.17568557783154,98.78934624697337,40951,5,807895,408,30,09,3,2017,2017-09-30,4,2017,848846,413
Agency,Overseas Private Investment Corp Accts,null,Non-CFO,0.0,0.0,826684106,0,0,0,30,09,3,2017,2017-09-30,4,2017,826684106,0
Bureau,Other Agencies/Boards/Commissions,U.S.-China Security Review Commission,null,0.0,0.0,0,0,0,0,30,09,3,2017,2017-09-30,4,2017,0,0
Agency,Farm Credit Administration,null,Non-CFO,0.0,0.0,0,0,0,0,30,09,3,2017,2017-09-30,4,2017,0,0
Agency,Securities & Exchange Commission,null,Non-CFO,99.99788381005604,98.51485148514851,40656,12,1921147946,796,30,09,3,2017,2017-09-30,4,2017,1921188602,808
Bureau,Department of Education,Federal Student Aid,null,47.947419954467655,44.24344566833156,72623811666,14033816,66896288207,11135989,30,09,3,2017,2017-09-30,4,2017,139520099873,25169805
Bureau,Department of Housing and Urban Development,Housing Programs,null,99.99601729581882,99.96552912788694,5409,2,135806837,5800,30,09,3,2017,2017-09-30,4,2017,135812246,5802
Bureau,Department of Housing and Urban Development,Government National Mortgage Association,null,0.0,0.0,0,0,0,0,30,09,3,2017,2017-09-30,4,2017,0,0
Bureau,Other Agencies,James Madison Memorial Fellowship,null,0.0,0.0,218726,25,0,0,30,09,3,2017,2017-09-30,4,2017,218726,25
Bureau,Department of Health & Human Services,National Institutes of Health,null,50.99569405646367,29.721362229102166,4921549,227,5121546,96,30,09,3,2017,2017-09-30,4,2017,10043095,323
Agency,Legislative Branch-CBO,null,Non-CFO,0.0,0.0,0,0,0,0,30,09,3,2017,2017-09-30,4,2017,0,0
Bureau,Department of the Treasury,Internal Revenue Service,null,99.26808560470768,98.0952380952381,1750,2,237349,103,30,09,3,2017,2017-09-30,4,2017,239099,105
Bureau,Funds Appropriated to the President,Executive Branch,null,0.0,0.0,0,0,0,0,30,09,3,2017,2017-09-30,4,2017,0,0
Agency,Merit Systems Protection Board,null,Non-CFO,0.0,0.0,258,1,0,0,30,09,3,2017,2017-09-30,4,2017,258,1
Bureau,Smithsonian Institution,JFK Center for the Performing Arts,null,0.0,0.0,0,0,0,0,30,09,3,2017,2017-09-30,4,2017,0,0
Bureau,Tennessee Valley Authority,Tennessee Valley Authority,null,0.0,0.0,0,0,0,0,30,09,3,2017,2017-09-30,4,2017,0,0
Bureau,Other Agencies,Archit.&Trans. Barriers Compliance Bd,null,0.0,0.0,0,0,0,0,30,09,3,2017,2017-09-30,4,2017,0,0
Agency,Consumer Product Safety Commission,null,Non-CFO,100.0,100.0,0,0,439,1,30,09,3,2017,2017-09-30,4,2017,439,1
Agency,Smithsonian Institution,null,Non-CFO,0.0,0.0,506,7,0,0,30,09,3,2017,2017-09-30,4,2017,506,7
Bureau,Smithsonian Institution,Administrative Conference of the US,null,0.0,0.0,0,0,0,0,30,09,3,2017,2017-09-30,4,2017,0,0
Bureau,Department of the Treasury,Spec Insp Gen-Troubled Asset Rel Prog,null,100.0,100.0,0,0,3916,1,30,09,3,2017,2017-09-30,4,2017,3916,1
Agency,Selective Service System,null,Non-CFO,0.0,0.0,1187,1,0,0,30,09,3,2017,2017-09-30,4,2017,1187,1
Bureau,Other Agencies,National Capital Planning Commission,null,0.0,0.0,0,0,0,0,30,09,3,2017,2017-09-30,4,2017,0,0
Bureau,Department of Justice,Drug Enforcement Administration,null,100.0,100.0,0,0,279107,16,30,09,3,2017,2017-09-30,4,2017,279107,16
Agency,Presidio Trust Corporation,null,Non-CFO,99.78279095430145,98.7012987012987,2925,1,1343704,76,30,09,3,2017,2017-09-30,4,2017,1346629,77
Bureau,Federal Mediation/Conciliation Service,Federal Mediation/Conciliation Service,null,0.0,0.0,0,0,0,0,30,09,3,2017,2017-09-30,4,2017,0,0
Bureau,Department of Transportation,Federal Transit Administration,null,100.0,100.0,0,0,784455,3,30,09,3,2017,2017-09-30,4,2017,784455,3
Bureau,U.S. Postal Service,U.S. Postal Service,null,67.27150758539887,73.98377110333423,20251982,13530,41626768,38476,30,09,3,2017,2017-09-30,4,2017,61878750,52006
Agency,The Judiciary,null,Non-CFO,98.96156718951586,93.98148148148148,15293,13,1457407,203,30,09,3,2017,2017-09-30,4,2017,1472700,216
Bureau,Department of the Interior,Bureau of Safety and Environmental Enf.,null,0.0,0.0,4053,1,0,0,30,09,3,2017,2017-09-30,4,2017,4053,1
Bureau,Other Agencies,Consumer Financial Protection Bureau,null,0.0,0.0,217953,61,0,0,30,09,3,2017,2017-09-30,4,2017,217953,61
Bureau,Department of Health & Human Services,Substance Abuse & Mental Health Admin.,null,100.0,100.0,0,0,647238,12,30,09,3,2017,2017-09-30,4,2017,647238,12
Bureau,Department of the Interior,National Park Service,null,100.0,100.0,0,0,5079067,1859,30,09,3,2017,2017-09-30,4,2017,5079067,1859
Bureau,Department of Justice,Legal Activities,null,99.85259148025088,99.86662008955508,104291,42,70645351,31447,30,09,3,2017,2017-09-30,4,2017,70749642,31489
Bureau,Department of Agriculture,Commodity Credit Corporation,null,99.92985598055057,99.98018035873551,87645,2,124862423,10089,30,09,3,2017,2017-09-30,4,2017,124950068,10091
Agency,National Credit Union Administration,null,Non-CFO,100.0,100.0,0,0,4821,2,30,09,3,2017,2017-09-30,4,2017,4821,2
Agency,Legis Branch-Library of Congress,null,Non-CFO,0.0,0.0,32948,12,0,0,30,09,3,2017,2017-09-30,4,2017,32948,12
Bureau,Neighborhood Reinvestment Corporation,Neighborhood Reinvestment Corporation,null,0.0,0.0,0,0,0,0,30,09,3,2017,2017-09-30,4,2017,0,0
Bureau,Department of Veterans Affairs,Medical and Construction,null,84.05255803441372,98.22534521868322,88384235,116093,465837785,6425630,30,09,3,2017,2017-09-30,4,2017,554222020,6541723
Bureau,Other Agencies,Gulf Coast Ecosystem Restoration Council,null,0.0,0.0,0,0,0,0,30,09,3,2017,2017-09-30,4,2017,0,0
Agency,Legislative Branch-GAO,null,Non-CFO,100.0,100.0,0,0,37125,13,30,09,3,2017,2017-09-30,4,2017,37125,13
Bureau,Presidio Trust Corporation,Presidio Trust Corporation,null,99.78279095430145,98.7012987012987,2925,1,1343704,76,30,09,3,2017,2017-09-30,4,2017,1346629,77
Bureau,Federal Trade Commission,Federal Trade Commission,null,100.0,100.0,0,0,483134767,56,30,09,3,2017,2017-09-30,4,2017,483134767,56
Agency,Department of Defense,null,CFO,56.93981763943477,23.581221531855924,1074935089,1009152,1421420082,311403,30,09,3,2017,2017-09-30,4,2017,2496355171,1320555
Bureau,Department of the Interior,Bureau of Indian Affairs,null,99.64596330237406,99.23996322402697,36067,124,10151295,16191,30,09,3,2017,2017-09-30,4,2017,10187362,16315
Bureau,Department of Labor,Employment Standards Administration,null,57.97412405333448,32.104027674820856,55638535,10991,76752602,5197,30,09,3,2017,2017-09-30,4,2017,132391137,16188
Agency,National Archives & Records Admin,null,Non-CFO,95.1064355416478,93.25842696629213,2377,6,46197,83,30,09,3,2017,2017-09-30,4,2017,48574,89
Bureau,Department of Justice,Federal Prison System,null,100.0,100.0,0,0,621689,67,30,09,3,2017,2017-09-30,4,2017,621689,67
Bureau,Department of Homeland Security,Immigration and Customs Enforcement,null,100.0,100.0,0,0,6683480,352,30,09,3,2017,2017-09-30,4,2017,6683480,352
Bureau,Armed Forces Retirement Home,Armed Forces Retirement Home,null,99.59945826009279,97.77777777777777,278,2,69128,88,30,09,3,2017,2017-09-30,4,2017,69406,90
Bureau,Department of Labor,Employment and Training Administration,null,100.0,100.0,0,0,2927113,2,30,09,3,2017,2017-09-30,4,2017,2927113,2
Bureau,Department of the Treasury,Departmental Offices,null,99.97884141251633,99.44444444444444,3936,4,18598440,716,30,09,3,2017,2017-09-30,4,2017,18602376,720
Bureau,Department of Agriculture,Rural Development,null,99.99728239331752,99.98866020298237,16049,4,590540344,35270,30,09,3,2017,2017-09-30,4,2017,590556393,35274
Agency,Armed Forces Retirement Home,null,Non-CFO,99.59945826009279,97.77777777777777,278,2,69128,88,30,09,3,2017,2017-09-30,4,2017,69406,90
Bureau,The Judiciary,Administrative Office of the U.S. Courts,null,98.96156718951586,93.98148148148148,15293,13,1457407,203,30,09,3,2017,2017-09-30,4,2017,1472700,216
Bureau,Other Agencies,Defense Nuclear Facilities Safety Board,null,0.0,0.0,0,0,0,0,30,09,3,2017,2017-09-30,4,2017,0,0
Bureau,Department of the Treasury,Treasury Forfeiture Fund,null,0.0,0.0,0,0,0,0,30,09,3,2017,2017-09-30,4,2017,0,0
Bureau,Department of Agriculture,Food and Nutrition Service,null,9.657162481600384,16.937354988399072,19124603,358,2044317,73,30,09,3,2017,2017-09-30,4,2017,21168920,431
Bureau,National Credit Union Administration,National Credit Union Administration,null,100.0,100.0,0,0,4821,2,30,09,3,2017,2017-09-30,4,2017,4821,2
Bureau,Department of State,Civil Monetary Penalties,null,0.0,0.0,0,0,0,0,30,09,3,2017,2017-09-30,4,2017,0,0
Bureau,Department of Health & Human Services,Office of the Secretary,null,100.0,100.0,0,0,4614,4,30,09,3,2017,2017-09-30,4,2017,4614,4
Bureau,Funds Appropriated to the President,Inter-American Foundation,null,0.0,0.0,0,0,0,0,30,09,3,2017,2017-09-30,4,2017,0,0
Bureau,Department of Justice,Bureau of ATF and Explosives,null,100.0,100.0,0,0,12034,5,30,09,3,2017,2017-09-30,4,2017,12034,5
Bureau,Department of Health & Human Services,Indian Health Services,null,83.59519526100988,5.90324012427874,3622842,2120,18461188,133,30,09,3,2017,2017-09-30,4,2017,22084030,2253
Bureau,Department of Commerce,Office of the Inspector General,null,0.0,0.0,0,0,0,0,30,09,3,2017,2017-09-30,4,2017,0,0
Bureau,Commodity Futures Trading Commission,Commodity Futures Trading Commission,null,100.0,100.0,0,0,592744300,357,30,09,3,2017,2017-09-30,4,2017,592744300,357
Bureau,Department of Veterans Affairs,Housing Credit Assistance,null,60.29476258277338,82.3529411764706,602066,12,914273,56,30,09,3,2017,2017-09-30,4,2017,1516339,68
Agency,Department of State,null,CFO,99.96347873103514,99.93706124425078,7403,13,20262977,20642,30,09,3,2017,2017-09-30,4,2017,20270380,20655
Bureau,Department of Justice,U.S. Marshals Service,null,0.0,0.0,0,0,0,0,30,09,3,2017,2017-09-30,4,2017,0,0
Bureau,Department of Health & Human Services,Centers for Disease Control,null,18.733906456491233,15.09433962264151,119297,45,27501,8,30,09,3,2017,2017-09-30,4,2017,146798,53
Bureau,Department of the Interior,Office of Surface Mining,null,99.98309785496866,99.54545454545455,340,1,2011239,219,30,09,3,2017,2017-09-30,4,2017,2011579,220
Agency,Agency for International Development,null,CFO,99.78223877355816,92.6829268292683,52545,3,24077095,38,30,09,3,2017,2017-09-30,4,2017,24129640,41
Agency,Corp. for National and Community Service,null,Non-CFO,79.08704218096253,91.36363636363636,811080,19,3067281,201,30,09,3,2017,2017-09-30,4,2017,3878361,220
Bureau,U.S. Court of Appeals / Veterans Claims,U.S. Court of Appeals / Veterans Claims,null,0.0,0.0,0,0,0,0,30,09,3,2017,2017-09-30,4,2017,0,0
Bureau,Department of the Treasury,Bureau of the Fiscal Service,null,100.0,100.0,0,0,9898686,3817,30,09,3,2017,2017-09-30,4,2017,9898686,3817
Bureau,Federal Election Commission,Federal Election Commission,null,99.05390711133873,97.29729729729729,3750,1,392617,36,30,09,3,2017,2017-09-30,4,2017,396367,37
Agency,Legislative Branch - U.S. House/Senate,null,Non-CFO,0.0,0.0,214980,198,0,0,30,09,3,2017,2017-09-30,4,2017,214980,198
Bureau,Office of Government Ethics,Office of Government Ethics,null,0.0,0.0,0,0,0,0,30,09,3,2017,2017-09-30,4,2017,0,0
Bureau,Department of Education,Departmental Management,null,96.72534376997528,92.43243243243244,21204377,140,626325486,1710,30,09,3,2017,2017-09-30,4,2017,647529863,1850
Agency,Railroad Retirement Board,null,Non-CFO,97.71818811842634,95.33984996590134,405508,205,17365808,4194,30,09,3,2017,2017-09-30,4,2017,17771316,4399
Bureau,National Foundation  Arts & Humanities,National Endowment for the Humanities,null,0.0,0.0,0,0,0,0,30,09,3,2017,2017-09-30,4,2017,0,0
Bureau,Other Agencies,Denali Commission,null,0.0,0.0,0,0,0,0,30,09,3,2017,2017-09-30,4,2017,0,0
Bureau,Department of Transportation,Research Innovative Technology Admin,null,92.04511278195488,75.0,529,1,6121,3,30,09,3,2017,2017-09-30,4,2017,6650,4
Agency,Federal Election Commission,null,Non-CFO,99.05390711133873,97.29729729729729,3750,1,392617,36,30,09,3,2017,2017-09-30,4,2017,396367,37
Bureau,Department of Housing and Urban Development,Management and Administration,null,0.0,0.0,0,0,0,0,30,09,3,2017,2017-09-30,4,2017,0,0
Agency,Federal Communications Commission,null,Non-CFO,100.0,100.0,0,0,188446103,12879,30,09,3,2017,2017-09-30,4,2017,188446103,12879
Bureau,Other Agencies,Commission On Fine Arts,null,0.0,0.0,0,0,0,0,30,09,3,2017,2017-09-30,4,2017,0,0
Bureau,Other Agencies,U.S. Inst. for Env. Conflict Resolution,null,0.0,0.0,208,1,0,0,30,09,3,2017,2017-09-30,4,2017,208,1
Bureau,Merit Systems Protection Board,Merit Systems Protection Board,null,0.0,0.0,258,1,0,0,30,09,3,2017,2017-09-30,4,2017,258,1
Agency,Federal Trade Commission,null,Non-CFO,100.0,100.0,0,0,483134767,56,30,09,3,2017,2017-09-30,4,2017,483134767,56
Bureau,Office of Personnel Management,Office of Personnel Management,null,53.711491893131495,76.56467315716273,15622839,337,18128171,1101,30,09,3,2017,2017-09-30,4,2017,33751010,1438
Agency,Department of the Treasury,null,CFO,99.98212671164455,99.8511588347863,5916,7,33093757,4696,30,09,3,2017,2017-09-30,4,2017,33099673,4703
Bureau,Department of Agriculture,Farm Service Agency,null,99.99998601486772,99.9928155758316,100,1,715044978,13918,30,09,3,2017,2017-09-30,4,2017,715045078,13919
Bureau,National Foundation  Arts & Humanities,National Endowment for the Arts,null,0.0,0.0,0,0,0,0,30,09,3,2017,2017-09-30,4,2017,0,0
Agency,Office of Personnel Management,null,CFO,53.711491893131495,76.56467315716273,15622839,337,18128171,1101,30,09,3,2017,2017-09-30,4,2017,33751010,1438
Bureau,Securities & Exchange Commission,Securities and Exchange Commission,null,99.99788381005604,98.51485148514851,40656,12,1921147946,796,30,09,3,2017,2017-09-30,4,2017,1921188602,808
Bureau,Consumer Product Safety Commission,Consumer Product Safety Commission,null,100.0,100.0,0,0,439,1,30,09,3,2017,2017-09-30,4,2017,439,1
Bureau,Department of Labor,Occupational Safety and Health Admin,null,96.97089365579446,96.92769692769693,1250512,133,40032687,4196,30,09,3,2017,2017-09-30,4,2017,41283199,4329
Agency,Commodity Futures Trading Commission,null,Non-CFO,100.0,100.0,0,0,592744300,357,30,09,3,2017,2017-09-30,4,2017,592744300,357
Bureau,Department of Defense,Consolidated Report,null,56.93981763943477,23.581221531855924,1074935089,1009152,1421420082,311403,30,09,3,2017,2017-09-30,4,2017,2496355171,1320555
Agency,Department of Labor,null,CFO,76.23264657385343,66.64035156969554,60708360,12677,194719154,25324,30,09,3,2017,2017-09-30,4,2017,255427514,38001
Bureau,Environmental Protection Agency,Environmental Protection Agency,null,100.0,100.0,0,0,9309636,181,30,09,3,2017,2017-09-30,4,2017,9309636,181
Agency,Department of Veterans Affairs,null,CFO,91.45869183661021,98.21800157880904,93536744,118581,1001573539,6535802,30,09,3,2017,2017-09-30,4,2017,1095110283,6654383
Bureau,Department of Commerce,Nat'l Telecomm & Information Admin.,null,0.0,0.0,0,0,0,0,30,09,3,2017,2017-09-30,4,2017,0,0
Bureau,Department of the Treasury,Treasury Franchise Fund,null,0.0,0.0,0,0,0,0,30,09,3,2017,2017-09-30,4,2017,0,0
Bureau,Department of Housing and Urban Development,Community Planning and Development,null,0.0,0.0,0,0,0,0,30,09,3,2017,2017-09-30,4,2017,0,0
Bureau,Farm Credit Administration,Farm Credit Administration,null,0.0,0.0,0,0,0,0,30,09,3,2017,2017-09-30,4,2017,0,0
Agency,Funds Appropriated to the President,null,Non-CFO,0.0,0.0,0,0,0,0,30,09,3,2017,2017-09-30,4,2017,0,0
Bureau,Department of Homeland Security,Science and Technology,null,0.0,0.0,0,0,0,0,30,09,3,2017,2017-09-30,4,2017,0,0
Bureau,Occupational Safety & Health Rev Comm,Occupational Safety & Health Rev Comm,null,0.0,0.0,0,0,0,0,30,09,3,2017,2017-09-30,4,2017,0,0
Bureau,Department of the Treasury,Office of the Secretary,null,0.0,0.0,0,0,0,0,30,09,3,2017,2017-09-30,4,2017,0,0
Bureau,Department of Housing and Urban Development,Public and Indian Housing Programs,null,0.0,0.0,0,0,0,0,30,09,3,2017,2017-09-30,4,2017,0,0
Bureau,Department of the Treasury,Community Dev Financial Inst Fund,null,100.0,100.0,0,0,2864484,6,30,09,3,2017,2017-09-30,4,2017,2864484,6
Agency,Federal Mediation/Conciliation Service,null,Non-CFO,0.0,0.0,0,0,0,0,30,09,3,2017,2017-09-30,4,2017,0,0
Agency,Export - Import  Bank,null,Non-CFO,0.0,0.0,0,0,0,0,30,09,3,2017,2017-09-30,4,2017,0,0
Agency,Occupational Safety & Health Rev Comm,null,Non-CFO,0.0,0.0,0,0,0,0,30,09,3,2017,2017-09-30,4,2017,0,0
Agency,U.S. Postal Service,null,Non-CFO,67.27150758539887,73.98377110333423,20251982,13530,41626768,38476,30,09,3,2017,2017-09-30,4,2017,61878750,52006
Bureau,Department of Commerce,Minority Business Development Agency,null,0.0,0.0,0,0,0,0,30,09,3,2017,2017-09-30,4,2017,0,0
Bureau,Smithsonian Institution,National Gallery of Art,null,0.0,0.0,0,0,0,0,30,09,3,2017,2017-09-30,4,2017,0,0
Bureau,Legislative Branch-GPO,Government Publishing Office,null,0.0,0.0,111458,87,0,0,30,09,3,2017,2017-09-30,4,2017,111458,87
Bureau,Department of the Interior,Office of Natural Resources Revenue,null,100.0,100.0,0,0,1288774,223,30,09,3,2017,2017-09-30,4,2017,1288774,223
Agency,Equal Employment Opportunity Commission,null,Non-CFO,100.0,100.0,0,0,27422,18,30,09,3,2017,2017-09-30,4,2017,27422,18
Bureau,Smithsonian Institution,Smithsonian Institution,null,0.0,0.0,506,7,0,0,30,09,3,2017,2017-09-30,4,2017,506,7
Bureau,Funds Appropriated to the President,African Development Foundation,null,0.0,0.0,0,0,0,0,30,09,3,2017,2017-09-30,4,2017,0,0
Bureau,Legislative Branch - U.S. House/Senate,U.S. House of Representatives,null,0.0,0.0,214980,198,0,0,30,09,3,2017,2017-09-30,4,2017,214980,198
Bureau,Department of State,Passport NSF,null,99.95904312190962,99.96839643511788,1045,5,2550419,15816,30,09,3,2017,2017-09-30,4,2017,2551464,15821
Bureau,Funds Appropriated to the President,Defense Security Assistance Agency,null,0.0,0.0,0,0,0,0,30,09,3,2017,2017-09-30,4,2017,0,0
Bureau,Department of Education,Office of Postsecondary Education,null,0.0,0.0,0,0,0,0,30,09,3,2017,2017-09-30,4,2017,0,0
Bureau,Agency for International Development,Agency for International Development,null,99.78223877355816,92.6829268292683,52545,3,24077095,38,30,09,3,2017,2017-09-30,4,2017,24129640,41
Bureau,Department of Homeland Security,U.S. Secret Service,null,0.0,0.0,0,0,0,0,30,09,3,2017,2017-09-30,4,2017,0,0
Bureau,Department of Transportation,St. Lawrence Seaway Development Corp.,null,0.0,0.0,0,0,0,0,30,09,3,2017,2017-09-30,4,2017,0,0
Agency,National Aeronautics and Space Administration,null,CFO,100.0,100.0,0,0,1448561,80,30,09,3,2017,2017-09-30,4,2017,1448561,80
Agency,National Labor Relations Board,null,Non-CFO,0.0,0.0,0,0,0,0,30,09,3,2017,2017-09-30,4,2017,0,0
Agency,Department of Energy,null,CFO,100.0,100.0,0,0,20263636,89,30,09,3,2017,2017-09-30,4,2017,20263636,89
Agency,Office of Special Counsel,null,Non-CFO,0.0,0.0,0,0,0,0,30,09,3,2017,2017-09-30,4,2017,0,0
Agency,Office of Government Ethics,null,Non-CFO,0.0,0.0,0,0,0,0,30,09,3,2017,2017-09-30,4,2017,0,0
Agency,Department of Commerce,null,CFO,99.94350943231167,99.84399375975039,3642,2,6443452,1280,30,09,3,2017,2017-09-30,4,2017,6447094,1282
Bureau,Corp. for National and Community Service,Corp. for National and Community Service,null,79.08704218096253,91.36363636363636,811080,19,3067281,201,30,09,3,2017,2017-09-30,4,2017,3878361,220
Agency,Department of Justice,null,CFO,98.57388915312751,99.31770523614284,1054435,218,72883366,31733,30,09,3,2017,2017-09-30,4,2017,73937801,31951
Bureau,Nuclear Regulatory Commission,Nuclear Regulatory Commission,null,100.0,100.0,0,0,979785,180,30,09,3,2017,2017-09-30,4,2017,979785,180
Bureau,Department of Transportation,Federal Motor Carrier Safety Admin,null,99.85346741829318,99.71746091542663,60835,15,41455529,5294,30,09,3,2017,2017-09-30,4,2017,41516364,5309
Agency,Office of Compliance,null,Non-CFO,0.0,0.0,0,0,0,0,30,09,3,2017,2017-09-30,4,2017,0,0
Agency,U.S. Court of Appeals / Veterans Claims,null,Non-CFO,0.0,0.0,0,0,0,0,30,09,3,2017,2017-09-30,4,2017,0,0
Bureau,Social Security Administration,Social Security Administration,null,25.543421306049765,10.996990131325727,4555472022,2312405,1562821488,285715,30,09,3,2017,2017-09-30,4,2017,6118293510,2598120
Bureau,Department of Homeland Security,Office of Biometric Identity Management,null,0.0,0.0,0,0,0,0,30,09,3,2017,2017-09-30,4,2017,0,0
Bureau,Legislative Branch-Office of Tech.,Medicaid & CHIP Payment & Access Comm.,null,0.0,0.0,0,0,0,0,30,09,3,2017,2017-09-30,4,2017,0,0
Bureau,Department of Justice,General Administration,null,0.0,0.0,0,0,0,0,30,09,3,2017,2017-09-30,4,2017,0,0
Bureau,Department of Commerce,International Trade Administration,null,0.0,0.0,0,0,0,0,30,09,3,2017,2017-09-30,4,2017,0,0
Bureau,Other Agencies,Morris K. Udall Scholarship,null,0.0,0.0,0,0,0,0,30,09,3,2017,2017-09-30,4,2017,0,0
Bureau,Office of Compliance,Office of Compliance,null,0.0,0.0,0,0,0,0,30,09,3,2017,2017-09-30,4,2017,0,0
Bureau,Department of the Treasury,Office of Sec International Affairs,null,0.0,0.0,0,0,0,0,30,09,3,2017,2017-09-30,4,2017,0,0
Bureau,Other Agencies,District of Columbia Government,null,0.0,0.0,0,0,0,0,30,09,3,2017,2017-09-30,4,2017,0,0
Bureau,Other Agencies,Chemical Safety Board,null,0.0,0.0,0,0,0,0,30,09,3,2017,2017-09-30,4,2017,0,0
Bureau,Other Agencies,U.S.  Agency of Global Media,null,52.536775743020115,16.666666666666668,4743,5,5250,1,30,09,3,2017,2017-09-30,4,2017,9993,6
Bureau,Department of State,Department of State,null,99.96411744375334,99.83450558543649,6358,8,17712558,4826,30,09,3,2017,2017-09-30,4,2017,17718916,4834
Agency,Tennessee Valley Authority,null,Non-CFO,0.0,0.0,0,0,0,0,30,09,3,2017,2017-09-30,4,2017,0,0
Bureau,Department of Commerce,General Administration,null,100.0,100.0,0,0,4660,1,30,09,3,2017,2017-09-30,4,2017,4660,1
Bureau,Legislative Branch-GAO,Government Accountability Office,null,100.0,100.0,0,0,37125,13,30,09,3,2017,2017-09-30,4,2017,37125,13
Bureau,General Services Administration,General Services Administration,null,70.07039944030258,63.87225548902195,2573626,362,6025306,640,30,09,3,2017,2017-09-30,4,2017,8598932,1002
Bureau,National Archives & Records Admin,Nat'l Archives & Records Administration,null,95.1064355416478,93.25842696629213,2377,6,46197,83,30,09,3,2017,2017-09-30,4,2017,48574,89
Agency,Legislative Branch-GPO,null,Non-CFO,0.0,0.0,111458,87,0,0,30,09,3,2017,2017-09-30,4,2017,111458,87
Bureau,Department of Agriculture,Forest Service,null,82.84830508972465,16.666666666666668,10276261,2290,49637707,458,30,09,3,2017,2017-09-30,4,2017,59913968,2748
Bureau,Other Agencies,Delta Regional Authority,null,0.0,0.0,0,0,0,0,30,09,3,2017,2017-09-30,4,2017,0,0
Bureau,Department of Homeland Security,Federal Law Enforcement Training Ctr.,null,100.0,100.0,0,0,19340,6,30,09,3,2017,2017-09-30,4,2017,19340,6
Bureau,Department of Homeland Security,Citizenship and Immigration Services,null,100.0,100.0,0,0,902611,1108,30,09,3,2017,2017-09-30,4,2017,902611,1108
Bureau,Department of Health & Human Services,Health Resources and Services Admin,null,100.0,100.0,0,0,84544980,512,30,09,3,2017,2017-09-30,4,2017,84544980,512
Bureau,Department of Justice,Federal Prison Industries,null,65.51206531303366,78.87931034482759,549120,49,1043089,183,30,09,3,2017,2017-09-30,4,2017,1592209,232
Bureau,Department of the Treasury,U.S. Mint,null,100.0,100.0,0,0,34751,8,30,09,3,2017,2017-09-30,4,2017,34751,8
Bureau,Pension Benefit Guaranty Corp,Pension Benefit Guaranty Corporation,null,100.0,100.0,0,0,2306730,937,30,09,3,2017,2017-09-30,4,2017,2306730,937
Bureau,Department of Justice,Office of Justice Assistance Programs,null,100.0,100.0,0,0,282096,15,30,09,3,2017,2017-09-30,4,2017,282096,15
Bureau,Other Agencies,Federal Housing Finance Agency,null,0.0,0.0,0,0,0,0,30,09,3,2017,2017-09-30,4,2017,0,0
Agency,Nuclear Regulatory Commission,null,CFO,100.0,100.0,0,0,979785,180,30,09,3,2017,2017-09-30,4,2017,979785,180
Bureau,Other Agencies,U.S. Institute of Peace,null,0.0,0.0,0,0,0,0,30,09,3,2017,2017-09-30,4,2017,0,0
Bureau,Federal Labor Relations Authority,Federal Labor Relations Authority,null,0.0,0.0,0,0,0,0,30,09,3,2017,2017-09-30,4,2017,0,0
Bureau,Other Agencies/Boards/Commissions,Medicare Payment Advisory Commission,null,0.0,0.0,0,0,0,0,30,09,3,2017,2017-09-30,4,2017,0,0
Bureau,Department of Commerce,Nat'l Institute of Standards& Technology,null,100.0,100.0,0,0,670854,6,30,09,3,2017,2017-09-30,4,2017,670854,6
Agency,Other Agencies/Boards/Commissions,null,Non-CFO,0.0,0.0,181226,4,0,0,30,09,3,2017,2017-09-30,4,2017,181226,4
Bureau,Department of Health & Human Services,Administration for Children and Families,null,100.0,100.0,0,0,20807932,1149,30,09,3,2017,2017-09-30,4,2017,20807932,1149
Bureau,Federal Communications Commission,Federal Communications Commission,null,100.0,100.0,0,0,188446103,12879,30,09,3,2017,2017-09-30,4,2017,188446103,12879
Bureau,Department of the Interior,Fish and Wildlife Service,null,100.0,100.0,0,0,543154,98,30,09,3,2017,2017-09-30,4,2017,543154,98
Bureau,Department of Agriculture,Federal Crop Insurance Corporation,null,99.9993360466892,100.0,1,0,150612,358,30,09,3,2017,2017-09-30,4,2017,150613,358
Bureau,National Science Foundation,National Science Foundation,null,100.0,100.0,0,0,176009,11,30,09,3,2017,2017-09-30,4,2017,176009,11
Bureau,Department of Transportation,Pipeline Hazardous Material Safety Admin,null,99.99329826988135,96.0,25,1,373013,24,30,09,3,2017,2017-09-30,4,2017,373038,25
Bureau,Department of Justice,Federal Bureau of Investigation,null,0.0,0.0,401024,127,0,0,30,09,3,2017,2017-09-30,4,2017,401024,127
Bureau,Department of Health & Human Services,Program Support Center,null,100.0,100.0,0,0,3598144,526,30,09,3,2017,2017-09-30,4,2017,3598144,526
Bureau,Department of Homeland Security,Transportation Safety Administration,null,100.0,100.0,0,0,12490186,4583,30,09,3,2017,2017-09-30,4,2017,12490186,4583
Bureau,Federal Deposit Insurance Corporation,Federal Deposit Insurance Corporation,null,0.0,0.0,0,0,0,0,30,09,3,2017,2017-09-30,4,2017,0,0
Bureau,Department of the Treasury,Office of Financial Research,null,100.0,100.0,0,0,36,1,30,09,3,2017,2017-09-30,4,2017,36,1
Bureau,Department of the Treasury,Tobacco Tax and Trade,null,100.0,100.0,0,0,1000,1,30,09,3,2017,2017-09-30,4,2017,1000,1
Bureau,Department of Commerce,Bureau of the Census,null,99.86220671521036,99.33774834437087,109,1,78995,150,30,09,3,2017,2017-09-30,4,2017,79104,151
Bureau,Department of Commerce,Patent and Trademark Office,null,100.0,100.0,0,0,320221,520,30,09,3,2017,2017-09-30,4,2017,320221,520
Bureau,Department of the Interior,Bureau of Land Management,null,100.0,100.0,0,0,12772354,292,30,09,3,2017,2017-09-30,4,2017,12772354,292
Agency,Department of Housing and Urban Development,null,CFO,99.99601729581882,99.96552912788694,5409,2,135806837,5800,30,09,3,2017,2017-09-30,4,2017,135812246,5802
Bureau,National Labor Relations Board,National Labor Relations Board,null,0.0,0.0,0,0,0,0,30,09,3,2017,2017-09-30,4,2017,0,0
Bureau,Other Agencies,Election Assistance Commission,null,0.0,0.0,91,1,0,0,30,09,3,2017,2017-09-30,4,2017,91,1
Bureau,Federal Maritime Commission,Salaries and Expenses,null,99.54477470455646,38.46153846153846,2161,8,472549,5,30,09,3,2017,2017-09-30,4,2017,474710,13
Bureau,Other Agencies,Surface Transportation Board,null,0.0,0.0,0,0,0,0,30,09,3,2017,2017-09-30,4,2017,0,0
Bureau,Department of Veterans Affairs,Life Insurance,null,100.0,100.0,0,0,444749,67,30,09,3,2017,2017-09-30,4,2017,444749,67
Bureau,Department of Transportation,Federal Aviation Administration,null,91.22996608177897,90.78549848942598,387510,61,4031059,601,30,09,3,2017,2017-09-30,4,2017,4418569,662
Bureau,Department of Homeland Security,Emergency Preparedness & Resp,null,100.0,100.0,0,0,273896320,43697,30,09,3,2017,2017-09-30,4,2017,273896320,43697
Agency,American Battle Monuments Commission,null,Non-CFO,0.0,0.0,0,0,0,0,30,09,3,2017,2017-09-30,4,2017,0,0
Agency,Federal Deposit Insurance Corporation,null,Non-CFO,0.0,0.0,0,0,0,0,30,09,3,2017,2017-09-30,4,2017,0,0
Bureau,Department of Transportation,Federal Railroad Administration,null,100.0,100.0,0,0,296507,20,30,09,3,2017,2017-09-30,4,2017,296507,20
Bureau,National Aeronautics and Space Administration,National Aeronautics and Space Admin,null,100.0,100.0,0,0,1448561,80,30,09,3,2017,2017-09-30,4,2017,1448561,80
Bureau,Department of Transportation,National Highway Traffic Safety Admin.,null,100.0,100.0,0,0,7617721,4,30,09,3,2017,2017-09-30,4,2017,7617721,4
Bureau,Department of Labor,Employee Benefit Security Administration,null,100.0,100.0,0,0,16487326,352,30,09,3,2017,2017-09-30,4,2017,16487326,352
Bureau,Department of Health & Human Services,Administration for Community Living,null,0.0,0.0,0,0,0,0,30,09,3,2017,2017-09-30,4,2017,0,0
Bureau,Railroad Retirement Board,Railroad Retirement Board,null,97.71818811842634,95.33984996590134,405508,205,17365808,4194,30,09,3,2017,2017-09-30,4,2017,17771316,4399
Agency,Federal Labor Relations Authority,null,Non-CFO,0.0,0.0,0,0,0,0,30,09,3,2017,2017-09-30,4,2017,0,0
Agency,Neighborhood Reinvestment Corporation,null,Non-CFO,0.0,0.0,0,0,0,0,30,09,3,2017,2017-09-30,4,2017,0,0
Agency,Federal Maritime Commission,null,Non-CFO,99.54477470455646,38.46153846153846,2161,8,472549,5,30,09,3,2017,2017-09-30,4,2017,474710,13
Bureau,Department of Housing and Urban Development,"Policy, Development and Research",null,0.0,0.0,0,0,0,0,30,09,3,2017,2017-09-30,4,2017,0,0
Bureau,Department of the Treasury,Financial Crimes Enforcement Network,null,100.0,100.0,0,0,67184,3,30,09,3,2017,2017-09-30,4,2017,67184,3
Bureau,Legislative Branch-Office of Tech.,Open World Leadership,null,0.0,0.0,0,0,0,0,30,09,3,2017,2017-09-30,4,2017,0,0
Bureau,Department of Commerce,National Technical Information Service,null,0.0,0.0,0,0,0,0,30,09,3,2017,2017-09-30,4,2017,0,0
Bureau,Department of Homeland Security,Office of the Inspector General DHS,null,100.0,100.0,0,0,499,2,30,09,3,2017,2017-09-30,4,2017,499,2
Bureau,Department of Commerce,Economic Development Administration,null,100.0,100.0,0,0,1307589,1,30,09,3,2017,2017-09-30,4,2017,1307589,1
Bureau,Department of Agriculture,U.S. Department of Agriculture,null,62.688046328754936,64.03823178016727,10240228,903,17204671,1608,30,09,3,2017,2017-09-30,4,2017,27444899,2511
Bureau,Department of Homeland Security,U.S. Coast Guard,null,100.0,100.0,0,0,60555667,8851,30,09,3,2017,2017-09-30,4,2017,60555667,8851
Bureau,Department of Transportation,Surface Transportation Board,null,0.0,0.0,0,0,0,0,30,09,3,2017,2017-09-30,4,2017,0,0
Bureau,Department of Homeland Security,Info Analysis Infrastructure Prot-NPPD,null,100.0,100.0,0,0,4610,1,30,09,3,2017,2017-09-30,4,2017,4610,1
Bureau,Department of Transportation,Office of the Secretary,null,100.0,100.0,0,0,1607898,24,30,09,3,2017,2017-09-30,4,2017,1607898,24
Bureau,Department of Veterans Affairs,Administration and Cemeteries,null,0.6365652589825923,2.952029520295203,3261565,789,20895,24,30,09,3,2017,2017-09-30,4,2017,3282460,813
Bureau,Department of Energy,Energy Consolidated Reports,null,100.0,100.0,0,0,19124665,58,30,09,3,2017,2017-09-30,4,2017,19124665,58
Bureau,Overseas Private Investment Corp Accts,Overseas Private Investment Corp Accts,null,0.0,0.0,826684106,0,0,0,30,09,3,2017,2017-09-30,4,2017,826684106,0
Bureau,Department of Transportation,Office of the Inspector General,null,0.0,0.0,0,0,0,0,30,09,3,2017,2017-09-30,4,2017,0,0
Bureau,Department of the Interior,"Bureau of Ocean Energy Mgmt., Reg & Enf",null,100.0,100.0,0,0,166,1,30,09,3,2017,2017-09-30,4,2017,166,1
Bureau,Equal Employment Opportunity Commission,Equal Employment Opportunity Commission,null,100.0,100.0,0,0,27422,18,30,09,3,2017,2017-09-30,4,2017,27422,18
Bureau,Legis Branch-Library of Congress,Library of Congress,null,0.0,0.0,32948,12,0,0,30,09,3,2017,2017-09-30,4,2017,32948,12
Bureau,Department of the Treasury,D.C. Pension Program,null,100.0,100.0,0,0,269831,14,30,09,3,2017,2017-09-30,4,2017,269831,14
Agency,Environmental Protection Agency,null,CFO,100.0,100.0,0,0,9309636,181,30,09,3,2017,2017-09-30,4,2017,9309636,181
Agency,Pension Benefit Guaranty Corp,null,Non-CFO,100.0,100.0,0,0,2306730,937,30,09,3,2017,2017-09-30,4,2017,2306730,937
Bureau,Other Agencies,National Transportation Safety Board,null,0.0,0.0,0,0,0,0,30,09,3,2017,2017-09-30,4,2017,0,0
Agency,Other Agencies,null,Non-CFO,0.8477135148139955,0.6211180124223602,614063,160,5250,1,30,09,3,2017,2017-09-30,4,2017,619313,161
Bureau,Other Agencies,U.S. Holocaust Memorial Council,null,0.0,0.0,0,0,0,0,30,09,3,2017,2017-09-30,4,2017,0,0
Bureau,Other Agencies,Federal Mine Safety & Health Review Comm,null,0.0,0.0,0,0,0,0,30,09,3,2017,2017-09-30,4,2017,0,0
Bureau,Department of Energy,Bonneville Power Administration,null,100.0,100.0,0,0,1138971,31,30,09,3,2017,2017-09-30,4,2017,1138971,31
Bureau,Department of the Interior,Office of the Secretary,null,100.0,100.0,0,0,16914,8,30,09,3,2017,2017-09-30,4,2017,16914,8
Bureau,Other Agencies,National Mediation Board,null,0.0,0.0,0,0,0,0,30,09,3,2017,2017-09-30,4,2017,0,0
Bureau,Department of Homeland Security,Management Headquarters,null,0.0,0.0,0,0,0,0,30,09,3,2017,2017-09-30,4,2017,0,0
Bureau,Department of the Interior,Bureau of Reclamation,null,100.0,100.0,0,0,95397,79,30,09,3,2017,2017-09-30,4,2017,95397,79
Agency,National Science Foundation,null,CFO,100.0,100.0,0,0,176009,11,30,09,3,2017,2017-09-30,4,2017,176009,11
Agency,Department of Transportation,null,CFO,99.20512514720878,98.681608437706,450229,80,56191266,5988,30,09,3,2017,2017-09-30,4,2017,56641495,6068
Bureau,Other Agencies,Council of Insps. Gen. of Intg. & Effy.,null,0.0,0.0,1275,3,0,0,30,09,3,2017,2017-09-30,4,2017,1275,3
Bureau,Department of Labor,Bureau of Labor Statistics,null,100.0,100.0,0,0,10969,1,30,09,3,2017,2017-09-30,4,2017,10969,1
Bureau,Department of the Interior,Geological Survey,null,100.0,100.0,0,0,92957,74,30,09,3,2017,2017-09-30,4,2017,92957,74
Bureau,Department of Commerce,NOAA,null,100.0,100.0,0,0,4061133,602,30,09,3,2017,2017-09-30,4,2017,4061133,602
Agency,National Foundation  Arts & Humanities,null,Non-CFO,0.0,0.0,0,0,0,0,30,09,3,2017,2017-09-30,4,2017,0,0
Bureau,Other Agencies,Comm. for Purchase from Blind/Handic.,null,0.0,0.0,8945,5,0,0,30,09,3,2017,2017-09-30,4,2017,8945,5
Bureau,Department of the Treasury,Bureau of Engraving and Printing,null,100.0,100.0,0,0,84528,1,30,09,3,2017,2017-09-30,4,2017,84528,1
Bureau,Department of the Treasury,Bureau of Public Debt,null,0.0,0.0,0,0,0,0,30,09,3,2017,2017-09-30,4,2017,0,0
Bureau,Other Agencies,Architect of the Capitol,null,0.0,0.0,162122,59,0,0,30,09,3,2017,2017-09-30,4,2017,162122,59
Bureau,Department of Commerce,Nat'l Telecomm & Information Admin.,null,0.0,0.0,0,0,0,0,31,12,4,2017,2017-12-31,1,2018,0,0
Bureau,Department of Transportation,Federal Highway Administration,null,99.54574434172777,100.0,57,0,12491,9,31,12,4,2017,2017-12-31,1,2018,12548,9
Agency,Office of Government Ethics,null,Non-CFO,0.0,0.0,0,0,0,0,31,12,4,2017,2017-12-31,1,2018,0,0
Bureau,Farm Credit Administration,Farm Credit System Insurance Corporation,null,0.0,0.0,0,0,0,0,31,12,4,2017,2017-12-31,1,2018,0,0
Bureau,Funds Appropriated to the President,Trade and Development Agency,null,0.0,0.0,0,0,0,0,31,12,4,2017,2017-12-31,1,2018,0,0
Bureau,Other Agencies,Denali Commission,null,0.0,0.0,0,0,0,0,31,12,4,2017,2017-12-31,1,2018,0,0
Bureau,Department of Health & Human Services,Administration for Community Living,null,0.0,0.0,0,0,0,0,31,12,4,2017,2017-12-31,1,2018,0,0
Bureau,National Foundation  Arts & Humanities,National Endowment for the Arts,null,0.0,0.0,0,0,0,0,31,12,4,2017,2017-12-31,1,2018,0,0
Bureau,National Labor Relations Board,National Labor Relations Board,null,0.0,0.0,0,0,0,0,31,12,4,2017,2017-12-31,1,2018,0,0
Bureau,Occupational Safety & Health Rev Comm,Occupational Safety & Health Rev Comm,null,0.0,0.0,0,0,0,0,31,12,4,2017,2017-12-31,1,2018,0,0
Bureau,Department of the Treasury,U.S. Treasury IG Office,null,0.0,0.0,0,0,0,0,31,12,4,2017,2017-12-31,1,2018,0,0
Bureau,Smithsonian Institution,National Gallery of Art,null,0.0,0.0,0,0,0,0,31,12,4,2017,2017-12-31,1,2018,0,0
Bureau,Department of Commerce,Economic and Statistical Analysis,null,0.0,0.0,0,0,0,0,31,12,4,2017,2017-12-31,1,2018,0,0
Bureau,Department of Justice,U.S. Marshals Service,null,0.0,0.0,0,0,0,0,31,12,4,2017,2017-12-31,1,2018,0,0
Bureau,Department of Health & Human Services,Office of the Inspector General,null,0.0,0.0,0,0,0,0,31,12,4,2017,2017-12-31,1,2018,0,0
Bureau,Other Agencies/Boards/Commissions,U.S.-China Security Review Commission,null,0.0,0.0,0,0,0,0,31,12,4,2017,2017-12-31,1,2018,0,0
Bureau,Department of Labor,Departmental Management,null,0.0,0.0,0,0,0,0,31,12,4,2017,2017-12-31,1,2018,0,0
Bureau,Department of State,Civil Monetary Penalties,null,0.0,0.0,0,0,0,0,31,12,4,2017,2017-12-31,1,2018,0,0
Bureau,Other Agencies,Commission On Fine Arts,null,0.0,0.0,0,0,0,0,31,12,4,2017,2017-12-31,1,2018,0,0
Bureau,National Foundation  Arts & Humanities,National Endowment for the Humanities,null,0.0,0.0,0,0,0,0,31,12,4,2017,2017-12-31,1,2018,0,0
Bureau,Department of the Treasury,Interest on Public Debt,null,0.0,0.0,0,0,0,0,31,12,4,2017,2017-12-31,1,2018,0,0
Bureau,Farm Credit Administration,Farm Credit Administration,null,0.0,0.0,0,0,0,0,31,12,4,2017,2017-12-31,1,2018,0,0
Agency,Small Business Administration,null,CFO,98.6439106577137,99.06648769262952,154202152,1071,11216888763,113657,31,12,4,2017,2017-12-31,1,2018,11371090915,114728
Bureau,Department of Education,Office of Postsecondary Education,null,0.0,0.0,0,0,0,0,31,12,4,2017,2017-12-31,1,2018,0,0
Bureau,Federal Election Commission,Federal Election Commission,null,98.33025478902881,95.71428571428571,9338,3,549909,67,31,12,4,2017,2017-12-31,1,2018,559247,70
Agency,Funds Appropriated to the President,null,Non-CFO,0.0,0.0,0,0,0,0,31,12,4,2017,2017-12-31,1,2018,0,0
Bureau,Merit Systems Protection Board,Merit Systems Protection Board,null,100.0,100.0,0,0,258,1,31,12,4,2017,2017-12-31,1,2018,258,1
Agency,National Credit Union Administration,null,Non-CFO,100.0,100.0,0,0,4821,2,31,12,4,2017,2017-12-31,1,2018,4821,2
Bureau,Department of the Treasury,Treasury IG for Tax Admin,null,0.0,0.0,0,0,0,0,31,12,4,2017,2017-12-31,1,2018,0,0
Bureau,Department of the Treasury,U.S. Mint,null,100.0,100.0,0,0,33782,8,31,12,4,2017,2017-12-31,1,2018,33782,8
Bureau,National Aeronautics and Space Administration,National Aeronautics and Space Admin,null,100.0,100.0,0,0,2491040,90,31,12,4,2017,2017-12-31,1,2018,2491040,90
Bureau,Funds Appropriated to the President,Executive Branch,null,0.0,0.0,0,0,0,0,31,12,4,2017,2017-12-31,1,2018,0,0
Bureau,Department of Justice,Drug Enforcement Administration,null,100.0,100.0,0,0,345626,19,31,12,4,2017,2017-12-31,1,2018,345626,19
Bureau,Consumer Product Safety Commission,Consumer Product Safety Commission,null,100.0,100.0,0,0,445,1,31,12,4,2017,2017-12-31,1,2018,445,1
Bureau,Department of Transportation,Federal Aviation Administration,null,96.76628052396019,95.52715654952077,134923,28,4037455,598,31,12,4,2017,2017-12-31,1,2018,4172378,626
Bureau,Department of Health & Human Services,National Institutes of Health,null,55.43919999694242,31.57894736842105,4313870,221,5366993,102,31,12,4,2017,2017-12-31,1,2018,9680863,323
Bureau,Department of Homeland Security,Office of Biometric Identity Management,null,0.0,0.0,0,0,0,0,31,12,4,2017,2017-12-31,1,2018,0,0
Bureau,Department of Homeland Security,Domestic Nuclear Detection Office,null,0.0,0.0,0,0,0,0,31,12,4,2017,2017-12-31,1,2018,0,0
Bureau,Department of Agriculture,Food and Nutrition Service,null,13.607758358899607,7.027540360873695,13157560,979,2072465,74,31,12,4,2017,2017-12-31,1,2018,15230025,1053
Bureau,Department of Labor,Employment Standards Administration,null,64.519117805247,49.51662799690642,45835427,5222,83348021,5122,31,12,4,2017,2017-12-31,1,2018,129183448,10344
Bureau,Department of Housing and Urban Development,Housing Programs,null,99.98540743678575,99.98357963875205,21253,1,145621426,6089,31,12,4,2017,2017-12-31,1,2018,145642679,6090
Bureau,Federal Communications Commission,Federal Communications Commission,null,100.0,100.0,0,0,204488064,11372,31,12,4,2017,2017-12-31,1,2018,204488064,11372
Bureau,Office of Personnel Management,Office of Personnel Management,null,99.50209354206328,98.04096170970614,90713,22,18128171,1101,31,12,4,2017,2017-12-31,1,2018,18218884,1123
Agency,Federal Deposit Insurance Corporation,null,Non-CFO,0.0,0.0,0,0,0,0,31,12,4,2017,2017-12-31,1,2018,0,0
Bureau,Environmental Protection Agency,Environmental Protection Agency,null,100.0,100.0,0,0,15738460,194,31,12,4,2017,2017-12-31,1,2018,15738460,194
Bureau,Department of Health & Human Services,Health Resources and Services Admin,null,100.0,100.0,0,0,90301135,540,31,12,4,2017,2017-12-31,1,2018,90301135,540
Agency,Merit Systems Protection Board,null,Non-CFO,100.0,100.0,0,0,258,1,31,12,4,2017,2017-12-31,1,2018,258,1
Agency,Consumer Product Safety Commission,null,Non-CFO,100.0,100.0,0,0,445,1,31,12,4,2017,2017-12-31,1,2018,445,1
Bureau,Department of Health & Human Services,Substance Abuse & Mental Health Admin.,null,100.0,100.0,0,0,656827,11,31,12,4,2017,2017-12-31,1,2018,656827,11
Bureau,Federal Trade Commission,Federal Trade Commission,null,100.0,100.0,0,0,483134768,56,31,12,4,2017,2017-12-31,1,2018,483134768,56
Bureau,Department of Veterans Affairs,Veterans Benefits,null,99.7613404578955,98.53610338282327,1289190,1689,538890343,113688,31,12,4,2017,2017-12-31,1,2018,540179533,115377
Bureau,Department of Veterans Affairs,Medical and Construction,null,52.92281844234489,61.005586941607916,268754320,2743108,302125905,4291510,31,12,4,2017,2017-12-31,1,2018,570880225,7034618
Bureau,Department of the Treasury,Departmental Offices,null,90.36409404444487,99.32885906040268,2003936,5,18792614,740,31,12,4,2017,2017-12-31,1,2018,20796550,745
Bureau,Department of Agriculture,Rural Development,null,99.99756375699302,99.98399077868852,14517,5,595862001,31227,31,12,4,2017,2017-12-31,1,2018,595876518,31232
Bureau,Department of Health & Human Services,Office of the Secretary,null,100.0,100.0,0,0,2630,4,31,12,4,2017,2017-12-31,1,2018,2630,4
Agency,Office of Personnel Management,null,CFO,99.50209354206328,98.04096170970614,90713,22,18128171,1101,31,12,4,2017,2017-12-31,1,2018,18218884,1123
Agency,Smithsonian Institution,null,Non-CFO,0.0,0.0,466,7,0,0,31,12,4,2017,2017-12-31,1,2018,466,7
Bureau,Armed Forces Retirement Home,Armed Forces Retirement Home,null,99.69020889583629,98.9010989010989,218,1,70152,90,31,12,4,2017,2017-12-31,1,2018,70370,91
Bureau,Railroad Retirement Board,Railroad Retirement Board,null,86.9950098744761,76.46109716744353,2725793,1313,18233800,4265,31,12,4,2017,2017-12-31,1,2018,20959593,5578
Bureau,Department of Agriculture,Farm Service Agency,null,99.99998612695877,99.99258655200533,100,1,720822381,13488,31,12,4,2017,2017-12-31,1,2018,720822481,13489
Bureau,Other Agencies,Council of Insps. Gen. of Intg. & Effy.,null,0.0,0.0,3096,3,0,0,31,12,4,2017,2017-12-31,1,2018,3096,3
Agency,Department of State,null,CFO,96.64678319055182,99.4908062234795,708083,108,20408446,21102,31,12,4,2017,2017-12-31,1,2018,21116529,21210
Agency,Agency for International Development,null,CFO,100.0,100.0,0,0,24263423,36,31,12,4,2017,2017-12-31,1,2018,24263423,36
Agency,Legis Branch-Library of Congress,null,Non-CFO,0.0,0.0,0,0,0,0,31,12,4,2017,2017-12-31,1,2018,0,0
Agency,U.S. Court of Appeals / Veterans Claims,null,Non-CFO,0.0,0.0,0,0,0,0,31,12,4,2017,2017-12-31,1,2018,0,0
Agency,Federal Mediation/Conciliation Service,null,Non-CFO,0.0,0.0,0,0,0,0,31,12,4,2017,2017-12-31,1,2018,0,0
Agency,Selective Service System,null,Non-CFO,0.0,0.0,1187,1,0,0,31,12,4,2017,2017-12-31,1,2018,1187,1
Bureau,National Credit Union Administration,Nat'l Credit Union Admin. Treasury Acct.,null,0.0,0.0,0,0,0,0,31,12,4,2017,2017-12-31,1,2018,0,0
Bureau,Department of the Treasury,Interest on Tax/Deposit of Earnings,null,100.0,100.0,0,0,3240,2,31,12,4,2017,2017-12-31,1,2018,3240,2
Agency,Department of the Interior,null,CFO,99.86589421917705,98.56127503769115,43517,334,32406240,22881,31,12,4,2017,2017-12-31,1,2018,32449757,23215
Agency,National Foundation  Arts & Humanities,null,Non-CFO,0.0,0.0,0,0,0,0,31,12,4,2017,2017-12-31,1,2018,0,0
Bureau,Federal Deposit Insurance Corporation,Federal Deposit Insurance Corporation,null,0.0,0.0,0,0,0,0,31,12,4,2017,2017-12-31,1,2018,0,0
Bureau,National Science Foundation,National Science Foundation,null,90.78792635796464,97.40259740259741,66194,2,652363,75,31,12,4,2017,2017-12-31,1,2018,718557,77
Bureau,Other Agencies,Federal Housing Finance Agency OIG,null,0.0,0.0,0,0,0,0,31,12,4,2017,2017-12-31,1,2018,0,0
Agency,Equal Employment Opportunity Commission,null,Non-CFO,100.0,100.0,0,0,26279,17,31,12,4,2017,2017-12-31,1,2018,26279,17
Agency,Department of the Treasury,null,CFO,93.23331042789899,99.75985591354812,2427454,12,33446129,4985,31,12,4,2017,2017-12-31,1,2018,35873583,4997
Agency,National Archives & Records Admin,null,Non-CFO,100.0,100.0,0,0,49995,90,31,12,4,2017,2017-12-31,1,2018,49995,90
Bureau,Other Agencies,Archit.&Trans. Barriers Compliance Bd,null,0.0,0.0,0,0,0,0,31,12,4,2017,2017-12-31,1,2018,0,0
Bureau,Department of the Interior,Bureau of Reclamation,null,100.0,100.0,0,0,92547,81,31,12,4,2017,2017-12-31,1,2018,92547,81
Agency,Department of Transportation,null,CFO,99.75816070263792,99.5026525198939,137764,30,56827337,6002,31,12,4,2017,2017-12-31,1,2018,56965101,6032
Agency,Department of Justice,null,CFO,99.18741516031025,99.40977056722562,607214,195,74119014,32843,31,12,4,2017,2017-12-31,1,2018,74726228,33038
Bureau,Other Agencies,U.S.  Agency of Global Media,null,52.536775743020115,16.666666666666668,4743,5,5250,1,31,12,4,2017,2017-12-31,1,2018,9993,6
Bureau,Department of Justice,Bureau of ATF and Explosives,null,100.0,100.0,0,0,12048,5,31,12,4,2017,2017-12-31,1,2018,12048,5
Bureau,Department of the Treasury,Community Dev Financial Inst Fund,null,86.07302695977486,83.33333333333333,421000,1,2601911,5,31,12,4,2017,2017-12-31,1,2018,3022911,6
Bureau,Department of Defense,Consolidated Report,null,54.01369871304381,21.823585534234766,1136170913,1146325,1334501616,320006,31,12,4,2017,2017-12-31,1,2018,2470672529,1466331
Bureau,Department of Labor,Mine Safety and Health Administration,null,97.79517584021423,99.50258153884901,1360666,79,60352464,15803,31,12,4,2017,2017-12-31,1,2018,61713130,15882
Bureau,Department of the Treasury,Spec Insp Gen-Troubled Asset Rel Prog,null,100.0,100.0,0,0,3916,1,31,12,4,2017,2017-12-31,1,2018,3916,1
Agency,Armed Forces Retirement Home,null,Non-CFO,99.69020889583629,98.9010989010989,218,1,70152,90,31,12,4,2017,2017-12-31,1,2018,70370,91
Agency,Legislative Branch-GPO,null,Non-CFO,0.0,0.0,123405,84,0,0,31,12,4,2017,2017-12-31,1,2018,123405,84
Agency,Department of Housing and Urban Development,null,CFO,99.98540743678575,99.98357963875205,21253,1,145621426,6089,31,12,4,2017,2017-12-31,1,2018,145642679,6090
Agency,Other Agencies/Boards/Commissions,null,Non-CFO,0.0,0.0,181226,4,0,0,31,12,4,2017,2017-12-31,1,2018,181226,4
Bureau,Department of Homeland Security,Info Analysis Infrastructure Prot-NPPD,null,100.0,100.0,0,0,4610,1,31,12,4,2017,2017-12-31,1,2018,4610,1
Agency,Department of Labor,null,CFO,80.99887021922294,82.57717342269768,48205970,5407,205494576,25627,31,12,4,2017,2017-12-31,1,2018,253700546,31034
Agency,Other Agencies,null,Non-CFO,1.1475359670558818,0.970873786407767,452252,102,5250,1,31,12,4,2017,2017-12-31,1,2018,457502,103
Bureau,Department of the Treasury,Treasury Forfeiture Fund,null,0.0,0.0,0,0,0,0,31,12,4,2017,2017-12-31,1,2018,0,0
Bureau,Department of Commerce,General Administration,null,100.0,100.0,0,0,4660,1,31,12,4,2017,2017-12-31,1,2018,4660,1
Agency,Department of Homeland Security,null,CFO,99.97255869153408,99.98681608437705,98824,8,360029776,60672,31,12,4,2017,2017-12-31,1,2018,360128600,60680
Agency,Federal Maritime Commission,null,Non-CFO,99.53722622202189,38.46153846153846,2197,8,472549,5,31,12,4,2017,2017-12-31,1,2018,474746,13
Bureau,Legislative Branch-GPO,Government Publishing Office,null,0.0,0.0,123405,84,0,0,31,12,4,2017,2017-12-31,1,2018,123405,84
Bureau,Social Security Administration,Social Security Administration,null,25.566057609340955,11.154781215862151,4776239190,2398406,1640509724,301127,31,12,4,2017,2017-12-31,1,2018,6416748914,2699533
Bureau,Department of Housing and Urban Development,Government National Mortgage Association,null,0.0,0.0,0,0,0,0,31,12,4,2017,2017-12-31,1,2018,0,0
Bureau,Department of Health & Human Services,Centers for Medicare & Medicaid Services,null,98.37280186618952,99.44845747887429,172219893,9387,10411610645,1692567,31,12,4,2017,2017-12-31,1,2018,10583830538,1701954
Agency,Federal Election Commission,null,Non-CFO,98.33025478902881,95.71428571428571,9338,3,549909,67,31,12,4,2017,2017-12-31,1,2018,559247,70
Bureau,National Credit Union Administration,National Credit Union Administration,null,100.0,100.0,0,0,4821,2,31,12,4,2017,2017-12-31,1,2018,4821,2
Bureau,Department of Agriculture,Federal Crop Insurance Corporation,null,100.0,100.0,0,0,139733,358,31,12,4,2017,2017-12-31,1,2018,139733,358
Bureau,Department of Transportation,Federal Motor Carrier Safety Admin,null,99.99338174218077,99.96236356793376,2784,2,42062667,5312,31,12,4,2017,2017-12-31,1,2018,42065451,5314
Agency,Presidio Trust Corporation,null,Non-CFO,98.5614487030153,95.0,19612,4,1343704,76,31,12,4,2017,2017-12-31,1,2018,1363316,80
Bureau,Department of the Treasury,Bureau of Engraving and Printing,null,100.0,100.0,0,0,84528,1,31,12,4,2017,2017-12-31,1,2018,84528,1
Bureau,Department of Agriculture,Agricultural Marketing Service,null,91.70737012478129,75.60975609756098,77775,150,860106,465,31,12,4,2017,2017-12-31,1,2018,937881,615
Agency,Department of Veterans Affairs,null,CFO,75.5180461975617,61.60669722649875,273148033,2745421,842563708,4405360,31,12,4,2017,2017-12-31,1,2018,1115711741,7150781
Bureau,Department of the Interior,Bureau of Safety and Environmental Enf.,null,0.0,0.0,0,0,0,0,31,12,4,2017,2017-12-31,1,2018,0,0
Bureau,Department of the Treasury,Comptroller of the Currency,null,99.93599221238584,85.71428571428571,768,4,1199086,24,31,12,4,2017,2017-12-31,1,2018,1199854,28
Bureau,Department of the Treasury,Internal Revenue Service,null,99.32769880906646,98.13084112149532,1750,2,258550,105,31,12,4,2017,2017-12-31,1,2018,260300,107
Agency,The Judiciary,null,Non-CFO,91.74791179185335,87.06896551724138,129993,30,1445281,202,31,12,4,2017,2017-12-31,1,2018,1575274,232
Agency,Pension Benefit Guaranty Corp,null,Non-CFO,100.0,100.0,0,0,2413022,856,31,12,4,2017,2017-12-31,1,2018,2413022,856
Agency,Department of Agriculture,null,CFO,97.8926706558137,93.23804640430714,32634593,4220,1515988696,58188,31,12,4,2017,2017-12-31,1,2018,1548623289,62408
Bureau,Department of Transportation,Maritime Administration,null,100.0,100.0,0,0,5745,5,31,12,4,2017,2017-12-31,1,2018,5745,5
Agency,Legislative Branch-CBO,null,Non-CFO,0.0,0.0,0,0,0,0,31,12,4,2017,2017-12-31,1,2018,0,0
Agency,Office of Special Counsel,null,Non-CFO,0.0,0.0,0,0,0,0,31,12,4,2017,2017-12-31,1,2018,0,0
Agency,Office of Compliance,null,Non-CFO,0.0,0.0,0,0,0,0,31,12,4,2017,2017-12-31,1,2018,0,0
Bureau,Other Agencies,National Mediation Board,null,0.0,0.0,0,0,0,0,31,12,4,2017,2017-12-31,1,2018,0,0
Bureau,Legislative Branch-Office of Tech.,Medicaid & CHIP Payment & Access Comm.,null,0.0,0.0,0,0,0,0,31,12,4,2017,2017-12-31,1,2018,0,0
Bureau,Other Agencies,Election Assistance Commission,null,0.0,0.0,0,0,0,0,31,12,4,2017,2017-12-31,1,2018,0,0
Bureau,Other Agencies,Millennium Challenge Corporation,null,0.0,0.0,0,0,0,0,31,12,4,2017,2017-12-31,1,2018,0,0
Agency,Department of Defense,null,CFO,54.01369871304381,21.823585534234766,1136170913,1146325,1334501616,320006,31,12,4,2017,2017-12-31,1,2018,2470672529,1466331
Agency,Corp. for National and Community Service,null,Non-CFO,98.91168566763763,92.98892988929889,38595,19,3507715,252,31,12,4,2017,2017-12-31,1,2018,3546310,271
Agency,Railroad Retirement Board,null,Non-CFO,86.9950098744761,76.46109716744353,2725793,1313,18233800,4265,31,12,4,2017,2017-12-31,1,2018,20959593,5578
Bureau,Department of Transportation,Research Innovative Technology Admin,null,100.0,100.0,0,0,6244,3,31,12,4,2017,2017-12-31,1,2018,6244,3
Bureau,Department of Veterans Affairs,Housing Credit Assistance,null,70.01804731601398,83.54430379746836,454697,13,1061872,66,31,12,4,2017,2017-12-31,1,2018,1516569,79
Bureau,Department of Homeland Security,Immigration and Customs Enforcement,null,94.16885437120763,98.34254143646409,95533,3,1542790,178,31,12,4,2017,2017-12-31,1,2018,1638323,181
Bureau,Department of Justice,Federal Bureau of Investigation,null,0.0,0.0,399920,118,0,0,31,12,4,2017,2017-12-31,1,2018,399920,118
Bureau,Small Business Administration,Small Business Administration,null,98.6439106577137,99.06648769262952,154202152,1071,11216888763,113657,31,12,4,2017,2017-12-31,1,2018,11371090915,114728
Agency,Overseas Private Investment Corp Accts,null,Non-CFO,0.0,0.0,36405765,4,0,0,31,12,4,2017,2017-12-31,1,2018,36405765,4
Agency,U.S. Postal Service,null,Non-CFO,82.10655577611016,85.84723283729713,9074314,6296,41638751,38190,31,12,4,2017,2017-12-31,1,2018,50713065,44486
Bureau,Legislative Branch-GAO,Government Accountability Office,null,0.0,0.0,0,0,0,0,31,12,4,2017,2017-12-31,1,2018,0,0
Agency,Federal Communications Commission,null,Non-CFO,100.0,100.0,0,0,204488064,11372,31,12,4,2017,2017-12-31,1,2018,204488064,11372
Bureau,Pension Benefit Guaranty Corp,Pension Benefit Guaranty Corporation,null,100.0,100.0,0,0,2413022,856,31,12,4,2017,2017-12-31,1,2018,2413022,856
Agency,Federal Trade Commission,null,Non-CFO,100.0,100.0,0,0,483134768,56,31,12,4,2017,2017-12-31,1,2018,483134768,56
Bureau,Department of Labor,Occupational Safety and Health Admin,null,97.62783860450688,97.61422462300247,1009877,106,41562142,4337,31,12,4,2017,2017-12-31,1,2018,42572019,4443
Bureau,Department of Health & Human Services,Indian Health Services,null,44.047136590432835,5.211979774406846,25710503,2437,20239787,134,31,12,4,2017,2017-12-31,1,2018,45950290,2571
Bureau,Department of Education,Federal Student Aid,null,62.52722464139899,57.2582140648456,53300023222,11010411,88936634490,14749886,31,12,4,2017,2017-12-31,1,2018,142236657712,25760297
Agency,Commodity Futures Trading Commission,null,Non-CFO,100.0,100.0,0,0,588764938,354,31,12,4,2017,2017-12-31,1,2018,588764938,354
Bureau,Department of Veterans Affairs,Life Insurance,null,100.0,100.0,0,0,464693,72,31,12,4,2017,2017-12-31,1,2018,464693,72
Agency,Securities & Exchange Commission,null,Non-CFO,100.0,100.0,0,0,1971282930,804,31,12,4,2017,2017-12-31,1,2018,1971282930,804
Bureau,Department of Commerce,Economic Development Administration,null,100.0,100.0,0,0,1307589,1,31,12,4,2017,2017-12-31,1,2018,1307589,1
Bureau,Department of Health & Human Services,Food and Drug Administration,null,39.9835723690954,18.064672988086556,30447294,3370,20284306,743,31,12,4,2017,2017-12-31,1,2018,50731600,4113
Bureau,Other Agencies,U.S. Institute of Peace,null,0.0,0.0,0,0,0,0,31,12,4,2017,2017-12-31,1,2018,0,0
Bureau,Department of Housing and Urban Development,Public and Indian Housing Programs,null,0.0,0.0,0,0,0,0,31,12,4,2017,2017-12-31,1,2018,0,0
Bureau,Department of Homeland Security,Office of the Inspector General DHS,null,100.0,100.0,0,0,506,2,31,12,4,2017,2017-12-31,1,2018,506,2
Bureau,Department of Labor,Employee Benefit Security Administration,null,100.0,100.0,0,0,16920981,361,31,12,4,2017,2017-12-31,1,2018,16920981,361
Bureau,Department of Health & Human Services,Administration for Children and Families,null,100.0,100.0,0,0,21445513,1196,31,12,4,2017,2017-12-31,1,2018,21445513,1196
Agency,General Services Administration,null,CFO,95.92631643804535,90.00912408759125,774878,438,18246678,3946,31,12,4,2017,2017-12-31,1,2018,19021556,4384
Bureau,Corp. for National and Community Service,Corp. for National and Community Service,null,98.91168566763763,92.98892988929889,38595,19,3507715,252,31,12,4,2017,2017-12-31,1,2018,3546310,271
Bureau,Office of Compliance,Office of Compliance,null,0.0,0.0,0,0,0,0,31,12,4,2017,2017-12-31,1,2018,0,0
Bureau,Department of Agriculture,Forest Service,null,83.97378372579112,23.34710743801653,9469062,1484,49615764,452,31,12,4,2017,2017-12-31,1,2018,59084826,1936
Agency,Federal Labor Relations Authority,null,Non-CFO,0.0,0.0,0,0,0,0,31,12,4,2017,2017-12-31,1,2018,0,0
Agency,Legislative Branch-GAO,null,Non-CFO,0.0,0.0,0,0,0,0,31,12,4,2017,2017-12-31,1,2018,0,0
Bureau,Department of Commerce,Minority Business Development Agency,null,0.0,0.0,0,0,0,0,31,12,4,2017,2017-12-31,1,2018,0,0
Bureau,Smithsonian Institution,Administrative Conference of the US,null,0.0,0.0,0,0,0,0,31,12,4,2017,2017-12-31,1,2018,0,0
Bureau,American Battle Monuments Commission,American Battle Monuments Commission,null,0.0,0.0,0,0,0,0,31,12,4,2017,2017-12-31,1,2018,0,0
Bureau,Other Agencies,National Transportation Safety Board,null,0.0,0.0,0,0,0,0,31,12,4,2017,2017-12-31,1,2018,0,0
Bureau,Other Agencies,Chemical Safety Board,null,0.0,0.0,0,0,0,0,31,12,4,2017,2017-12-31,1,2018,0,0
Bureau,Department of the Treasury,Tobacco Tax and Trade,null,100.0,100.0,0,0,1000,1,31,12,4,2017,2017-12-31,1,2018,1000,1
Bureau,Federal Maritime Commission,Salaries and Expenses,null,99.53722622202189,38.46153846153846,2197,8,472549,5,31,12,4,2017,2017-12-31,1,2018,474746,13
Bureau,Department of Homeland Security,U.S. Coast Guard,null,100.0,100.0,0,0,61862178,9558,31,12,4,2017,2017-12-31,1,2018,61862178,9558
Agency,National Science Foundation,null,CFO,90.78792635796464,97.40259740259741,66194,2,652363,75,31,12,4,2017,2017-12-31,1,2018,718557,77
Bureau,Department of Transportation,Surface Transportation Board,null,0.0,0.0,0,0,0,0,31,12,4,2017,2017-12-31,1,2018,0,0
Bureau,Department of Labor,Bureau of Labor Statistics,null,100.0,100.0,0,0,10969,1,31,12,4,2017,2017-12-31,1,2018,10969,1
Agency,Department of Health & Human Services,null,CFO,97.8456952393511,99.09674003620754,232799685,15457,10573456201,1695789,31,12,4,2017,2017-12-31,1,2018,10806255886,1711246
Bureau,Department of Justice,Federal Prison Industries,null,89.23443727645173,85.91549295774648,125842,30,1043089,183,31,12,4,2017,2017-12-31,1,2018,1168931,213
Bureau,Funds Appropriated to the President,Defense Security Assistance Agency,null,0.0,0.0,0,0,0,0,31,12,4,2017,2017-12-31,1,2018,0,0
Bureau,Department of the Treasury,Treasury Franchise Fund,null,0.0,0.0,0,0,0,0,31,12,4,2017,2017-12-31,1,2018,0,0
Bureau,Department of Transportation,Office of the Inspector General,null,0.0,0.0,0,0,0,0,31,12,4,2017,2017-12-31,1,2018,0,0
Bureau,Department of Homeland Security,Citizenship and Immigration Services,null,99.65482014147025,99.57947855340622,3291,5,950125,1184,31,12,4,2017,2017-12-31,1,2018,953416,1189
Bureau,Department of the Interior,Office of Natural Resources Revenue,null,100.0,100.0,0,0,1229640,245,31,12,4,2017,2017-12-31,1,2018,1229640,245
Bureau,Department of State,Department of State,null,96.17579802612076,97.90606653620353,707943,107,17804233,5003,31,12,4,2017,2017-12-31,1,2018,18512176,5110
Bureau,Other Agencies,Federal Housing Finance Agency,null,0.0,0.0,0,0,0,0,31,12,4,2017,2017-12-31,1,2018,0,0
Bureau,Department of the Treasury,Office of Financial Research,null,100.0,100.0,0,0,36,1,31,12,4,2017,2017-12-31,1,2018,36,1
Bureau,Department of Veterans Affairs,Administration and Cemeteries,null,0.7823729996506561,3.779527559055118,2649826,611,20895,24,31,12,4,2017,2017-12-31,1,2018,2670721,635
Bureau,Department of State,Passport NSF,null,99.99462438463603,99.99378881987577,140,1,2604213,16099,31,12,4,2017,2017-12-31,1,2018,2604353,16100
Bureau,U.S. Postal Service,U.S. Postal Service,null,82.10655577611016,85.84723283729713,9074314,6296,41638751,38190,31,12,4,2017,2017-12-31,1,2018,50713065,44486
Bureau,Department of Education,Departmental Management,null,99.05566489743887,95.69832402234637,5972630,77,626496711,1713,31,12,4,2017,2017-12-31,1,2018,632469341,1790
Bureau,Neighborhood Reinvestment Corporation,Neighborhood Reinvestment Corporation,null,0.0,0.0,0,0,0,0,31,12,4,2017,2017-12-31,1,2018,0,0
Bureau,Department of Transportation,Federal Railroad Administration,null,100.0,100.0,0,0,323852,21,31,12,4,2017,2017-12-31,1,2018,323852,21
Agency,Export - Import  Bank,null,Non-CFO,0.0,0.0,0,0,0,0,31,12,4,2017,2017-12-31,1,2018,0,0
Agency,Occupational Safety & Health Rev Comm,null,Non-CFO,0.0,0.0,0,0,0,0,31,12,4,2017,2017-12-31,1,2018,0,0
Bureau,Department of the Interior,Bureau of Indian Affairs,null,99.59174540869552,98.35378776677017,43517,334,10615763,19955,31,12,4,2017,2017-12-31,1,2018,10659280,20289
Bureau,Department of the Interior,Office of Surface Mining,null,100.0,100.0,0,0,1913481,223,31,12,4,2017,2017-12-31,1,2018,1913481,223
Bureau,Department of Health & Human Services,Centers for Disease Control,null,20.56816261763258,16.0,108125,42,27998,8,31,12,4,2017,2017-12-31,1,2018,136123,50
Bureau,Department of the Interior,Bureau of Land Management,null,100.0,100.0,0,0,12779699,302,31,12,4,2017,2017-12-31,1,2018,12779699,302
Agency,Environmental Protection Agency,null,CFO,100.0,100.0,0,0,15738460,194,31,12,4,2017,2017-12-31,1,2018,15738460,194
Bureau,Other Agencies,Delta Regional Authority,null,0.0,0.0,0,0,0,0,31,12,4,2017,2017-12-31,1,2018,0,0
Bureau,Other Agencies,Federal Mine Safety & Health Review Comm,null,0.0,0.0,0,0,0,0,31,12,4,2017,2017-12-31,1,2018,0,0
Bureau,Federal Labor Relations Authority,Federal Labor Relations Authority,null,0.0,0.0,0,0,0,0,31,12,4,2017,2017-12-31,1,2018,0,0
Bureau,Other Agencies,James Madison Memorial Fellowship,null,0.0,0.0,211899,24,0,0,31,12,4,2017,2017-12-31,1,2018,211899,24
Bureau,Department of Agriculture,U.S. Department of Agriculture,null,63.70838954259837,50.3428927680798,9818480,1593,17235927,1615,31,12,4,2017,2017-12-31,1,2018,27054407,3208
Bureau,Department of Housing and Urban Development,Community Planning and Development,null,0.0,0.0,0,0,0,0,31,12,4,2017,2017-12-31,1,2018,0,0
Bureau,Legis Branch-Library of Congress,Library of Congress,null,0.0,0.0,0,0,0,0,31,12,4,2017,2017-12-31,1,2018,0,0
Bureau,Legislative Branch-Office of Tech.,Open World Leadership,null,0.0,0.0,0,0,0,0,31,12,4,2017,2017-12-31,1,2018,0,0
Bureau,Department of Energy,Energy Consolidated Reports,null,100.0,100.0,0,0,22048659,87,31,12,4,2017,2017-12-31,1,2018,22048659,87
Agency,Tennessee Valley Authority,null,Non-CFO,0.0,0.0,0,0,0,0,31,12,4,2017,2017-12-31,1,2018,0,0
Bureau,Commodity Futures Trading Commission,Commodity Futures Trading Commission,null,100.0,100.0,0,0,588764938,354,31,12,4,2017,2017-12-31,1,2018,588764938,354
Bureau,Department of the Interior,Geological Survey,null,100.0,100.0,0,0,97947,84,31,12,4,2017,2017-12-31,1,2018,97947,84
Agency,Department of Education,null,CFO,62.68893290554989,57.26088495858274,53305995852,11010488,89563131201,14751599,31,12,4,2017,2017-12-31,1,2018,142869127053,25762087
Bureau,Department of Justice,Legal Activities,null,99.88587450864543,99.85573086131745,81452,47,71289106,32531,31,12,4,2017,2017-12-31,1,2018,71370558,32578
Agency,Legislative Branch-Office of Tech.,null,Non-CFO,0.0,0.0,0,0,0,0,31,12,4,2017,2017-12-31,1,2018,0,0
Bureau,Department of Commerce,Bureau of Industry and Security,null,100.0,100.0,0,0,2751,1,31,12,4,2017,2017-12-31,1,2018,2751,1
Agency,Department of Commerce,null,CFO,100.0,100.0,0,0,6708206,1273,31,12,4,2017,2017-12-31,1,2018,6708206,1273
Bureau,Other Agencies,National Capital Planning Commission,null,0.0,0.0,0,0,0,0,31,12,4,2017,2017-12-31,1,2018,0,0
Bureau,Federal Mediation/Conciliation Service,Federal Mediation/Conciliation Service,null,0.0,0.0,0,0,0,0,31,12,4,2017,2017-12-31,1,2018,0,0
Bureau,Equal Employment Opportunity Commission,Equal Employment Opportunity Commission,null,100.0,100.0,0,0,26279,17,31,12,4,2017,2017-12-31,1,2018,26279,17
Bureau,Department of Commerce,Nat'l Institute of Standards& Technology,null,100.0,100.0,0,0,676371,11,31,12,4,2017,2017-12-31,1,2018,676371,11
Bureau,General Services Administration,General Services Administration,null,95.92631643804535,90.00912408759125,774878,438,18246678,3946,31,12,4,2017,2017-12-31,1,2018,19021556,4384
Agency,Legislative Branch - U.S. House/Senate,null,Non-CFO,0.0,0.0,213241,204,0,0,31,12,4,2017,2017-12-31,1,2018,213241,204
Bureau,Other Agencies,Comm. for Purchase from Blind/Handic.,null,0.0,0.0,9337,6,0,0,31,12,4,2017,2017-12-31,1,2018,9337,6
Bureau,Department of Homeland Security,Emergency Preparedness & Resp,null,100.0,100.0,0,0,276900138,43912,31,12,4,2017,2017-12-31,1,2018,276900138,43912
Bureau,Department of Homeland Security,Federal Law Enforcement Training Ctr.,null,100.0,100.0,0,0,15146,5,31,12,4,2017,2017-12-31,1,2018,15146,5
Bureau,Presidio Trust Corporation,Presidio Trust Corporation,null,98.5614487030153,95.0,19612,4,1343704,76,31,12,4,2017,2017-12-31,1,2018,1363316,80
Bureau,Department of Transportation,National Highway Traffic Safety Admin.,null,100.0,100.0,0,0,7663681,4,31,12,4,2017,2017-12-31,1,2018,7663681,4
Bureau,Other Agencies,Morris K. Udall Scholarship,null,0.0,0.0,982,1,0,0,31,12,4,2017,2017-12-31,1,2018,982,1
Bureau,Department of Agriculture,Commodity Credit Corporation,null,99.92454697685996,99.91736390868712,97099,8,128590919,9673,31,12,4,2017,2017-12-31,1,2018,128688018,9681
Bureau,Department of the Interior,"Bureau of Ocean Energy Mgmt., Reg & Enf",null,100.0,100.0,0,0,166,1,31,12,4,2017,2017-12-31,1,2018,166,1
Bureau,Funds Appropriated to the President,African Development Foundation,null,0.0,0.0,0,0,0,0,31,12,4,2017,2017-12-31,1,2018,0,0
Bureau,Other Agencies,Gulf Coast Ecosystem Restoration Council,null,0.0,0.0,0,0,0,0,31,12,4,2017,2017-12-31,1,2018,0,0
Bureau,Legislative Branch - U.S. House/Senate,U.S. House of Representatives,null,0.0,0.0,213241,204,0,0,31,12,4,2017,2017-12-31,1,2018,213241,204
Bureau,The Judiciary,Administrative Office of the U.S. Courts,null,91.74791179185335,87.06896551724138,129993,30,1445281,202,31,12,4,2017,2017-12-31,1,2018,1575274,232
Agency,American Battle Monuments Commission,null,Non-CFO,0.0,0.0,0,0,0,0,31,12,4,2017,2017-12-31,1,2018,0,0
Bureau,Department of the Treasury,Office of Sec International Affairs,null,0.0,0.0,0,0,0,0,31,12,4,2017,2017-12-31,1,2018,0,0
Agency,Neighborhood Reinvestment Corporation,null,Non-CFO,0.0,0.0,0,0,0,0,31,12,4,2017,2017-12-31,1,2018,0,0
Bureau,Other Agencies/Boards/Commissions,Medicare Payment Advisory Commission,null,0.0,0.0,0,0,0,0,31,12,4,2017,2017-12-31,1,2018,0,0
Bureau,Department of the Interior,Office of the Secretary,null,100.0,100.0,0,0,17524,9,31,12,4,2017,2017-12-31,1,2018,17524,9
Bureau,Department of Health & Human Services,Program Support Center,null,100.0,100.0,0,0,3520367,484,31,12,4,2017,2017-12-31,1,2018,3520367,484
Bureau,Department of Homeland Security,Bureau of Customs & Border Protection,null,100.0,100.0,0,0,7269184,582,31,12,4,2017,2017-12-31,1,2018,7269184,582
Bureau,Overseas Private Investment Corp Accts,Overseas Private Investment Corp Accts,null,0.0,0.0,36405765,4,0,0,31,12,4,2017,2017-12-31,1,2018,36405765,4
Bureau,Department of Agriculture,Food Safety and Inspection Service,null,100.0,100.0,0,0,789400,836,31,12,4,2017,2017-12-31,1,2018,789400,836
Bureau,Legislative Branch-CBO,Congressional Budget Office,null,0.0,0.0,0,0,0,0,31,12,4,2017,2017-12-31,1,2018,0,0
Bureau,Department of the Treasury,International Monetary Funds,null,0.0,0.0,0,0,0,0,31,12,4,2017,2017-12-31,1,2018,0,0
Bureau,Other Agencies,District of Columbia Government,null,0.0,0.0,0,0,0,0,31,12,4,2017,2017-12-31,1,2018,0,0
Bureau,Department of the Treasury,Office of the Secretary,null,0.0,0.0,0,0,0,0,31,12,4,2017,2017-12-31,1,2018,0,0
Bureau,Selective Service System,Selective Service System,null,0.0,0.0,1187,1,0,0,31,12,4,2017,2017-12-31,1,2018,1187,1
Bureau,Department of the Treasury,Financial Crimes Enforcement Network,null,100.0,100.0,0,0,66477,3,31,12,4,2017,2017-12-31,1,2018,66477,3
Bureau,Department of the Treasury,Bureau of the Fiscal Service,null,100.0,100.0,0,0,10120208,4079,31,12,4,2017,2017-12-31,1,2018,10120208,4079
Bureau,National Archives & Records Admin,Nat'l Archives & Records Administration,null,100.0,100.0,0,0,49995,90,31,12,4,2017,2017-12-31,1,2018,49995,90
Bureau,Other Agencies,Defense Nuclear Facilities Safety Board,null,0.0,0.0,0,0,0,0,31,12,4,2017,2017-12-31,1,2018,0,0
Agency,National Labor Relations Board,null,Non-CFO,0.0,0.0,0,0,0,0,31,12,4,2017,2017-12-31,1,2018,0,0
Bureau,Tennessee Valley Authority,Tennessee Valley Authority,null,0.0,0.0,0,0,0,0,31,12,4,2017,2017-12-31,1,2018,0,0
Bureau,U.S. Court of Appeals / Veterans Claims,U.S. Court of Appeals / Veterans Claims,null,0.0,0.0,0,0,0,0,31,12,4,2017,2017-12-31,1,2018,0,0
Bureau,Department of Housing and Urban Development,"Policy, Development and Research",null,0.0,0.0,0,0,0,0,31,12,4,2017,2017-12-31,1,2018,0,0
Bureau,Other Agencies,U.S. Inst. for Env. Conflict Resolution,null,0.0,0.0,920,3,0,0,31,12,4,2017,2017-12-31,1,2018,920,3
Bureau,Department of Commerce,Patent and Trademark Office,null,100.0,100.0,0,0,265201,477,31,12,4,2017,2017-12-31,1,2018,265201,477
Bureau,Department of Transportation,Federal Transit Administration,null,100.0,100.0,0,0,784232,2,31,12,4,2017,2017-12-31,1,2018,784232,2
Bureau,Department of Commerce,National Technical Information Service,null,0.0,0.0,0,0,0,0,31,12,4,2017,2017-12-31,1,2018,0,0
Bureau,Nuclear Regulatory Commission,Nuclear Regulatory Commission,null,100.0,100.0,0,0,1225119,210,31,12,4,2017,2017-12-31,1,2018,1225119,210
Bureau,Department of Transportation,Office of the Secretary,null,100.0,100.0,0,0,1552973,24,31,12,4,2017,2017-12-31,1,2018,1552973,24
Bureau,Department of Homeland Security,Transportation Safety Administration,null,100.0,100.0,0,0,11485099,5250,31,12,4,2017,2017-12-31,1,2018,11485099,5250
Bureau,Agency for International Development,Agency for International Development,null,100.0,100.0,0,0,24263423,36,31,12,4,2017,2017-12-31,1,2018,24263423,36
Bureau,Export - Import  Bank,Export-Import Bank,null,0.0,0.0,0,0,0,0,31,12,4,2017,2017-12-31,1,2018,0,0
Bureau,Department of Homeland Security,U.S. Secret Service,null,0.0,0.0,0,0,0,0,31,12,4,2017,2017-12-31,1,2018,0,0
Bureau,Office of Government Ethics,Office of Government Ethics,null,0.0,0.0,0,0,0,0,31,12,4,2017,2017-12-31,1,2018,0,0
Bureau,Department of Commerce,International Trade Administration,null,0.0,0.0,0,0,0,0,31,12,4,2017,2017-12-31,1,2018,0,0
Bureau,Smithsonian Institution,JFK Center for the Performing Arts,null,0.0,0.0,0,0,0,0,31,12,4,2017,2017-12-31,1,2018,0,0
Agency,Farm Credit Administration,null,Non-CFO,0.0,0.0,0,0,0,0,31,12,4,2017,2017-12-31,1,2018,0,0
Bureau,Department of Housing and Urban Development,Management and Administration,null,0.0,0.0,0,0,0,0,31,12,4,2017,2017-12-31,1,2018,0,0
Bureau,Other Agencies,Advisory Council on Hist. Preservation,null,0.0,0.0,0,0,0,0,31,12,4,2017,2017-12-31,1,2018,0,0
Bureau,Funds Appropriated to the President,Inter-American Foundation,null,0.0,0.0,0,0,0,0,31,12,4,2017,2017-12-31,1,2018,0,0
Bureau,Other Agencies,U.S. Holocaust Memorial Council,null,0.0,0.0,0,0,0,0,31,12,4,2017,2017-12-31,1,2018,0,0
Bureau,Smithsonian Institution,Smithsonian Institution,null,0.0,0.0,466,7,0,0,31,12,4,2017,2017-12-31,1,2018,466,7
Bureau,Department of Homeland Security,Management Headquarters,null,0.0,0.0,0,0,0,0,31,12,4,2017,2017-12-31,1,2018,0,0
Bureau,Department of the Interior,Fish and Wildlife Service,null,100.0,100.0,0,0,551893,100,31,12,4,2017,2017-12-31,1,2018,551893,100
Bureau,Department of Commerce,Bureau of the Census,null,100.0,100.0,0,0,88214,143,31,12,4,2017,2017-12-31,1,2018,88214,143
Bureau,Department of Commerce,NOAA,null,100.0,100.0,0,0,4363420,639,31,12,4,2017,2017-12-31,1,2018,4363420,639
Bureau,Department of the Treasury,Bureau of Public Debt,null,0.0,0.0,0,0,0,0,31,12,4,2017,2017-12-31,1,2018,0,0
Bureau,Department of State,International Commissions,null,0.0,0.0,0,0,0,0,31,12,4,2017,2017-12-31,1,2018,0,0
Agency,Social Security Administration,null,CFO,25.566057609340955,11.154781215862151,4776239190,2398406,1640509724,301127,31,12,4,2017,2017-12-31,1,2018,6416748914,2699533
Bureau,Department of Transportation,St. Lawrence Seaway Development Corp.,null,0.0,0.0,0,0,0,0,31,12,4,2017,2017-12-31,1,2018,0,0
Bureau,Other Agencies,Surface Transportation Board,null,0.0,0.0,0,0,0,0,31,12,4,2017,2017-12-31,1,2018,0,0
Bureau,Department of Justice,Office of Justice Assistance Programs,null,100.0,100.0,0,0,774398,23,31,12,4,2017,2017-12-31,1,2018,774398,23
Bureau,Department of Commerce,Office of the Inspector General,null,0.0,0.0,0,0,0,0,31,12,4,2017,2017-12-31,1,2018,0,0
Bureau,Other Agencies,National Council on Disability,null,0.0,0.0,2086,1,0,0,31,12,4,2017,2017-12-31,1,2018,2086,1
Bureau,Department of Homeland Security,Office of Health Affairs,null,0.0,0.0,0,0,0,0,31,12,4,2017,2017-12-31,1,2018,0,0
Bureau,Department of the Treasury,D.C. Pension Program,null,100.0,100.0,0,0,280781,15,31,12,4,2017,2017-12-31,1,2018,280781,15
Bureau,Department of Homeland Security,Science and Technology,null,0.0,0.0,0,0,0,0,31,12,4,2017,2017-12-31,1,2018,0,0
Bureau,Other Agencies,Consumer Financial Protection Bureau,null,0.0,0.0,219189,59,0,0,31,12,4,2017,2017-12-31,1,2018,219189,59
Agency,Department of Energy,null,CFO,100.0,100.0,0,0,23165714,116,31,12,4,2017,2017-12-31,1,2018,23165714,116
Bureau,Department of Justice,General Administration,null,0.0,0.0,0,0,0,0,31,12,4,2017,2017-12-31,1,2018,0,0
Agency,National Aeronautics and Space Administration,null,CFO,100.0,100.0,0,0,2491040,90,31,12,4,2017,2017-12-31,1,2018,2491040,90
Bureau,Office of Special Counsel,Office of Special Counsel,null,0.0,0.0,0,0,0,0,31,12,4,2017,2017-12-31,1,2018,0,0
Bureau,Department of Labor,Employment and Training Administration,null,100.0,100.0,0,0,3299999,3,31,12,4,2017,2017-12-31,1,2018,3299999,3
Bureau,Department of the Interior,National Park Service,null,100.0,100.0,0,0,5107580,1881,31,12,4,2017,2017-12-31,1,2018,5107580,1881
Agency,Nuclear Regulatory Commission,null,CFO,100.0,100.0,0,0,1225119,210,31,12,4,2017,2017-12-31,1,2018,1225119,210
Bureau,Funds Appropriated to the President,Peace Corps,null,0.0,0.0,0,0,0,0,31,12,4,2017,2017-12-31,1,2018,0,0
Bureau,Department of Transportation,Pipeline Hazardous Material Safety Admin,null,100.0,100.0,0,0,377997,24,31,12,4,2017,2017-12-31,1,2018,377997,24
Bureau,Department of Energy,Bonneville Power Administration,null,100.0,100.0,0,0,1117055,29,31,12,4,2017,2017-12-31,1,2018,1117055,29
Bureau,Other Agencies,Architect of the Capitol,null,0.0,0.0,0,0,0,0,31,12,4,2017,2017-12-31,1,2018,0,0
Bureau,Securities & Exchange Commission,Securities and Exchange Commission,null,100.0,100.0,0,0,1971282930,804,31,12,4,2017,2017-12-31,1,2018,1971282930,804
Bureau,Other Agencies/Boards/Commissions,U.S. Comm. on Int. Religious Freedom,null,0.0,0.0,181226,4,0,0,31,12,4,2017,2017-12-31,1,2018,181226,4
Bureau,Department of Justice,Federal Prison System,null,100.0,100.0,0,0,654747,82,31,12,4,2017,2017-12-31,1,2018,654747,82
Bureau,Legislative Branch-GAO,Government Accountability Office,null,0.0,0.0,0,0,0,0,31,03,1,2018,2018-03-31,2,2018,0,0
Bureau,Other Agencies,Gulf Coast Ecosystem Restoration Council,null,0.0,0.0,0,0,0,0,31,03,1,2018,2018-03-31,2,2018,0,0
Bureau,Federal Labor Relations Authority,Federal Labor Relations Authority,null,0.0,0.0,0,0,0,0,31,03,1,2018,2018-03-31,2,2018,0,0
Bureau,Federal Mediation/Conciliation Service,Federal Mediation/Conciliation Service,null,0.0,0.0,0,0,0,0,31,03,1,2018,2018-03-31,2,2018,0,0
Bureau,Department of Labor,Departmental Management,null,0.0,0.0,0,0,0,0,31,03,1,2018,2018-03-31,2,2018,0,0
Bureau,Department of the Treasury,Bureau of Public Debt,null,0.0,0.0,0,0,0,0,31,03,1,2018,2018-03-31,2,2018,0,0
Bureau,Department of the Treasury,Comptroller of the Currency,null,99.80189066636379,71.42857142857143,1814,8,913842,20,31,03,1,2018,2018-03-31,2,2018,915656,28
Bureau,Selective Service System,Selective Service System,null,0.0,0.0,0,0,0,0,31,03,1,2018,2018-03-31,2,2018,0,0
Bureau,Other Agencies,U.S. Institute of Peace,null,0.0,0.0,0,0,0,0,31,03,1,2018,2018-03-31,2,2018,0,0
Bureau,Federal Deposit Insurance Corporation,Federal Deposit Insurance Corporation,null,0.0,0.0,0,0,0,0,31,03,1,2018,2018-03-31,2,2018,0,0
Bureau,Department of the Treasury,U.S. Treasury IG Office,null,0.0,0.0,0,0,0,0,31,03,1,2018,2018-03-31,2,2018,0,0
Bureau,Other Agencies,National Mediation Board,null,0.0,0.0,0,0,0,0,31,03,1,2018,2018-03-31,2,2018,0,0
Bureau,Department of Commerce,Bureau of the Census,null,100.0,100.0,0,0,157763,224,31,03,1,2018,2018-03-31,2,2018,157763,224
Agency,Office of Personnel Management,null,CFO,90.56225601800197,89.00565885206144,1889187,136,18128171,1101,31,03,1,2018,2018-03-31,2,2018,20017358,1237
Agency,Department of the Interior,null,CFO,99.82148047750898,98.41702860834918,58652,441,32796018,27418,31,03,1,2018,2018-03-31,2,2018,32854670,27859
Agency,Department of the Treasury,null,CFO,93.375768624596,99.63349825911673,2409319,20,33961980,5437,31,03,1,2018,2018-03-31,2,2018,36371299,5457
Agency,Department of Transportation,null,CFO,99.88543278178238,99.64610717896865,65627,21,57216902,5913,31,03,1,2018,2018-03-31,2,2018,57282529,5934
Agency,Department of Housing and Urban Development,null,CFO,99.8370775621726,99.9009900990099,239738,6,146908809,6054,31,03,1,2018,2018-03-31,2,2018,147148547,6060
Agency,Department of Agriculture,null,CFO,97.88190136944263,90.89618487968804,32398784,5066,1497217615,50581,31,03,1,2018,2018-03-31,2,2018,1529616399,55647
Agency,Export - Import  Bank,null,Non-CFO,0.0,0.0,0,0,0,0,31,03,1,2018,2018-03-31,2,2018,0,0
Agency,Federal Deposit Insurance Corporation,null,Non-CFO,0.0,0.0,0,0,0,0,31,03,1,2018,2018-03-31,2,2018,0,0
Agency,Funds Appropriated to the President,null,Non-CFO,0.0,0.0,0,0,0,0,31,03,1,2018,2018-03-31,2,2018,0,0
Agency,Office of Special Counsel,null,Non-CFO,0.0,0.0,0,0,0,0,31,03,1,2018,2018-03-31,2,2018,0,0
Agency,Farm Credit Administration,null,Non-CFO,100.0,100.0,0,0,586,1,31,03,1,2018,2018-03-31,2,2018,586,1
Bureau,Funds Appropriated to the President,Executive Branch,null,0.0,0.0,0,0,0,0,31,03,1,2018,2018-03-31,2,2018,0,0
Bureau,Smithsonian Institution,Administrative Conference of the US,null,0.0,0.0,0,0,0,0,31,03,1,2018,2018-03-31,2,2018,0,0
Bureau,Other Agencies,Architect of the Capitol,null,0.0,0.0,0,0,0,0,31,03,1,2018,2018-03-31,2,2018,0,0
Bureau,Department of the Treasury,Treasury Forfeiture Fund,null,0.0,0.0,0,0,0,0,31,03,1,2018,2018-03-31,2,2018,0,0
Agency,Department of State,null,CFO,99.63089829573799,99.91520351157223,74107,17,20003557,20031,31,03,1,2018,2018-03-31,2,2018,20077664,20048
Agency,Social Security Administration,null,CFO,25.37517664492625,10.799193136607116,4824906944,2400317,1640645304,290597,31,03,1,2018,2018-03-31,2,2018,6465552248,2690914
Bureau,Department of Commerce,Nat'l Telecomm & Information Admin.,null,0.0,0.0,0,0,0,0,31,03,1,2018,2018-03-31,2,2018,0,0
Bureau,National Labor Relations Board,National Labor Relations Board,null,0.0,0.0,0,0,0,0,31,03,1,2018,2018-03-31,2,2018,0,0
Bureau,Department of Housing and Urban Development,Community Planning and Development,null,0.0,0.0,0,0,0,0,31,03,1,2018,2018-03-31,2,2018,0,0
Bureau,Department of Housing and Urban Development,Government National Mortgage Association,null,0.0,0.0,0,0,0,0,31,03,1,2018,2018-03-31,2,2018,0,0
Agency,Equal Employment Opportunity Commission,null,Non-CFO,52.64676320589658,39.62264150943396,25441,32,28285,21,31,03,1,2018,2018-03-31,2,2018,53726,53
Bureau,Other Agencies/Boards/Commissions,U.S.-China Security Review Commission,null,0.0,0.0,0,0,0,0,31,03,1,2018,2018-03-31,2,2018,0,0
Agency,Department of Justice,null,CFO,99.1213100724262,99.39674059845734,662113,201,74690179,33118,31,03,1,2018,2018-03-31,2,2018,75352292,33319
Agency,Department of Defense,null,CFO,53.20074699014271,20.4453852214035,1164546177,1218830,1323840073,313237,31,03,1,2018,2018-03-31,2,2018,2488386250,1532067
Agency,National Labor Relations Board,null,Non-CFO,0.0,0.0,0,0,0,0,31,03,1,2018,2018-03-31,2,2018,0,0
Agency,Armed Forces Retirement Home,null,Non-CFO,95.57883837214055,93.75,3245,6,70152,90,31,03,1,2018,2018-03-31,2,2018,73397,96
Bureau,Department of State,Civil Monetary Penalties,null,0.0,0.0,0,0,0,0,31,03,1,2018,2018-03-31,2,2018,0,0
Bureau,Other Agencies,Defense Nuclear Facilities Safety Board,null,0.0,0.0,0,0,0,0,31,03,1,2018,2018-03-31,2,2018,0,0
Bureau,Department of Justice,General Administration,null,0.0,0.0,0,0,0,0,31,03,1,2018,2018-03-31,2,2018,0,0
Bureau,Railroad Retirement Board,Railroad Retirement Board,null,96.02788784937641,97.71668219944083,743214,98,17967587,4194,31,03,1,2018,2018-03-31,2,2018,18710801,4292
Bureau,Farm Credit Administration,Farm Credit Administration,null,100.0,100.0,0,0,586,1,31,03,1,2018,2018-03-31,2,2018,586,1
Bureau,Other Agencies,Federal Housing Finance Agency,null,100.0,100.0,0,0,3910,1,31,03,1,2018,2018-03-31,2,2018,3910,1
Bureau,Department of the Treasury,Spec Insp Gen-Troubled Asset Rel Prog,null,100.0,100.0,0,0,3916,1,31,03,1,2018,2018-03-31,2,2018,3916,1
Bureau,Department of the Treasury,Financial Crimes Enforcement Network,null,100.0,100.0,0,0,65360,3,31,03,1,2018,2018-03-31,2,2018,65360,3
Bureau,Department of Health & Human Services,Centers for Disease Control,null,15.730908390245991,22.727272727272727,157445,34,29391,10,31,03,1,2018,2018-03-31,2,2018,186836,44
Bureau,Department of Commerce,Nat'l Institute of Standards& Technology,null,100.0,100.0,0,0,672689,11,31,03,1,2018,2018-03-31,2,2018,672689,11
Bureau,Department of Agriculture,Food Safety and Inspection Service,null,100.0,100.0,0,0,802529,819,31,03,1,2018,2018-03-31,2,2018,802529,819
Agency,Office of Compliance,null,Non-CFO,0.0,0.0,0,0,0,0,31,03,1,2018,2018-03-31,2,2018,0,0
Bureau,Department of Agriculture,Agricultural Marketing Service,null,87.43618173250968,76.33711507293354,126119,146,877708,471,31,03,1,2018,2018-03-31,2,2018,1003827,617
Bureau,Department of Housing and Urban Development,Housing Programs,null,99.8370775621726,99.9009900990099,239738,6,146908809,6054,31,03,1,2018,2018-03-31,2,2018,147148547,6060
Bureau,Department of Education,Departmental Management,null,95.61860085236435,96.08167770419426,29148256,71,636124526,1741,31,03,1,2018,2018-03-31,2,2018,665272782,1812
Bureau,Department of Defense,Consolidated Report,null,53.20074699014271,20.4453852214035,1164546177,1218830,1323840073,313237,31,03,1,2018,2018-03-31,2,2018,2488386250,1532067
Bureau,Social Security Administration,Social Security Administration,null,25.37517664492625,10.799193136607116,4824906944,2400317,1640645304,290597,31,03,1,2018,2018-03-31,2,2018,6465552248,2690914
Agency,Department of Health & Human Services,null,CFO,98.08428880677845,99.11023727959842,214426317,15545,10978613519,1731550,31,03,1,2018,2018-03-31,2,2018,11193039836,1747095
Agency,Legislative Branch-GPO,null,Non-CFO,0.0,0.0,132192,95,0,0,31,03,1,2018,2018-03-31,2,2018,132192,95
Agency,Other Agencies,null,Non-CFO,1.6564434928534228,1.9047619047619047,543832,103,9160,2,31,03,1,2018,2018-03-31,2,2018,552992,105
Bureau,Merit Systems Protection Board,Merit Systems Protection Board,null,100.0,100.0,0,0,258,1,31,03,1,2018,2018-03-31,2,2018,258,1
Bureau,Smithsonian Institution,Smithsonian Institution,null,0.0,0.0,0,0,0,0,31,03,1,2018,2018-03-31,2,2018,0,0
Bureau,Legislative Branch-Office of Tech.,Medicaid & CHIP Payment & Access Comm.,null,0.0,0.0,0,0,0,0,31,03,1,2018,2018-03-31,2,2018,0,0
Bureau,Department of the Treasury,Office of Financial Research,null,0.0,0.0,0,0,0,0,31,03,1,2018,2018-03-31,2,2018,0,0
Bureau,Department of Transportation,Maritime Administration,null,100.0,100.0,0,0,5948,5,31,03,1,2018,2018-03-31,2,2018,5948,5
Bureau,Department of Veterans Affairs,Housing Credit Assistance,null,58.44224608343602,80.59701492537313,590224,13,830026,54,31,03,1,2018,2018-03-31,2,2018,1420250,67
Agency,U.S. Court of Appeals / Veterans Claims,null,Non-CFO,0.0,0.0,0,0,0,0,31,03,1,2018,2018-03-31,2,2018,0,0
Agency,Presidio Trust Corporation,null,Non-CFO,97.29221153149716,92.70833333333333,37759,7,1356700,89,31,03,1,2018,2018-03-31,2,2018,1394459,96
Agency,The Judiciary,null,Non-CFO,97.38113734950507,97.58064516129032,42273,6,1571901,242,31,03,1,2018,2018-03-31,2,2018,1614174,248
Bureau,Department of State,Department of State,null,99.58144619515086,99.68114786767636,73967,16,17598074,5002,31,03,1,2018,2018-03-31,2,2018,17672041,5018
Bureau,Department of Agriculture,Food and Nutrition Service,null,1.6174594902807518,1.791359325605901,18405082,932,302589,17,31,03,1,2018,2018-03-31,2,2018,18707671,949
Bureau,Office of Compliance,Office of Compliance,null,0.0,0.0,0,0,0,0,31,03,1,2018,2018-03-31,2,2018,0,0
Bureau,Department of the Treasury,Office of Sec International Affairs,null,0.0,0.0,0,0,0,0,31,03,1,2018,2018-03-31,2,2018,0,0
Bureau,Department of State,Passport NSF,null,99.99418030173473,99.99334664005323,140,1,2405483,15029,31,03,1,2018,2018-03-31,2,2018,2405623,15030
Agency,National Archives & Records Admin,null,Non-CFO,100.0,100.0,0,0,44412,134,31,03,1,2018,2018-03-31,2,2018,44412,134
Agency,Pension Benefit Guaranty Corp,null,Non-CFO,100.0,100.0,0,0,2443832,825,31,03,1,2018,2018-03-31,2,2018,2443832,825
Bureau,Funds Appropriated to the President,Defense Security Assistance Agency,null,0.0,0.0,0,0,0,0,31,03,1,2018,2018-03-31,2,2018,0,0
Bureau,Department of Education,Office of Postsecondary Education,null,0.0,0.0,0,0,0,0,31,03,1,2018,2018-03-31,2,2018,0,0
Bureau,Department of Homeland Security,U.S. Secret Service,null,0.0,0.0,0,0,0,0,31,03,1,2018,2018-03-31,2,2018,0,0
Bureau,Department of Commerce,Bureau of Industry and Security,null,0.0,0.0,0,0,0,0,31,03,1,2018,2018-03-31,2,2018,0,0
Bureau,Department of Commerce,Economic and Statistical Analysis,null,0.0,0.0,0,0,0,0,31,03,1,2018,2018-03-31,2,2018,0,0
Bureau,National Aeronautics and Space Administration,National Aeronautics and Space Admin,null,99.99932068447832,92.15686274509804,17,8,2502502,94,31,03,1,2018,2018-03-31,2,2018,2502519,102
Agency,Small Business Administration,null,CFO,97.64118226815528,98.48972195972014,270395205,1742,11192771336,113601,31,03,1,2018,2018-03-31,2,2018,11463166541,115343
Bureau,Department of Labor,Bureau of Labor Statistics,null,100.0,100.0,0,0,10969,1,31,03,1,2018,2018-03-31,2,2018,10969,1
Bureau,Department of the Interior,Bureau of Reclamation,null,100.0,100.0,0,0,91289,80,31,03,1,2018,2018-03-31,2,2018,91289,80
Bureau,Department of the Treasury,Internal Revenue Service,null,99.34678115114416,98.3739837398374,1749,2,266002,121,31,03,1,2018,2018-03-31,2,2018,267751,123
Bureau,Department of Health & Human Services,Indian Health Services,null,47.512188568280905,4.702529390808692,20268424,2675,18347063,132,31,03,1,2018,2018-03-31,2,2018,38615487,2807
Bureau,Department of Labor,Occupational Safety and Health Admin,null,97.0573227295344,97.46067415730337,1260121,113,41562142,4337,31,03,1,2018,2018-03-31,2,2018,42822263,4450
Bureau,Department of Veterans Affairs,Medical and Construction,null,85.06284153040738,98.47175868961908,91403854,118516,520518783,7636542,31,03,1,2018,2018-03-31,2,2018,611922637,7755058
Agency,Corp. for National and Community Service,null,Non-CFO,99.61534348323497,93.7956204379562,13560,17,3511663,257,31,03,1,2018,2018-03-31,2,2018,3525223,274
Bureau,Farm Credit Administration,Farm Credit System Insurance Corporation,null,0.0,0.0,0,0,0,0,31,03,1,2018,2018-03-31,2,2018,0,0
Bureau,Other Agencies,U.S.  Agency of Global Media,null,44.65045075693145,14.285714285714286,6508,6,5250,1,31,03,1,2018,2018-03-31,2,2018,11758,7
Bureau,Department of Transportation,Pipeline Hazardous Material Safety Admin,null,100.0,100.0,0,0,372464,23,31,03,1,2018,2018-03-31,2,2018,372464,23
Bureau,Department of Transportation,Federal Aviation Administration,null,98.42180967320925,97.52475247524752,64669,15,4032999,591,31,03,1,2018,2018-03-31,2,2018,4097668,606
Agency,Legis Branch-Library of Congress,null,Non-CFO,0.0,0.0,0,0,0,0,31,03,1,2018,2018-03-31,2,2018,0,0
Agency,Smithsonian Institution,null,Non-CFO,0.0,0.0,0,0,0,0,31,03,1,2018,2018-03-31,2,2018,0,0
Bureau,Agency for International Development,Agency for International Development,null,99.44129100137289,93.47826086956522,154306,3,27464007,43,31,03,1,2018,2018-03-31,2,2018,27618313,46
Agency,Railroad Retirement Board,null,Non-CFO,96.02788784937641,97.71668219944083,743214,98,17967587,4194,31,03,1,2018,2018-03-31,2,2018,18710801,4292
Agency,Office of Government Ethics,null,Non-CFO,0.0,0.0,0,0,0,0,31,03,1,2018,2018-03-31,2,2018,0,0
Bureau,Department of Housing and Urban Development,"Policy, Development and Research",null,0.0,0.0,0,0,0,0,31,03,1,2018,2018-03-31,2,2018,0,0
Agency,U.S. Postal Service,null,Non-CFO,80.56015254244113,89.29029804629938,10041577,4506,41613031,37568,31,03,1,2018,2018-03-31,2,2018,51654608,42074
Agency,Federal Communications Commission,null,Non-CFO,100.0,100.0,0,0,225000329,11896,31,03,1,2018,2018-03-31,2,2018,225000329,11896
Agency,Federal Trade Commission,null,Non-CFO,100.0,100.0,0,0,483134767,56,31,03,1,2018,2018-03-31,2,2018,483134767,56
Bureau,Department of Commerce,International Trade Administration,null,0.0,0.0,0,0,0,0,31,03,1,2018,2018-03-31,2,2018,0,0
Bureau,U.S. Court of Appeals / Veterans Claims,U.S. Court of Appeals / Veterans Claims,null,0.0,0.0,0,0,0,0,31,03,1,2018,2018-03-31,2,2018,0,0
Bureau,Department of Health & Human Services,Centers for Medicare & Medicaid Services,null,98.28406998821252,99.42071071374538,188854106,10070,10817078811,1728267,31,03,1,2018,2018-03-31,2,2018,11005932917,1738337
Bureau,Department of Commerce,National Technical Information Service,null,0.0,0.0,0,0,0,0,31,03,1,2018,2018-03-31,2,2018,0,0
Bureau,Small Business Administration,Small Business Administration,null,97.64118226815528,98.48972195972014,270395205,1742,11192771336,113601,31,03,1,2018,2018-03-31,2,2018,11463166541,115343
Bureau,Consumer Product Safety Commission,Consumer Product Safety Commission,null,100.0,100.0,0,0,450,1,31,03,1,2018,2018-03-31,2,2018,450,1
Bureau,Department of Health & Human Services,National Institutes of Health,null,51.302884266346,28.97196261682243,4762388,228,5017222,93,31,03,1,2018,2018-03-31,2,2018,9779610,321
Bureau,Neighborhood Reinvestment Corporation,Neighborhood Reinvestment Corporation,null,0.0,0.0,0,0,0,0,31,03,1,2018,2018-03-31,2,2018,0,0
Agency,Overseas Private Investment Corp Accts,null,Non-CFO,0.0,0.0,0,0,0,0,31,03,1,2018,2018-03-31,2,2018,0,0
Agency,Selective Service System,null,Non-CFO,0.0,0.0,0,0,0,0,31,03,1,2018,2018-03-31,2,2018,0,0
Agency,Merit Systems Protection Board,null,Non-CFO,100.0,100.0,0,0,258,1,31,03,1,2018,2018-03-31,2,2018,258,1
Agency,Commodity Futures Trading Commission,null,Non-CFO,100.0,100.0,0,0,591060271,354,31,03,1,2018,2018-03-31,2,2018,591060271,354
Bureau,Department of the Treasury,Tobacco Tax and Trade,null,100.0,100.0,0,0,1000,1,31,03,1,2018,2018-03-31,2,2018,1000,1
Bureau,Department of Justice,Federal Bureau of Investigation,null,2.277194171467299,5.154639175257732,389313,92,9072,5,31,03,1,2018,2018-03-31,2,2018,398385,97
Agency,Securities & Exchange Commission,null,Non-CFO,100.0,100.0,0,0,1870637844,778,31,03,1,2018,2018-03-31,2,2018,1870637844,778
Bureau,Department of Commerce,Minority Business Development Agency,null,0.0,0.0,0,0,0,0,31,03,1,2018,2018-03-31,2,2018,0,0
Bureau,Department of Labor,Mine Safety and Health Administration,null,95.92253621088499,97.42830712303423,2572658,417,60521906,15798,31,03,1,2018,2018-03-31,2,2018,63094564,16215
Bureau,Department of Homeland Security,Office of the Inspector General DHS,null,100.0,100.0,0,0,1332,3,31,03,1,2018,2018-03-31,2,2018,1332,3
Bureau,Department of Justice,Legal Activities,null,99.65299686295958,99.6989875034206,249724,99,71716196,32790,31,03,1,2018,2018-03-31,2,2018,71965920,32889
Bureau,Office of Government Ethics,Office of Government Ethics,null,0.0,0.0,0,0,0,0,31,03,1,2018,2018-03-31,2,2018,0,0
Bureau,Department of the Interior,Office of the Secretary,null,100.0,100.0,0,0,17464,9,31,03,1,2018,2018-03-31,2,2018,17464,9
Bureau,Department of the Treasury,Community Dev Financial Inst Fund,null,89.27775388962503,85.71428571428571,391000,1,3255624,6,31,03,1,2018,2018-03-31,2,2018,3646624,7
Agency,Consumer Product Safety Commission,null,Non-CFO,100.0,100.0,0,0,450,1,31,03,1,2018,2018-03-31,2,2018,450,1
Bureau,Federal Maritime Commission,Salaries and Expenses,null,99.5296788842037,38.46153846153846,2233,8,472549,5,31,03,1,2018,2018-03-31,2,2018,474782,13
Bureau,National Archives & Records Admin,Nat'l Archives & Records Administration,null,100.0,100.0,0,0,44412,134,31,03,1,2018,2018-03-31,2,2018,44412,134
Bureau,Department of Veterans Affairs,Veterans Benefits,null,99.759997733107,98.50955313020269,1288260,1692,535481670,111831,31,03,1,2018,2018-03-31,2,2018,536769930,113523
Agency,Other Agencies/Boards/Commissions,null,Non-CFO,0.0,0.0,864,1,0,0,31,03,1,2018,2018-03-31,2,2018,864,1
Bureau,Department of Justice,U.S. Marshals Service,null,0.0,0.0,1775,1,0,0,31,03,1,2018,2018-03-31,2,2018,1775,1
Bureau,Department of Agriculture,Rural Development,null,99.9970501785681,99.97121473805412,17204,7,583204540,24311,31,03,1,2018,2018-03-31,2,2018,583221744,24318
Agency,National Aeronautics and Space Administration,null,CFO,99.99932068447832,92.15686274509804,17,8,2502502,94,31,03,1,2018,2018-03-31,2,2018,2502519,102
Agency,Department of Commerce,null,CFO,100.0,100.0,0,0,6249203,1322,31,03,1,2018,2018-03-31,2,2018,6249203,1322
Bureau,Department of Homeland Security,Office of Health Affairs,null,0.0,0.0,0,0,0,0,31,03,1,2018,2018-03-31,2,2018,0,0
Agency,Environmental Protection Agency,null,CFO,100.0,100.0,0,0,15789174,203,31,03,1,2018,2018-03-31,2,2018,15789174,203
Bureau,Other Agencies,U.S. Inst. for Env. Conflict Resolution,null,0.0,0.0,2528,7,0,0,31,03,1,2018,2018-03-31,2,2018,2528,7
Bureau,Armed Forces Retirement Home,Armed Forces Retirement Home,null,95.57883837214055,93.75,3245,6,70152,90,31,03,1,2018,2018-03-31,2,2018,73397,96
Agency,National Credit Union Administration,null,Non-CFO,100.0,100.0,0,0,4821,2,31,03,1,2018,2018-03-31,2,2018,4821,2
Agency,Federal Election Commission,null,Non-CFO,100.0,100.0,0,0,601395,77,31,03,1,2018,2018-03-31,2,2018,601395,77
Bureau,Department of Transportation,Federal Motor Carrier Safety Admin,null,99.99774285629331,99.88553987027852,958,6,42442064,5236,31,03,1,2018,2018-03-31,2,2018,42443022,5242
Bureau,Department of Health & Human Services,Office of the Secretary,null,100.0,100.0,0,0,4256,6,31,03,1,2018,2018-03-31,2,2018,4256,6
Bureau,National Credit Union Administration,National Credit Union Administration,null,100.0,100.0,0,0,4821,2,31,03,1,2018,2018-03-31,2,2018,4821,2
Bureau,Department of Justice,Drug Enforcement Administration,null,100.0,100.0,0,0,345891,20,31,03,1,2018,2018-03-31,2,2018,345891,20
Agency,Department of Energy,null,CFO,100.0,100.0,0,0,36761358,119,31,03,1,2018,2018-03-31,2,2018,36761358,119
Bureau,Federal Election Commission,Federal Election Commission,null,100.0,100.0,0,0,601395,77,31,03,1,2018,2018-03-31,2,2018,601395,77
Bureau,Funds Appropriated to the President,Peace Corps,null,0.0,0.0,0,0,0,0,31,03,1,2018,2018-03-31,2,2018,0,0
Bureau,Tennessee Valley Authority,Tennessee Valley Authority,null,0.0,0.0,0,0,0,0,31,03,1,2018,2018-03-31,2,2018,0,0
Bureau,Department of Energy,Bonneville Power Administration,null,100.0,100.0,0,0,1107158,30,31,03,1,2018,2018-03-31,2,2018,1107158,30
Agency,Department of Labor,null,CFO,83.10913983524105,74.03617601020349,41988654,8957,206599361,25541,31,03,1,2018,2018-03-31,2,2018,248588015,34498
Bureau,Department of Commerce,Patent and Trademark Office,null,100.0,100.0,0,0,319974,498,31,03,1,2018,2018-03-31,2,2018,319974,498
Bureau,Department of Housing and Urban Development,Management and Administration,null,0.0,0.0,0,0,0,0,31,03,1,2018,2018-03-31,2,2018,0,0
Bureau,Other Agencies,Chemical Safety Board,null,0.0,0.0,3997,1,0,0,31,03,1,2018,2018-03-31,2,2018,3997,1
Agency,Agency for International Development,null,CFO,99.44129100137289,93.47826086956522,154306,3,27464007,43,31,03,1,2018,2018-03-31,2,2018,27618313,46
Agency,Federal Maritime Commission,null,Non-CFO,99.5296788842037,38.46153846153846,2233,8,472549,5,31,03,1,2018,2018-03-31,2,2018,474782,13
Bureau,Department of Homeland Security,Office of Biometric Identity Management,null,0.0,0.0,0,0,0,0,31,03,1,2018,2018-03-31,2,2018,0,0
Bureau,Department of Homeland Security,Emergency Preparedness & Resp,null,100.0,100.0,0,0,273941405,43551,31,03,1,2018,2018-03-31,2,2018,273941405,43551
Bureau,Department of the Treasury,Interest on Public Debt,null,0.0,0.0,0,0,0,0,31,03,1,2018,2018-03-31,2,2018,0,0
Bureau,Other Agencies,Comm. for Purchase from Blind/Handic.,null,0.0,0.0,12993,7,0,0,31,03,1,2018,2018-03-31,2,2018,12993,7
Bureau,Department of the Treasury,U.S. Mint,null,100.0,100.0,0,0,34463,11,31,03,1,2018,2018-03-31,2,2018,34463,11
Bureau,Department of Health & Human Services,Administration for Children and Families,null,100.0,100.0,0,0,21825982,1266,31,03,1,2018,2018-03-31,2,2018,21825982,1266
Bureau,Other Agencies/Boards/Commissions,Medicare Payment Advisory Commission,null,0.0,0.0,0,0,0,0,31,03,1,2018,2018-03-31,2,2018,0,0
Bureau,Equal Employment Opportunity Commission,Equal Employment Opportunity Commission,null,52.64676320589658,39.62264150943396,25441,32,28285,21,31,03,1,2018,2018-03-31,2,2018,53726,53
Bureau,Department of the Interior,Bureau of Safety and Environmental Enf.,null,100.0,100.0,0,0,14571,5,31,03,1,2018,2018-03-31,2,2018,14571,5
Bureau,Department of Health & Human Services,Substance Abuse & Mental Health Admin.,null,100.0,100.0,0,0,666783,11,31,03,1,2018,2018-03-31,2,2018,666783,11
Bureau,Department of Agriculture,Commodity Credit Corporation,null,99.92304374730564,99.93923435284586,98314,6,127654788,9868,31,03,1,2018,2018-03-31,2,2018,127753102,9874
Agency,Nuclear Regulatory Commission,null,CFO,100.0,100.0,0,0,1308078,216,31,03,1,2018,2018-03-31,2,2018,1308078,216
Agency,Federal Labor Relations Authority,null,Non-CFO,0.0,0.0,0,0,0,0,31,03,1,2018,2018-03-31,2,2018,0,0
Bureau,Other Agencies,National Council on Disability,null,0.0,0.0,0,0,0,0,31,03,1,2018,2018-03-31,2,2018,0,0
Agency,Legislative Branch-Office of Tech.,null,Non-CFO,0.0,0.0,0,0,0,0,31,03,1,2018,2018-03-31,2,2018,0,0
Bureau,Department of Homeland Security,Info Analysis Infrastructure Prot-NPPD,null,100.0,100.0,0,0,4610,1,31,03,1,2018,2018-03-31,2,2018,4610,1
Bureau,Department of the Interior,Bureau of Indian Affairs,null,99.43133042424891,98.23026606204101,58652,441,10255246,24478,31,03,1,2018,2018-03-31,2,2018,10313898,24919
Bureau,Other Agencies,U.S. Holocaust Memorial Council,null,0.0,0.0,0,0,0,0,31,03,1,2018,2018-03-31,2,2018,0,0
Bureau,Overseas Private Investment Corp Accts,Overseas Private Investment Corp Accts,null,0.0,0.0,0,0,0,0,31,03,1,2018,2018-03-31,2,2018,0,0
Bureau,Corp. for National and Community Service,Corp. for National and Community Service,null,99.61534348323497,93.7956204379562,13560,17,3511663,257,31,03,1,2018,2018-03-31,2,2018,3525223,274
Bureau,Department of Agriculture,Farm Service Agency,null,100.0,100.0,0,0,717173200,12656,31,03,1,2018,2018-03-31,2,2018,717173200,12656
Bureau,Department of Transportation,Federal Railroad Administration,null,100.0,100.0,0,0,253547,18,31,03,1,2018,2018-03-31,2,2018,253547,18
Bureau,Smithsonian Institution,JFK Center for the Performing Arts,null,0.0,0.0,0,0,0,0,31,03,1,2018,2018-03-31,2,2018,0,0
Bureau,Department of Education,Federal Student Aid,null,57.8126543354936,53.306709937391446,60586579891,12017107,83026579308,13719154,31,03,1,2018,2018-03-31,2,2018,143613159199,25736261
Bureau,Legislative Branch-GPO,Government Publishing Office,null,0.0,0.0,132192,95,0,0,31,03,1,2018,2018-03-31,2,2018,132192,95
Bureau,National Foundation  Arts & Humanities,National Endowment for the Arts,null,0.0,0.0,0,0,0,0,31,03,1,2018,2018-03-31,2,2018,0,0
Bureau,Department of the Interior,"Bureau of Ocean Energy Mgmt., Reg & Enf",null,100.0,100.0,0,0,166,1,31,03,1,2018,2018-03-31,2,2018,166,1
Bureau,National Science Foundation,National Science Foundation,null,100.0,100.0,0,0,658703,112,31,03,1,2018,2018-03-31,2,2018,658703,112
Bureau,Department of Agriculture,U.S. Department of Agriculture,null,65.42618681466053,51.61904761904762,9072171,1524,17167836,1626,31,03,1,2018,2018-03-31,2,2018,26240007,3150
Bureau,Department of Health & Human Services,Health Resources and Services Admin,null,100.0,100.0,0,0,89712283,529,31,03,1,2018,2018-03-31,2,2018,89712283,529
Bureau,Commodity Futures Trading Commission,Commodity Futures Trading Commission,null,100.0,100.0,0,0,591060271,354,31,03,1,2018,2018-03-31,2,2018,591060271,354
Bureau,Department of Justice,Bureau of ATF and Explosives,null,100.0,100.0,0,0,11892,4,31,03,1,2018,2018-03-31,2,2018,11892,4
Bureau,Department of Transportation,Surface Transportation Board,null,0.0,0.0,0,0,0,0,31,03,1,2018,2018-03-31,2,2018,0,0
Bureau,Department of the Treasury,Treasury Franchise Fund,null,0.0,0.0,0,0,0,0,31,03,1,2018,2018-03-31,2,2018,0,0
Bureau,Department of Health & Human Services,Administration for Community Living,null,0.0,0.0,0,0,0,0,31,03,1,2018,2018-03-31,2,2018,0,0
Bureau,Pension Benefit Guaranty Corp,Pension Benefit Guaranty Corporation,null,100.0,100.0,0,0,2443832,825,31,03,1,2018,2018-03-31,2,2018,2443832,825
Bureau,Department of Homeland Security,Transportation Safety Administration,null,100.0,100.0,0,0,9732943,4819,31,03,1,2018,2018-03-31,2,2018,9732943,4819
Bureau,Federal Communications Commission,Federal Communications Commission,null,100.0,100.0,0,0,225000329,11896,31,03,1,2018,2018-03-31,2,2018,225000329,11896
Bureau,Federal Trade Commission,Federal Trade Commission,null,100.0,100.0,0,0,483134767,56,31,03,1,2018,2018-03-31,2,2018,483134767,56
Bureau,Department of Homeland Security,Science and Technology,null,0.0,0.0,0,0,0,0,31,03,1,2018,2018-03-31,2,2018,0,0
Bureau,Department of the Treasury,Office of the Secretary,null,0.0,0.0,0,0,0,0,31,03,1,2018,2018-03-31,2,2018,0,0
Bureau,Department of Agriculture,Federal Crop Insurance Corporation,null,100.0,100.0,0,0,138690,358,31,03,1,2018,2018-03-31,2,2018,138690,358
Bureau,General Services Administration,General Services Administration,null,88.92470417053667,89.63287442636629,2162472,497,17362713,4297,31,03,1,2018,2018-03-31,2,2018,19525185,4794
Agency,Department of Education,null,CFO,57.98697884727326,53.30972136103585,60615728147,12017178,83662703834,13720895,31,03,1,2018,2018-03-31,2,2018,144278431981,25738073
Bureau,Other Agencies/Boards/Commissions,U.S. Comm. on Int. Religious Freedom,null,0.0,0.0,864,1,0,0,31,03,1,2018,2018-03-31,2,2018,864,1
Bureau,Department of Homeland Security,Federal Law Enforcement Training Ctr.,null,100.0,100.0,0,0,15146,5,31,03,1,2018,2018-03-31,2,2018,15146,5
Bureau,Presidio Trust Corporation,Presidio Trust Corporation,null,97.29221153149716,92.70833333333333,37759,7,1356700,89,31,03,1,2018,2018-03-31,2,2018,1394459,96
Bureau,Department of Veterans Affairs,Administration and Cemeteries,null,0.7549651186083443,3.5007610350076104,2734820,634,20804,23,31,03,1,2018,2018-03-31,2,2018,2755624,657
Bureau,Department of Health & Human Services,Program Support Center,null,100.0,100.0,0,0,3625428,531,31,03,1,2018,2018-03-31,2,2018,3625428,531
Agency,Department of Veterans Affairs,null,CFO,91.6750661438043,98.4642385060283,96017158,120855,1057351261,7748531,31,03,1,2018,2018-03-31,2,2018,1153368419,7869386
Agency,Neighborhood Reinvestment Corporation,null,Non-CFO,0.0,0.0,0,0,0,0,31,03,1,2018,2018-03-31,2,2018,0,0
Bureau,Department of Transportation,Federal Transit Administration,null,100.0,100.0,0,0,784271,2,31,03,1,2018,2018-03-31,2,2018,784271,2
Bureau,Department of the Treasury,Departmental Offices,null,89.96882940334342,98.73417721518987,2014756,9,18070198,702,31,03,1,2018,2018-03-31,2,2018,20084954,711
Bureau,Department of Housing and Urban Development,Public and Indian Housing Programs,null,0.0,0.0,0,0,0,0,31,03,1,2018,2018-03-31,2,2018,0,0
Bureau,Department of Labor,Employment and Training Administration,null,100.0,100.0,0,0,3299999,3,31,03,1,2018,2018-03-31,2,2018,3299999,3
Agency,Occupational Safety & Health Rev Comm,null,Non-CFO,0.0,0.0,0,0,0,0,31,03,1,2018,2018-03-31,2,2018,0,0
Agency,Legislative Branch-GAO,null,Non-CFO,0.0,0.0,0,0,0,0,31,03,1,2018,2018-03-31,2,2018,0,0
Bureau,Funds Appropriated to the President,Trade and Development Agency,null,0.0,0.0,0,0,0,0,31,03,1,2018,2018-03-31,2,2018,0,0
Bureau,Other Agencies,Surface Transportation Board,null,0.0,0.0,0,0,0,0,31,03,1,2018,2018-03-31,2,2018,0,0
Bureau,Other Agencies,Millennium Challenge Corporation,null,0.0,0.0,0,0,0,0,31,03,1,2018,2018-03-31,2,2018,0,0
Bureau,Department of Transportation,Office of the Inspector General,null,0.0,0.0,0,0,0,0,31,03,1,2018,2018-03-31,2,2018,0,0
Bureau,Export - Import  Bank,Export-Import Bank,null,0.0,0.0,0,0,0,0,31,03,1,2018,2018-03-31,2,2018,0,0
Agency,Legislative Branch - U.S. House/Senate,null,Non-CFO,0.0,0.0,222993,222,0,0,31,03,1,2018,2018-03-31,2,2018,222993,222
Bureau,Legislative Branch - U.S. House/Senate,U.S. House of Representatives,null,0.0,0.0,222993,222,0,0,31,03,1,2018,2018-03-31,2,2018,222993,222
Bureau,Office of Personnel Management,Office of Personnel Management,null,90.56225601800197,89.00565885206144,1889187,136,18128171,1101,31,03,1,2018,2018-03-31,2,2018,20017358,1237
Bureau,Department of Energy,Energy Consolidated Reports,null,100.0,100.0,0,0,35654200,89,31,03,1,2018,2018-03-31,2,2018,35654200,89
Agency,National Foundation  Arts & Humanities,null,Non-CFO,0.0,0.0,0,0,0,0,31,03,1,2018,2018-03-31,2,2018,0,0
Bureau,Legislative Branch-CBO,Congressional Budget Office,null,0.0,0.0,0,0,0,0,31,03,1,2018,2018-03-31,2,2018,0,0
Bureau,Funds Appropriated to the President,African Development Foundation,null,0.0,0.0,0,0,0,0,31,03,1,2018,2018-03-31,2,2018,0,0
Bureau,Department of Homeland Security,Citizenship and Immigration Services,null,100.0,100.0,0,0,966677,1201,31,03,1,2018,2018-03-31,2,2018,966677,1201
Bureau,Department of Labor,Employment Standards Administration,null,68.78401859560987,37.40157480314961,38155875,8427,84075986,5035,31,03,1,2018,2018-03-31,2,2018,122231861,13462
Bureau,Smithsonian Institution,National Gallery of Art,null,0.0,0.0,0,0,0,0,31,03,1,2018,2018-03-31,2,2018,0,0
Bureau,Office of Special Counsel,Office of Special Counsel,null,0.0,0.0,0,0,0,0,31,03,1,2018,2018-03-31,2,2018,0,0
Bureau,Other Agencies,Council of Insps. Gen. of Intg. & Effy.,null,0.0,0.0,68512,1,0,0,31,03,1,2018,2018-03-31,2,2018,68512,1
Bureau,Other Agencies,James Madison Memorial Fellowship,null,0.0,0.0,229199,22,0,0,31,03,1,2018,2018-03-31,2,2018,229199,22
Bureau,Department of Justice,Office of Justice Assistance Programs,null,100.0,100.0,0,0,821426,19,31,03,1,2018,2018-03-31,2,2018,821426,19
Bureau,Department of the Interior,National Park Service,null,100.0,100.0,0,0,5154772,1833,31,03,1,2018,2018-03-31,2,2018,5154772,1833
Bureau,Department of Homeland Security,Bureau of Customs & Border Protection,null,100.0,100.0,0,0,8436139,1467,31,03,1,2018,2018-03-31,2,2018,8436139,1467
Bureau,Department of the Interior,Bureau of Land Management,null,100.0,100.0,0,0,12746693,300,31,03,1,2018,2018-03-31,2,2018,12746693,300
Bureau,Department of Labor,Employee Benefit Security Administration,null,100.0,100.0,0,0,17128359,367,31,03,1,2018,2018-03-31,2,2018,17128359,367
Bureau,Department of Transportation,Federal Highway Administration,null,100.0,100.0,0,0,12531,8,31,03,1,2018,2018-03-31,2,2018,12531,8
Bureau,Other Agencies,Delta Regional Authority,null,0.0,0.0,0,0,0,0,31,03,1,2018,2018-03-31,2,2018,0,0
Bureau,Other Agencies,District of Columbia Government,null,0.0,0.0,0,0,0,0,31,03,1,2018,2018-03-31,2,2018,0,0
Bureau,Department of Homeland Security,Management Headquarters,null,0.0,0.0,0,0,0,0,31,03,1,2018,2018-03-31,2,2018,0,0
Bureau,Department of Commerce,General Administration,null,100.0,100.0,0,0,4660,1,31,03,1,2018,2018-03-31,2,2018,4660,1
Bureau,Department of the Interior,Fish and Wildlife Service,null,100.0,100.0,0,0,558743,113,31,03,1,2018,2018-03-31,2,2018,558743,113
Bureau,The Judiciary,Administrative Office of the U.S. Courts,null,97.38113734950507,97.58064516129032,42273,6,1571901,242,31,03,1,2018,2018-03-31,2,2018,1614174,248
Bureau,Environmental Protection Agency,Environmental Protection Agency,null,100.0,100.0,0,0,15789174,203,31,03,1,2018,2018-03-31,2,2018,15789174,203
Bureau,U.S. Postal Service,U.S. Postal Service,null,80.56015254244113,89.29029804629938,10041577,4506,41613031,37568,31,03,1,2018,2018-03-31,2,2018,51654608,42074
Bureau,Securities & Exchange Commission,Securities and Exchange Commission,null,100.0,100.0,0,0,1870637844,778,31,03,1,2018,2018-03-31,2,2018,1870637844,778
Bureau,Department of the Treasury,International Monetary Funds,null,0.0,0.0,0,0,0,0,31,03,1,2018,2018-03-31,2,2018,0,0
Bureau,Other Agencies,Archit.&Trans. Barriers Compliance Bd,null,0.0,0.0,0,0,0,0,31,03,1,2018,2018-03-31,2,2018,0,0
Bureau,Department of State,International Commissions,null,0.0,0.0,0,0,0,0,31,03,1,2018,2018-03-31,2,2018,0,0
Bureau,Department of the Treasury,D.C. Pension Program,null,100.0,100.0,0,0,164744,15,31,03,1,2018,2018-03-31,2,2018,164744,15
Bureau,Department of the Interior,Office of Surface Mining,null,100.0,100.0,0,0,1904819,214,31,03,1,2018,2018-03-31,2,2018,1904819,214
Bureau,Legislative Branch-Office of Tech.,Open World Leadership,null,0.0,0.0,0,0,0,0,31,03,1,2018,2018-03-31,2,2018,0,0
Bureau,Other Agencies,Advisory Council on Hist. Preservation,null,0.0,0.0,0,0,0,0,31,03,1,2018,2018-03-31,2,2018,0,0
Bureau,Department of Health & Human Services,Office of the Inspector General,null,0.0,0.0,0,0,0,0,31,03,1,2018,2018-03-31,2,2018,0,0
Agency,Department of Homeland Security,null,CFO,100.0,100.0,0,0,361001395,61228,31,03,1,2018,2018-03-31,2,2018,361001395,61228
Agency,Federal Mediation/Conciliation Service,null,Non-CFO,0.0,0.0,0,0,0,0,31,03,1,2018,2018-03-31,2,2018,0,0
Bureau,National Credit Union Administration,Nat'l Credit Union Admin. Treasury Acct.,null,0.0,0.0,0,0,0,0,31,03,1,2018,2018-03-31,2,2018,0,0
Bureau,Funds Appropriated to the President,Inter-American Foundation,null,0.0,0.0,0,0,0,0,31,03,1,2018,2018-03-31,2,2018,0,0
Agency,General Services Administration,null,CFO,88.92470417053667,89.63287442636629,2162472,497,17362713,4297,31,03,1,2018,2018-03-31,2,2018,19525185,4794
Bureau,Occupational Safety & Health Rev Comm,Occupational Safety & Health Rev Comm,null,0.0,0.0,0,0,0,0,31,03,1,2018,2018-03-31,2,2018,0,0
Bureau,Other Agencies,Federal Mine Safety & Health Review Comm,null,0.0,0.0,0,0,0,0,31,03,1,2018,2018-03-31,2,2018,0,0
Bureau,Department of Transportation,Office of the Secretary,null,100.0,100.0,0,0,1638017,24,31,03,1,2018,2018-03-31,2,2018,1638017,24
Bureau,Department of the Interior,Office of Natural Resources Revenue,null,100.0,100.0,0,0,1719629,287,31,03,1,2018,2018-03-31,2,2018,1719629,287
Bureau,Department of Transportation,St. Lawrence Seaway Development Corp.,null,0.0,0.0,0,0,0,0,31,03,1,2018,2018-03-31,2,2018,0,0
Bureau,Other Agencies,Morris K. Udall Scholarship,null,0.0,0.0,982,1,0,0,31,03,1,2018,2018-03-31,2,2018,982,1
Bureau,Department of the Treasury,Treasury IG for Tax Admin,null,0.0,0.0,0,0,0,0,31,03,1,2018,2018-03-31,2,2018,0,0
Bureau,Department of Transportation,National Highway Traffic Safety Admin.,null,100.0,100.0,0,0,7669575,4,31,03,1,2018,2018-03-31,2,2018,7669575,4
Bureau,Other Agencies,Denali Commission,null,0.0,0.0,0,0,0,0,31,03,1,2018,2018-03-31,2,2018,0,0
Bureau,Department of the Treasury,Bureau of Engraving and Printing,null,100.0,100.0,0,0,84528,1,31,03,1,2018,2018-03-31,2,2018,84528,1
Bureau,Department of Veterans Affairs,Life Insurance,null,100.0,100.0,0,0,499978,81,31,03,1,2018,2018-03-31,2,2018,499978,81
Bureau,Department of Transportation,Research Innovative Technology Admin,null,100.0,100.0,0,0,5486,2,31,03,1,2018,2018-03-31,2,2018,5486,2
Agency,American Battle Monuments Commission,null,Non-CFO,0.0,0.0,6549,3,0,0,31,03,1,2018,2018-03-31,2,2018,6549,3
Bureau,Department of Homeland Security,Domestic Nuclear Detection Office,null,0.0,0.0,0,0,0,0,31,03,1,2018,2018-03-31,2,2018,0,0
Bureau,Department of Commerce,Economic Development Administration,null,100.0,100.0,0,0,1307589,1,31,03,1,2018,2018-03-31,2,2018,1307589,1
Bureau,Other Agencies,National Capital Planning Commission,null,0.0,0.0,0,0,0,0,31,03,1,2018,2018-03-31,2,2018,0,0
Bureau,American Battle Monuments Commission,American Battle Monuments Commission,null,0.0,0.0,6549,3,0,0,31,03,1,2018,2018-03-31,2,2018,6549,3
Bureau,Department of Justice,Federal Prison Industries,null,97.99875985306137,95.3125,21301,9,1043089,183,31,03,1,2018,2018-03-31,2,2018,1064390,192
Bureau,Department of the Treasury,Interest on Tax/Deposit of Earnings,null,100.0,100.0,0,0,3240,2,31,03,1,2018,2018-03-31,2,2018,3240,2
Bureau,Other Agencies,Consumer Financial Protection Bureau,null,0.0,0.0,219113,58,0,0,31,03,1,2018,2018-03-31,2,2018,219113,58
Bureau,Other Agencies,Commission On Fine Arts,null,0.0,0.0,0,0,0,0,31,03,1,2018,2018-03-31,2,2018,0,0
Bureau,Department of Agriculture,Forest Service,null,91.424938043316,15.65726083964212,4679894,2451,49895735,455,31,03,1,2018,2018-03-31,2,2018,54575629,2906
Bureau,Department of Homeland Security,U.S. Coast Guard,null,100.0,100.0,0,0,60255919,9798,31,03,1,2018,2018-03-31,2,2018,60255919,9798
Bureau,Department of Commerce,Office of the Inspector General,null,0.0,0.0,0,0,0,0,31,03,1,2018,2018-03-31,2,2018,0,0
Bureau,Department of the Interior,Geological Survey,null,100.0,100.0,0,0,332626,98,31,03,1,2018,2018-03-31,2,2018,332626,98
Bureau,National Foundation  Arts & Humanities,National Endowment for the Humanities,null,0.0,0.0,0,0,0,0,31,03,1,2018,2018-03-31,2,2018,0,0
Bureau,Department of the Treasury,Bureau of the Fiscal Service,null,100.0,100.0,0,0,11099063,4554,31,03,1,2018,2018-03-31,2,2018,11099063,4554
Bureau,Legis Branch-Library of Congress,Library of Congress,null,0.0,0.0,0,0,0,0,31,03,1,2018,2018-03-31,2,2018,0,0
Bureau,Department of Justice,Federal Prison System,null,100.0,100.0,0,0,742613,97,31,03,1,2018,2018-03-31,2,2018,742613,97
Bureau,Department of Health & Human Services,Food and Drug Administration,null,98.30784617924506,21.73913043478261,383954,2538,22306300,705,31,03,1,2018,2018-03-31,2,2018,22690254,3243
Bureau,Nuclear Regulatory Commission,Nuclear Regulatory Commission,null,100.0,100.0,0,0,1308078,216,31,03,1,2018,2018-03-31,2,2018,1308078,216
Bureau,Other Agencies,Election Assistance Commission,null,0.0,0.0,0,0,0,0,31,03,1,2018,2018-03-31,2,2018,0,0
Bureau,Department of Homeland Security,Immigration and Customs Enforcement,null,100.0,100.0,0,0,7647224,383,31,03,1,2018,2018-03-31,2,2018,7647224,383
Bureau,Other Agencies,Federal Housing Finance Agency OIG,null,0.0,0.0,0,0,0,0,31,03,1,2018,2018-03-31,2,2018,0,0
Bureau,Department of Commerce,NOAA,null,100.0,100.0,0,0,3786528,587,31,03,1,2018,2018-03-31,2,2018,3786528,587
Agency,Tennessee Valley Authority,null,Non-CFO,0.0,0.0,0,0,0,0,31,03,1,2018,2018-03-31,2,2018,0,0
Agency,National Science Foundation,null,CFO,100.0,100.0,0,0,658703,112,31,03,1,2018,2018-03-31,2,2018,658703,112
Bureau,Other Agencies,National Transportation Safety Board,null,0.0,0.0,0,0,0,0,31,03,1,2018,2018-03-31,2,2018,0,0
Agency,Legislative Branch-CBO,null,Non-CFO,0.0,0.0,0,0,0,0,31,03,1,2018,2018-03-31,2,2018,0,0
Bureau,Other Agencies,Delta Regional Authority,null,0.0,0.0,0,0,0,0,30,06,2,2018,2018-06-30,3,2018,0,0
Bureau,Department of the Treasury,Treasury Franchise Fund,null,0.0,0.0,0,0,0,0,30,06,2,2018,2018-06-30,3,2018,0,0
Bureau,Department of Health & Human Services,Administration for Community Living,null,0.0,0.0,0,0,0,0,30,06,2,2018,2018-06-30,3,2018,0,0
Bureau,Department of Homeland Security,Info Analysis Infrastructure Prot-NPPD,null,100.0,100.0,0,0,4610,1,30,06,2,2018,2018-06-30,3,2018,4610,1
Bureau,Department of Transportation,Federal Transit Administration,null,100.0,100.0,0,0,784282,2,30,06,2,2018,2018-06-30,3,2018,784282,2
Agency,Legis Branch-Library of Congress,null,Non-CFO,0.0,0.0,0,0,0,0,30,06,2,2018,2018-06-30,3,2018,0,0
Agency,Occupational Safety & Health Rev Comm,null,Non-CFO,0.0,0.0,0,0,0,0,30,06,2,2018,2018-06-30,3,2018,0,0
Agency,Smithsonian Institution,null,Non-CFO,0.0,0.0,0,0,0,0,30,06,2,2018,2018-06-30,3,2018,0,0
Agency,Federal Communications Commission,null,Non-CFO,100.0,100.0,0,0,181805645,13647,30,06,2,2018,2018-06-30,3,2018,181805645,13647
Bureau,Department of Health & Human Services,National Institutes of Health,null,36.73052461953121,21.85792349726776,7734725,286,4490325,80,30,06,2,2018,2018-06-30,3,2018,12225050,366
Bureau,Department of Health & Human Services,Food and Drug Administration,null,51.26683753716063,17.396061269146607,21876764,3020,23014154,636,30,06,2,2018,2018-06-30,3,2018,44890918,3656
Agency,Department of Labor,null,CFO,83.74772569496655,72.92260407935177,40013178,9691,206187306,26099,30,06,2,2018,2018-06-30,3,2018,246200484,35790
Agency,Selective Service System,null,Non-CFO,0.0,0.0,0,0,0,0,30,06,2,2018,2018-06-30,3,2018,0,0
Agency,Office of Government Ethics,null,Non-CFO,0.0,0.0,0,0,0,0,30,06,2,2018,2018-06-30,3,2018,0,0
Agency,American Battle Monuments Commission,null,Non-CFO,0.0,0.0,0,0,0,0,30,06,2,2018,2018-06-30,3,2018,0,0
Agency,Department of Housing and Urban Development,null,CFO,99.93624247009477,99.93480032599837,95083,4,149037106,6131,30,06,2,2018,2018-06-30,3,2018,149132189,6135
Bureau,Funds Appropriated to the President,Trade and Development Agency,null,0.0,0.0,0,0,0,0,30,06,2,2018,2018-06-30,3,2018,0,0
Agency,Export - Import  Bank,null,Non-CFO,0.0,0.0,0,0,0,0,30,06,2,2018,2018-06-30,3,2018,0,0
Agency,Office of Compliance,null,Non-CFO,0.0,0.0,0,0,0,0,30,06,2,2018,2018-06-30,3,2018,0,0
Bureau,Department of Commerce,Bureau of Industry and Security,null,100.0,100.0,0,0,30900,1,30,06,2,2018,2018-06-30,3,2018,30900,1
Agency,Department of Defense,null,CFO,55.4829626639023,19.211028228700762,1065012174,1299981,1327357664,309126,30,06,2,2018,2018-06-30,3,2018,2392369838,1609107
Agency,Railroad Retirement Board,null,Non-CFO,100.0,100.0,0,0,17843234,3834,30,06,2,2018,2018-06-30,3,2018,17843234,3834
Bureau,Other Agencies,Federal Housing Finance Agency,null,100.0,100.0,0,0,3910,1,30,06,2,2018,2018-06-30,3,2018,3910,1
Bureau,Department of Commerce,General Administration,null,100.0,100.0,0,0,4660,1,30,06,2,2018,2018-06-30,3,2018,4660,1
Agency,National Science Foundation,null,CFO,100.0,100.0,0,0,663531,129,30,06,2,2018,2018-06-30,3,2018,663531,129
Agency,Department of Justice,null,CFO,99.26911265954385,99.44510385756676,560397,187,76113116,33513,30,06,2,2018,2018-06-30,3,2018,76673513,33700
Agency,Department of Veterans Affairs,null,CFO,88.58119864237179,98.39997648391284,135091370,127370,1047969494,7833138,30,06,2,2018,2018-06-30,3,2018,1183060864,7960508
Agency,Department of Agriculture,null,CFO,98.27208777232347,94.70456603064518,26384939,3100,1500598815,55441,30,06,2,2018,2018-06-30,3,2018,1526983754,58541
Agency,Small Business Administration,null,CFO,97.63308291258517,98.5091733161994,271033859,1717,11179889388,113454,30,06,2,2018,2018-06-30,3,2018,11450923247,115171
Agency,Tennessee Valley Authority,null,Non-CFO,0.0,0.0,0,0,0,0,30,06,2,2018,2018-06-30,3,2018,0,0
Agency,Federal Mediation/Conciliation Service,null,Non-CFO,0.0,0.0,0,0,0,0,30,06,2,2018,2018-06-30,3,2018,0,0
Agency,Federal Deposit Insurance Corporation,null,Non-CFO,0.0,0.0,0,0,0,0,30,06,2,2018,2018-06-30,3,2018,0,0
Agency,Merit Systems Protection Board,null,Non-CFO,100.0,100.0,0,0,120,1,30,06,2,2018,2018-06-30,3,2018,120,1
Agency,Legislative Branch - U.S. House/Senate,null,Non-CFO,0.0,0.0,228379,254,0,0,30,06,2,2018,2018-06-30,3,2018,228379,254
Agency,U.S. Postal Service,null,Non-CFO,76.06518564855926,72.98326785393773,13051840,13547,41478936,36596,30,06,2,2018,2018-06-30,3,2018,54530776,50143
Agency,Securities & Exchange Commission,null,Non-CFO,100.0,100.0,0,0,1869828407,764,30,06,2,2018,2018-06-30,3,2018,1869828407,764
Bureau,Legislative Branch-Office of Tech.,Medicaid & CHIP Payment & Access Comm.,null,0.0,0.0,0,0,0,0,30,06,2,2018,2018-06-30,3,2018,0,0
Bureau,Other Agencies,Millennium Challenge Corporation,null,0.0,0.0,0,0,0,0,30,06,2,2018,2018-06-30,3,2018,0,0
Bureau,Other Agencies,U.S. Institute of Peace,null,0.0,0.0,0,0,0,0,30,06,2,2018,2018-06-30,3,2018,0,0
Bureau,Department of Homeland Security,U.S. Secret Service,null,0.0,0.0,0,0,0,0,30,06,2,2018,2018-06-30,3,2018,0,0
Bureau,Department of Housing and Urban Development,Government National Mortgage Association,null,0.0,0.0,0,0,0,0,30,06,2,2018,2018-06-30,3,2018,0,0
Bureau,Funds Appropriated to the President,Defense Security Assistance Agency,null,0.0,0.0,0,0,0,0,30,06,2,2018,2018-06-30,3,2018,0,0
Bureau,Department of Homeland Security,Office of Health Affairs,null,0.0,0.0,0,0,0,0,30,06,2,2018,2018-06-30,3,2018,0,0
Bureau,Other Agencies,District of Columbia Government,null,0.0,0.0,0,0,0,0,30,06,2,2018,2018-06-30,3,2018,0,0
Bureau,National Foundation  Arts & Humanities,National Endowment for the Arts,null,0.0,0.0,0,0,0,0,30,06,2,2018,2018-06-30,3,2018,0,0
Bureau,Other Agencies,U.S. Holocaust Memorial Council,null,0.0,0.0,0,0,0,0,30,06,2,2018,2018-06-30,3,2018,0,0
Bureau,Smithsonian Institution,National Gallery of Art,null,0.0,0.0,0,0,0,0,30,06,2,2018,2018-06-30,3,2018,0,0
Bureau,Department of Homeland Security,Domestic Nuclear Detection Office,null,0.0,0.0,0,0,0,0,30,06,2,2018,2018-06-30,3,2018,0,0
Bureau,Legis Branch-Library of Congress,Library of Congress,null,0.0,0.0,0,0,0,0,30,06,2,2018,2018-06-30,3,2018,0,0
Bureau,Funds Appropriated to the President,Inter-American Foundation,null,0.0,0.0,0,0,0,0,30,06,2,2018,2018-06-30,3,2018,0,0
Bureau,Smithsonian Institution,Administrative Conference of the US,null,0.0,0.0,0,0,0,0,30,06,2,2018,2018-06-30,3,2018,0,0
Bureau,Other Agencies,Archit.&Trans. Barriers Compliance Bd,null,0.0,0.0,0,0,0,0,30,06,2,2018,2018-06-30,3,2018,0,0
Bureau,Smithsonian Institution,Smithsonian Institution,null,0.0,0.0,0,0,0,0,30,06,2,2018,2018-06-30,3,2018,0,0
Bureau,Department of Homeland Security,Science and Technology,null,0.0,0.0,0,0,0,0,30,06,2,2018,2018-06-30,3,2018,0,0
Bureau,Legislative Branch-GAO,Government Accountability Office,null,0.0,0.0,0,0,0,0,30,06,2,2018,2018-06-30,3,2018,0,0
Bureau,Other Agencies,Federal Mine Safety & Health Review Comm,null,0.0,0.0,0,0,0,0,30,06,2,2018,2018-06-30,3,2018,0,0
Bureau,Department of Housing and Urban Development,"Policy, Development and Research",null,0.0,0.0,0,0,0,0,30,06,2,2018,2018-06-30,3,2018,0,0
Agency,Department of Health & Human Services,null,CFO,96.94319111959858,99.65068894111394,353637067,6152,11215194379,1755029,30,06,2,2018,2018-06-30,3,2018,11568831446,1761181
Bureau,National Credit Union Administration,Nat'l Credit Union Admin. Treasury Acct.,null,0.0,0.0,0,0,0,0,30,06,2,2018,2018-06-30,3,2018,0,0
Bureau,Department of Transportation,Surface Transportation Board,null,0.0,0.0,0,0,0,0,30,06,2,2018,2018-06-30,3,2018,0,0
Bureau,Department of the Treasury,Treasury IG for Tax Admin,null,0.0,0.0,0,0,0,0,30,06,2,2018,2018-06-30,3,2018,0,0
Bureau,Department of Commerce,Minority Business Development Agency,null,0.0,0.0,0,0,0,0,30,06,2,2018,2018-06-30,3,2018,0,0
Bureau,Department of Justice,U.S. Marshals Service,null,0.0,0.0,0,0,0,0,30,06,2,2018,2018-06-30,3,2018,0,0
Bureau,Department of the Treasury,Office of Sec International Affairs,null,0.0,0.0,0,0,0,0,30,06,2,2018,2018-06-30,3,2018,0,0
Bureau,Department of the Treasury,U.S. Treasury IG Office,null,0.0,0.0,0,0,0,0,30,06,2,2018,2018-06-30,3,2018,0,0
Bureau,Other Agencies,Surface Transportation Board,null,0.0,0.0,0,0,0,0,30,06,2,2018,2018-06-30,3,2018,0,0
Bureau,Other Agencies,Federal Housing Finance Agency OIG,null,0.0,0.0,0,0,0,0,30,06,2,2018,2018-06-30,3,2018,0,0
Bureau,Department of Health & Human Services,Office of the Inspector General,null,0.0,0.0,0,0,0,0,30,06,2,2018,2018-06-30,3,2018,0,0
Bureau,Other Agencies/Boards/Commissions,Medicare Payment Advisory Commission,null,0.0,0.0,0,0,0,0,30,06,2,2018,2018-06-30,3,2018,0,0
Bureau,Other Agencies,National Capital Planning Commission,null,0.0,0.0,0,0,0,0,30,06,2,2018,2018-06-30,3,2018,0,0
Bureau,Department of Homeland Security,Management Headquarters,null,0.0,0.0,0,0,0,0,30,06,2,2018,2018-06-30,3,2018,0,0
Bureau,Other Agencies,Commission On Fine Arts,null,0.0,0.0,0,0,0,0,30,06,2,2018,2018-06-30,3,2018,0,0
Bureau,Department of State,Civil Monetary Penalties,null,0.0,0.0,0,0,0,0,30,06,2,2018,2018-06-30,3,2018,0,0
Bureau,Department of the Treasury,Spec Insp Gen-Troubled Asset Rel Prog,null,100.0,100.0,0,0,3916,1,30,06,2,2018,2018-06-30,3,2018,3916,1
Agency,Legislative Branch-CBO,null,Non-CFO,0.0,0.0,0,0,0,0,30,06,2,2018,2018-06-30,3,2018,0,0
Bureau,Other Agencies,Election Assistance Commission,null,0.0,0.0,0,0,0,0,30,06,2,2018,2018-06-30,3,2018,0,0
Bureau,Other Agencies,Defense Nuclear Facilities Safety Board,null,0.0,0.0,0,0,0,0,30,06,2,2018,2018-06-30,3,2018,0,0
Bureau,Department of the Treasury,Office of the Secretary,null,0.0,0.0,0,0,0,0,30,06,2,2018,2018-06-30,3,2018,0,0
Bureau,Consumer Product Safety Commission,Consumer Product Safety Commission,null,100.0,100.0,0,0,456,1,30,06,2,2018,2018-06-30,3,2018,456,1
Bureau,Department of Transportation,Research Innovative Technology Admin,null,100.0,100.0,0,0,5549,2,30,06,2,2018,2018-06-30,3,2018,5549,2
Bureau,Department of Homeland Security,Immigration and Customs Enforcement,null,100.0,100.0,0,0,8225397,375,30,06,2,2018,2018-06-30,3,2018,8225397,375
Bureau,Department of Education,Federal Student Aid,null,53.66253266095367,49.959915432353455,68092081244,13053506,78856134000,13032593,30,06,2,2018,2018-06-30,3,2018,146948215244,26086099
Agency,National Labor Relations Board,null,Non-CFO,0.0,0.0,0,0,0,0,30,06,2,2018,2018-06-30,3,2018,0,0
Bureau,Department of Transportation,Maritime Administration,null,100.0,100.0,0,0,6154,5,30,06,2,2018,2018-06-30,3,2018,6154,5
Bureau,National Credit Union Administration,National Credit Union Administration,null,100.0,100.0,0,0,6156,4,30,06,2,2018,2018-06-30,3,2018,6156,4
Bureau,Legislative Branch-GPO,Government Publishing Office,null,0.0,0.0,132296,86,0,0,30,06,2,2018,2018-06-30,3,2018,132296,86
Bureau,Other Agencies,James Madison Memorial Fellowship,null,0.0,0.0,228525,21,0,0,30,06,2,2018,2018-06-30,3,2018,228525,21
Bureau,Department of Justice,Federal Bureau of Investigation,null,0.0,0.0,384209,93,0,0,30,06,2,2018,2018-06-30,3,2018,384209,93
Bureau,Federal Maritime Commission,Salaries and Expenses,null,99.97662262172032,92.3076923076923,111,1,474707,12,30,06,2,2018,2018-06-30,3,2018,474818,13
Bureau,Department of Agriculture,Food Safety and Inspection Service,null,98.89697536222208,99.6023856858847,9912,4,888708,1002,30,06,2,2018,2018-06-30,3,2018,898620,1006
Bureau,Department of the Treasury,Comptroller of the Currency,null,99.89573021843859,92.85714285714286,948,2,908232,26,30,06,2,2018,2018-06-30,3,2018,909180,28
Bureau,Department of Veterans Affairs,Housing Credit Assistance,null,45.65004357642344,74.54545454545455,791993,14,665217,41,30,06,2,2018,2018-06-30,3,2018,1457210,55
Bureau,Department of Labor,Employment and Training Administration,null,100.0,100.0,0,0,2811570,2,30,06,2,2018,2018-06-30,3,2018,2811570,2
Bureau,Department of Veterans Affairs,Administration and Cemeteries,null,0.27560972905930126,2.2189349112426036,3058565,661,8453,15,30,06,2,2018,2018-06-30,3,2018,3067018,676
Bureau,Department of Homeland Security,Bureau of Customs & Border Protection,null,100.0,100.0,0,0,8067443,1467,30,06,2,2018,2018-06-30,3,2018,8067443,1467
Bureau,Department of the Treasury,Bureau of the Fiscal Service,null,99.99683397691547,99.97924019099024,360,1,11370372,4816,30,06,2,2018,2018-06-30,3,2018,11370732,4817
Bureau,Office of Personnel Management,Office of Personnel Management,null,84.75995107646413,80.54133138258962,3259490,266,18128171,1101,30,06,2,2018,2018-06-30,3,2018,21387661,1367
Bureau,Department of Agriculture,U.S. Department of Agriculture,null,64.7384898339098,52.98736770228747,8698791,1377,15970575,1552,30,06,2,2018,2018-06-30,3,2018,24669366,2929
Bureau,Agency for International Development,Agency for International Development,null,99.81435686431809,96.42857142857143,52257,2,28096912,54,30,06,2,2018,2018-06-30,3,2018,28149169,56
Agency,Overseas Private Investment Corp Accts,null,Non-CFO,0.0,0.0,0,0,0,0,30,06,2,2018,2018-06-30,3,2018,0,0
Agency,Legislative Branch-Office of Tech.,null,Non-CFO,0.0,0.0,0,0,0,0,30,06,2,2018,2018-06-30,3,2018,0,0
Bureau,Department of the Treasury,Interest on Public Debt,null,0.0,0.0,0,0,0,0,30,06,2,2018,2018-06-30,3,2018,0,0
Bureau,Department of the Treasury,Tobacco Tax and Trade,null,100.0,100.0,0,0,1000,1,30,06,2,2018,2018-06-30,3,2018,1000,1
Bureau,Department of Housing and Urban Development,Housing Programs,null,99.93624247009477,99.93480032599837,95083,4,149037106,6131,30,06,2,2018,2018-06-30,3,2018,149132189,6135
Bureau,Department of Veterans Affairs,Medical and Construction,null,79.65793909225243,98.40597374728027,129950278,125000,508875250,7716778,30,06,2,2018,2018-06-30,3,2018,638825528,7841778
Bureau,Department of Defense,Consolidated Report,null,55.4829626639023,19.211028228700762,1065012174,1299981,1327357664,309126,30,06,2,2018,2018-06-30,3,2018,2392369838,1609107
Bureau,Department of Health & Human Services,Centers for Medicare & Medicaid Services,null,97.25254657835741,99.98430463840741,312240011,275,11052466249,1751835,30,06,2,2018,2018-06-30,3,2018,11364706260,1752110
Bureau,Federal Deposit Insurance Corporation,Federal Deposit Insurance Corporation,null,0.0,0.0,0,0,0,0,30,06,2,2018,2018-06-30,3,2018,0,0
Bureau,Neighborhood Reinvestment Corporation,Neighborhood Reinvestment Corporation,null,0.0,0.0,0,0,0,0,30,06,2,2018,2018-06-30,3,2018,0,0
Bureau,Selective Service System,Selective Service System,null,0.0,0.0,0,0,0,0,30,06,2,2018,2018-06-30,3,2018,0,0
Bureau,Other Agencies,U.S.  Agency of Global Media,null,49.52362984624092,14.285714285714286,5351,6,5250,1,30,06,2,2018,2018-06-30,3,2018,10601,7
Bureau,Department of Homeland Security,Citizenship and Immigration Services,null,100.0,100.0,0,0,981716,1217,30,06,2,2018,2018-06-30,3,2018,981716,1217
Agency,National Foundation  Arts & Humanities,null,Non-CFO,0.0,0.0,0,0,0,0,30,06,2,2018,2018-06-30,3,2018,0,0
Bureau,Legislative Branch-CBO,Congressional Budget Office,null,0.0,0.0,0,0,0,0,30,06,2,2018,2018-06-30,3,2018,0,0
Bureau,Legislative Branch-Office of Tech.,Open World Leadership,null,0.0,0.0,0,0,0,0,30,06,2,2018,2018-06-30,3,2018,0,0
Bureau,Other Agencies,Gulf Coast Ecosystem Restoration Council,null,0.0,0.0,0,0,0,0,30,06,2,2018,2018-06-30,3,2018,0,0
Bureau,Federal Labor Relations Authority,Federal Labor Relations Authority,null,0.0,0.0,0,0,0,0,30,06,2,2018,2018-06-30,3,2018,0,0
Bureau,American Battle Monuments Commission,American Battle Monuments Commission,null,0.0,0.0,0,0,0,0,30,06,2,2018,2018-06-30,3,2018,0,0
Bureau,Other Agencies/Boards/Commissions,U.S.-China Security Review Commission,null,0.0,0.0,0,0,0,0,30,06,2,2018,2018-06-30,3,2018,0,0
Bureau,Department of Labor,Occupational Safety and Health Admin,null,95.9401100252107,96.91983929596327,2137736,161,50517287,5066,30,06,2,2018,2018-06-30,3,2018,52655023,5227
Agency,Legislative Branch-GAO,null,Non-CFO,0.0,0.0,0,0,0,0,30,06,2,2018,2018-06-30,3,2018,0,0
Bureau,Department of the Interior,Bureau of Safety and Environmental Enf.,null,100.0,100.0,0,0,14571,5,30,06,2,2018,2018-06-30,3,2018,14571,5
Bureau,Department of Justice,Drug Enforcement Administration,null,100.0,100.0,0,0,341821,21,30,06,2,2018,2018-06-30,3,2018,341821,21
Agency,Office of Special Counsel,null,Non-CFO,0.0,0.0,0,0,0,0,30,06,2,2018,2018-06-30,3,2018,0,0
Bureau,Department of Labor,Mine Safety and Health Administration,null,95.48881988932129,95.81983927072088,2654087,697,56179454,15977,30,06,2,2018,2018-06-30,3,2018,58833541,16674
Bureau,Department of Justice,Bureau of ATF and Explosives,null,100.0,100.0,0,0,23785,3,30,06,2,2018,2018-06-30,3,2018,23785,3
Bureau,Overseas Private Investment Corp Accts,Overseas Private Investment Corp Accts,null,0.0,0.0,0,0,0,0,30,06,2,2018,2018-06-30,3,2018,0,0
Bureau,Department of the Treasury,Financial Crimes Enforcement Network,null,99.67660479333718,66.66666666666667,146,1,45000,2,30,06,2,2018,2018-06-30,3,2018,45146,3
Bureau,Tennessee Valley Authority,Tennessee Valley Authority,null,0.0,0.0,0,0,0,0,30,06,2,2018,2018-06-30,3,2018,0,0
Bureau,Department of Justice,Legal Activities,null,99.75858731018063,99.71705496357835,176188,94,72805891,33128,30,06,2,2018,2018-06-30,3,2018,72982079,33222
Bureau,Armed Forces Retirement Home,Armed Forces Retirement Home,null,99.1198670263495,95.83333333333333,646,4,72752,92,30,06,2,2018,2018-06-30,3,2018,73398,96
Bureau,Department of Homeland Security,Office of the Inspector General DHS,null,100.0,100.0,0,0,1353,3,30,06,2,2018,2018-06-30,3,2018,1353,3
Agency,Farm Credit Administration,null,Non-CFO,100.0,100.0,0,0,595,1,30,06,2,2018,2018-06-30,3,2018,595,1
Agency,Other Agencies/Boards/Commissions,null,Non-CFO,0.0,0.0,864,1,0,0,30,06,2,2018,2018-06-30,3,2018,864,1
Bureau,Department of Agriculture,Commodity Credit Corporation,null,100.0,100.0,0,0,112161047,9993,30,06,2,2018,2018-06-30,3,2018,112161047,9993
Bureau,Federal Mediation/Conciliation Service,Federal Mediation/Conciliation Service,null,0.0,0.0,0,0,0,0,30,06,2,2018,2018-06-30,3,2018,0,0
Bureau,Other Agencies,Comm. for Purchase from Blind/Handic.,null,0.0,0.0,0,0,0,0,30,06,2,2018,2018-06-30,3,2018,0,0
Bureau,Department of Health & Human Services,Office of the Secretary,null,100.0,100.0,0,0,4217,5,30,06,2,2018,2018-06-30,3,2018,4217,5
Bureau,Department of Justice,Office of Justice Assistance Programs,null,100.0,100.0,0,0,1125724,79,30,06,2,2018,2018-06-30,3,2018,1125724,79
Agency,Department of Commerce,null,CFO,99.5219209120932,100.0,32392,0,6743056,1361,30,06,2,2018,2018-06-30,3,2018,6775448,1361
Agency,U.S. Court of Appeals / Veterans Claims,null,Non-CFO,0.0,0.0,1482,1,0,0,30,06,2,2018,2018-06-30,3,2018,1482,1
Agency,National Archives & Records Admin,null,Non-CFO,99.7853923742757,99.50248756218906,90,1,41847,200,30,06,2,2018,2018-06-30,3,2018,41937,201
Agency,Environmental Protection Agency,null,CFO,100.0,100.0,0,0,15763320,200,30,06,2,2018,2018-06-30,3,2018,15763320,200
Bureau,Funds Appropriated to the President,African Development Foundation,null,0.0,0.0,0,0,0,0,30,06,2,2018,2018-06-30,3,2018,0,0
Bureau,Department of Labor,Employment Standards Administration,null,69.31997020022757,34.66232709519935,35221355,8833,79580864,4686,30,06,2,2018,2018-06-30,3,2018,114802219,13519
Agency,Equal Employment Opportunity Commission,null,Non-CFO,60.79651980314038,45.16129032258065,26765,34,41507,28,30,06,2,2018,2018-06-30,3,2018,68272,62
Bureau,Federal Communications Commission,Federal Communications Commission,null,100.0,100.0,0,0,181805645,13647,30,06,2,2018,2018-06-30,3,2018,181805645,13647
Bureau,Commodity Futures Trading Commission,Commodity Futures Trading Commission,null,100.0,100.0,0,0,592082424,352,30,06,2,2018,2018-06-30,3,2018,592082424,352
Bureau,Department of Agriculture,Rural Development,null,99.99895659579782,99.98600272946776,6234,4,597461170,28573,30,06,2,2018,2018-06-30,3,2018,597467404,28577
Agency,Armed Forces Retirement Home,null,Non-CFO,99.1198670263495,95.83333333333333,646,4,72752,92,30,06,2,2018,2018-06-30,3,2018,73398,96
Agency,Department of State,null,CFO,95.81871922977297,99.7510616488505,697662,51,15987704,20436,30,06,2,2018,2018-06-30,3,2018,16685366,20487
Bureau,Department of Homeland Security,Office of Biometric Identity Management,null,0.0,0.0,0,0,0,0,30,06,2,2018,2018-06-30,3,2018,0,0
Agency,Federal Maritime Commission,null,Non-CFO,99.97662262172032,92.3076923076923,111,1,474707,12,30,06,2,2018,2018-06-30,3,2018,474818,13
Bureau,Farm Credit Administration,Farm Credit System Insurance Corporation,null,0.0,0.0,0,0,0,0,30,06,2,2018,2018-06-30,3,2018,0,0
Bureau,Department of Transportation,St. Lawrence Seaway Development Corp.,null,0.0,0.0,0,0,0,0,30,06,2,2018,2018-06-30,3,2018,0,0
Agency,Other Agencies,null,Non-CFO,1.6797846354720636,1.941747572815534,536148,101,9160,2,30,06,2,2018,2018-06-30,3,2018,545308,103
Agency,Federal Election Commission,null,Non-CFO,99.28220048618954,98.78048780487805,4500,1,622416,81,30,06,2,2018,2018-06-30,3,2018,626916,82
Bureau,Department of the Treasury,Bureau of Public Debt,null,0.0,0.0,0,0,0,0,30,06,2,2018,2018-06-30,3,2018,0,0
Agency,Presidio Trust Corporation,null,Non-CFO,96.9167542469922,91.39784946236558,39312,8,1235708,85,30,06,2,2018,2018-06-30,3,2018,1275020,93
Bureau,Department of the Interior,Office of Natural Resources Revenue,null,100.0,100.0,0,0,1896263,347,30,06,2,2018,2018-06-30,3,2018,1896263,347
Agency,Pension Benefit Guaranty Corp,null,Non-CFO,100.0,100.0,0,0,3413373,1551,30,06,2,2018,2018-06-30,3,2018,3413373,1551
Bureau,Department of the Treasury,Internal Revenue Service,null,99.35613001022834,98.41269841269842,1750,2,270044,124,30,06,2,2018,2018-06-30,3,2018,271794,126
Bureau,Department of Commerce,Nat'l Telecomm & Information Admin.,null,0.0,0.0,0,0,0,0,30,06,2,2018,2018-06-30,3,2018,0,0
Bureau,Department of Commerce,International Trade Administration,null,0.0,0.0,0,0,0,0,30,06,2,2018,2018-06-30,3,2018,0,0
Agency,General Services Administration,null,CFO,84.2439505358848,86.6111467008328,3032045,627,16211643,4056,30,06,2,2018,2018-06-30,3,2018,19243688,4683
Agency,Corp. for National and Community Service,null,Non-CFO,98.06472814124741,93.77289377289377,69197,17,3506373,256,30,06,2,2018,2018-06-30,3,2018,3575570,273
Bureau,Other Agencies,National Transportation Safety Board,null,0.0,0.0,0,0,0,0,30,06,2,2018,2018-06-30,3,2018,0,0
Bureau,Other Agencies,Chemical Safety Board,null,0.0,0.0,0,0,0,0,30,06,2,2018,2018-06-30,3,2018,0,0
Agency,Office of Personnel Management,null,CFO,84.75995107646413,80.54133138258962,3259490,266,18128171,1101,30,06,2,2018,2018-06-30,3,2018,21387661,1367
Agency,Agency for International Development,null,CFO,99.81435686431809,96.42857142857143,52257,2,28096912,54,30,06,2,2018,2018-06-30,3,2018,28149169,56
Agency,Department of the Interior,null,CFO,99.89970334414251,98.58909022272556,37403,299,37254967,20893,30,06,2,2018,2018-06-30,3,2018,37292370,21192
Bureau,Funds Appropriated to the President,Executive Branch,null,0.0,0.0,0,0,0,0,30,06,2,2018,2018-06-30,3,2018,0,0
Bureau,Department of Agriculture,Agricultural Marketing Service,null,91.38233447113838,78.15344603381014,253323,168,2686255,601,30,06,2,2018,2018-06-30,3,2018,2939578,769
Agency,National Credit Union Administration,null,Non-CFO,100.0,100.0,0,0,6156,4,30,06,2,2018,2018-06-30,3,2018,6156,4
Bureau,Funds Appropriated to the President,Peace Corps,null,0.0,0.0,0,0,0,0,30,06,2,2018,2018-06-30,3,2018,0,0
Bureau,U.S. Court of Appeals / Veterans Claims,U.S. Court of Appeals / Veterans Claims,null,0.0,0.0,1482,1,0,0,30,06,2,2018,2018-06-30,3,2018,1482,1
Bureau,National Archives & Records Admin,Nat'l Archives & Records Administration,null,99.7853923742757,99.50248756218906,90,1,41847,200,30,06,2,2018,2018-06-30,3,2018,41937,201
Bureau,Department of Commerce,Bureau of the Census,null,100.0,100.0,0,0,162518,220,30,06,2,2018,2018-06-30,3,2018,162518,220
Bureau,Department of Agriculture,Forest Service,null,95.87129480389899,37.753222836095766,2151716,676,49964284,410,30,06,2,2018,2018-06-30,3,2018,52116000,1086
Agency,Consumer Product Safety Commission,null,Non-CFO,100.0,100.0,0,0,456,1,30,06,2,2018,2018-06-30,3,2018,456,1
Bureau,Department of Justice,General Administration,null,0.0,0.0,0,0,0,0,30,06,2,2018,2018-06-30,3,2018,0,0
Bureau,Federal Trade Commission,Federal Trade Commission,null,100.0,100.0,0,0,483134768,56,30,06,2,2018,2018-06-30,3,2018,483134768,56
Bureau,Office of Compliance,Office of Compliance,null,0.0,0.0,0,0,0,0,30,06,2,2018,2018-06-30,3,2018,0,0
Bureau,Department of Transportation,Office of the Inspector General,null,0.0,0.0,0,0,0,0,30,06,2,2018,2018-06-30,3,2018,0,0
Bureau,Presidio Trust Corporation,Presidio Trust Corporation,null,96.9167542469922,91.39784946236558,39312,8,1235708,85,30,06,2,2018,2018-06-30,3,2018,1275020,93
Agency,Federal Trade Commission,null,Non-CFO,100.0,100.0,0,0,483134768,56,30,06,2,2018,2018-06-30,3,2018,483134768,56
Bureau,Other Agencies,National Council on Disability,null,0.0,0.0,0,0,0,0,30,06,2,2018,2018-06-30,3,2018,0,0
Bureau,Equal Employment Opportunity Commission,Equal Employment Opportunity Commission,null,60.79651980314038,45.16129032258065,26765,34,41507,28,30,06,2,2018,2018-06-30,3,2018,68272,62
Bureau,Department of Health & Human Services,Centers for Disease Control,null,7.402905588435894,32.5,623159,27,49820,13,30,06,2,2018,2018-06-30,3,2018,672979,40
Bureau,Department of Transportation,Federal Highway Administration,null,100.0,100.0,0,0,12706,8,30,06,2,2018,2018-06-30,3,2018,12706,8
Bureau,Department of Homeland Security,Emergency Preparedness & Resp,null,100.0,100.0,0,0,269971144,43083,30,06,2,2018,2018-06-30,3,2018,269971144,43083
Bureau,Department of Homeland Security,Federal Law Enforcement Training Ctr.,null,100.0,100.0,0,0,12641,4,30,06,2,2018,2018-06-30,3,2018,12641,4
Bureau,Department of Labor,Employee Benefit Security Administration,null,100.0,100.0,0,0,17087162,367,30,06,2,2018,2018-06-30,3,2018,17087162,367
Bureau,Department of the Treasury,Bureau of Engraving and Printing,null,100.0,100.0,0,0,84528,1,30,06,2,2018,2018-06-30,3,2018,84528,1
Bureau,Social Security Administration,Social Security Administration,null,25.103210214409685,11.075213386105327,4872823931,2408085,1633227857,299917,30,06,2,2018,2018-06-30,3,2018,6506051788,2708002
Bureau,Department of Health & Human Services,Program Support Center,null,100.0,100.0,0,0,3902199,543,30,06,2,2018,2018-06-30,3,2018,3902199,543
Bureau,Department of Justice,Federal Prison System,null,100.0,100.0,0,0,772806,99,30,06,2,2018,2018-06-30,3,2018,772806,99
Bureau,Department of Commerce,National Technical Information Service,null,0.0,0.0,32392,0,0,0,30,06,2,2018,2018-06-30,3,2018,32392,0
Bureau,U.S. Postal Service,U.S. Postal Service,null,76.06518564855926,72.98326785393773,13051840,13547,41478936,36596,30,06,2,2018,2018-06-30,3,2018,54530776,50143
Bureau,Other Agencies,Morris K. Udall Scholarship,null,0.0,0.0,982,1,0,0,30,06,2,2018,2018-06-30,3,2018,982,1
Bureau,Department of Agriculture,Federal Crop Insurance Corporation,null,100.0,100.0,0,0,130776,358,30,06,2,2018,2018-06-30,3,2018,130776,358
Bureau,Department of Commerce,Patent and Trademark Office,null,100.0,100.0,0,0,342387,535,30,06,2,2018,2018-06-30,3,2018,342387,535
Bureau,Other Agencies/Boards/Commissions,U.S. Comm. on Int. Religious Freedom,null,0.0,0.0,864,1,0,0,30,06,2,2018,2018-06-30,3,2018,864,1
Bureau,Department of the Treasury,Interest on Tax/Deposit of Earnings,null,100.0,100.0,0,0,3240,2,30,06,2,2018,2018-06-30,3,2018,3240,2
Bureau,Federal Election Commission,Federal Election Commission,null,99.28220048618954,98.78048780487805,4500,1,622416,81,30,06,2,2018,2018-06-30,3,2018,626916,82
Bureau,Department of the Interior,National Park Service,null,100.0,100.0,0,0,4981546,1871,30,06,2,2018,2018-06-30,3,2018,4981546,1871
Bureau,Department of Education,Office of Postsecondary Education,null,0.0,0.0,0,0,0,0,30,06,2,2018,2018-06-30,3,2018,0,0
Bureau,Other Agencies,Council of Insps. Gen. of Intg. & Effy.,null,0.0,0.0,79189,4,0,0,30,06,2,2018,2018-06-30,3,2018,79189,4
Bureau,Department of the Interior,Fish and Wildlife Service,null,100.0,100.0,0,0,573720,119,30,06,2,2018,2018-06-30,3,2018,573720,119
Bureau,Pension Benefit Guaranty Corp,Pension Benefit Guaranty Corporation,null,100.0,100.0,0,0,3413373,1551,30,06,2,2018,2018-06-30,3,2018,3413373,1551
Bureau,Department of the Interior,Bureau of Indian Affairs,null,99.74480611220848,98.35179979052974,37403,299,14619296,17842,30,06,2,2018,2018-06-30,3,2018,14656699,18141
Bureau,Securities & Exchange Commission,Securities and Exchange Commission,null,100.0,100.0,0,0,1869828407,764,30,06,2,2018,2018-06-30,3,2018,1869828407,764
Bureau,Department of Transportation,Federal Railroad Administration,null,100.0,100.0,0,0,281217,19,30,06,2,2018,2018-06-30,3,2018,281217,19
Bureau,Department of Transportation,Pipeline Hazardous Material Safety Admin,null,100.0,100.0,0,0,373743,22,30,06,2,2018,2018-06-30,3,2018,373743,22
Bureau,Nuclear Regulatory Commission,Nuclear Regulatory Commission,null,82.97142505069662,89.91935483870968,254270,25,1238926,223,30,06,2,2018,2018-06-30,3,2018,1493196,248
Bureau,Department of the Interior,Office of Surface Mining,null,100.0,100.0,0,0,2058570,235,30,06,2,2018,2018-06-30,3,2018,2058570,235
Bureau,Department of the Treasury,Community Dev Financial Inst Fund,null,89.24818999740691,85.71428571428571,391000,1,3245597,6,30,06,2,2018,2018-06-30,3,2018,3636597,7
Bureau,Department of Agriculture,Food and Nutrition Service,null,2.541716906911121,2.3542600896860986,15264963,871,398111,21,30,06,2,2018,2018-06-30,3,2018,15663074,892
Bureau,Department of the Interior,Bureau of Reclamation,null,100.0,100.0,0,0,88889,77,30,06,2,2018,2018-06-30,3,2018,88889,77
Bureau,Other Agencies,Consumer Financial Protection Bureau,null,0.0,0.0,219672,60,0,0,30,06,2,2018,2018-06-30,3,2018,219672,60
Agency,Social Security Administration,null,CFO,25.103210214409685,11.075213386105327,4872823931,2408085,1633227857,299917,30,06,2,2018,2018-06-30,3,2018,6506051788,2708002
Bureau,Department of Labor,Departmental Management,null,0.0,0.0,0,0,0,0,30,06,2,2018,2018-06-30,3,2018,0,0
Bureau,Department of Energy,Bonneville Power Administration,null,100.0,100.0,0,0,1107158,30,30,06,2,2018,2018-06-30,3,2018,1107158,30
Bureau,National Aeronautics and Space Administration,National Aeronautics and Space Admin,null,100.0,100.0,0,0,2504436,94,30,06,2,2018,2018-06-30,3,2018,2504436,94
Bureau,Corp. for National and Community Service,Corp. for National and Community Service,null,98.06472814124741,93.77289377289377,69197,17,3506373,256,30,06,2,2018,2018-06-30,3,2018,3575570,273
Bureau,Department of Veterans Affairs,Veterans Benefits,null,99.7606727169705,98.5625482330792,1290534,1695,537943432,116222,30,06,2,2018,2018-06-30,3,2018,539233966,117917
Bureau,Small Business Administration,Small Business Administration,null,97.63308291258517,98.5091733161994,271033859,1717,11179889388,113454,30,06,2,2018,2018-06-30,3,2018,11450923247,115171
Agency,Department of Education,null,CFO,53.86101322309721,49.96311686204917,68092905424,13053523,79489237533,13034279,30,06,2,2018,2018-06-30,3,2018,147582142957,26087802
Bureau,Department of Housing and Urban Development,Community Planning and Development,null,0.0,0.0,0,0,0,0,30,06,2,2018,2018-06-30,3,2018,0,0
Bureau,Farm Credit Administration,Farm Credit Administration,null,100.0,100.0,0,0,595,1,30,06,2,2018,2018-06-30,3,2018,595,1
Agency,Department of the Treasury,null,CFO,94.08116546272001,99.59411466260781,2545228,24,40456954,5889,30,06,2,2018,2018-06-30,3,2018,43002182,5913
Agency,Funds Appropriated to the President,null,Non-CFO,0.0,0.0,0,0,0,0,30,06,2,2018,2018-06-30,3,2018,0,0
Bureau,Export - Import  Bank,Export-Import Bank,null,0.0,0.0,0,0,0,0,30,06,2,2018,2018-06-30,3,2018,0,0
Agency,Department of Transportation,null,CFO,99.95423604631803,99.67796610169492,26698,19,58311793,5881,30,06,2,2018,2018-06-30,3,2018,58338491,5900
Bureau,National Foundation  Arts & Humanities,National Endowment for the Humanities,null,0.0,0.0,0,0,0,0,30,06,2,2018,2018-06-30,3,2018,0,0
Bureau,Occupational Safety & Health Rev Comm,Occupational Safety & Health Rev Comm,null,0.0,0.0,0,0,0,0,30,06,2,2018,2018-06-30,3,2018,0,0
Bureau,General Services Administration,General Services Administration,null,84.2439505358848,86.6111467008328,3032045,627,16211643,4056,30,06,2,2018,2018-06-30,3,2018,19243688,4683
Bureau,Department of Transportation,Federal Motor Carrier Safety Admin,null,99.99639802992007,99.94416527079844,1585,3,44002112,5370,30,06,2,2018,2018-06-30,3,2018,44003697,5373
Bureau,Department of State,Passport NSF,null,100.0,100.0,0,0,2455833,15207,30,06,2,2018,2018-06-30,3,2018,2455833,15207
Bureau,Department of Transportation,Federal Aviation Administration,null,99.30138271308203,96.3718820861678,25113,16,3569559,425,30,06,2,2018,2018-06-30,3,2018,3594672,441
Bureau,Railroad Retirement Board,Railroad Retirement Board,null,100.0,100.0,0,0,17843234,3834,30,06,2,2018,2018-06-30,3,2018,17843234,3834
Bureau,Department of Health & Human Services,Indian Health Services,null,63.53694752752824,5.321920357275772,11162408,2544,19450520,143,30,06,2,2018,2018-06-30,3,2018,30612928,2687
Bureau,Department of Health & Human Services,Health Resources and Services Admin,null,100.0,100.0,0,0,88888568,523,30,06,2,2018,2018-06-30,3,2018,88888568,523
Bureau,Department of Agriculture,Farm Service Agency,null,100.0,100.0,0,0,720937889,12931,30,06,2,2018,2018-06-30,3,2018,720937889,12931
Bureau,Department of the Treasury,Departmental Offices,null,91.88266333976561,98.11738648947951,2151024,17,24348111,886,30,06,2,2018,2018-06-30,3,2018,26499135,903
Bureau,Department of Commerce,Economic and Statistical Analysis,null,0.0,0.0,0,0,0,0,30,06,2,2018,2018-06-30,3,2018,0,0
Bureau,Other Agencies,Advisory Council on Hist. Preservation,null,0.0,0.0,0,0,0,0,30,06,2,2018,2018-06-30,3,2018,0,0
Bureau,Department of the Interior,Geological Survey,null,100.0,100.0,0,0,259089,92,30,06,2,2018,2018-06-30,3,2018,259089,92
Bureau,Department of Health & Human Services,Substance Abuse & Mental Health Admin.,null,100.0,100.0,0,0,728937,13,30,06,2,2018,2018-06-30,3,2018,728937,13
Bureau,Department of Commerce,Nat'l Institute of Standards& Technology,null,100.0,100.0,0,0,1091760,11,30,06,2,2018,2018-06-30,3,2018,1091760,11
Bureau,Department of Commerce,NOAA,null,100.0,100.0,0,0,3803242,592,30,06,2,2018,2018-06-30,3,2018,3803242,592
Agency,The Judiciary,null,Non-CFO,100.0,100.0,0,0,1561247,224,30,06,2,2018,2018-06-30,3,2018,1561247,224
Bureau,Department of the Treasury,Office of Financial Research,null,0.0,0.0,0,0,0,0,30,06,2,2018,2018-06-30,3,2018,0,0
Bureau,Department of State,Department of State,null,95.09708435266288,99.0340909090909,697662,51,13531871,5229,30,06,2,2018,2018-06-30,3,2018,14229533,5280
Bureau,Department of Transportation,National Highway Traffic Safety Admin.,null,100.0,100.0,0,0,7637264,4,30,06,2,2018,2018-06-30,3,2018,7637264,4
Bureau,Legislative Branch - U.S. House/Senate,U.S. House of Representatives,null,0.0,0.0,228379,254,0,0,30,06,2,2018,2018-06-30,3,2018,228379,254
Bureau,Department of the Treasury,International Monetary Funds,null,0.0,0.0,0,0,0,0,30,06,2,2018,2018-06-30,3,2018,0,0
Agency,Department of Homeland Security,null,CFO,100.0,100.0,0,0,356971430,59589,30,06,2,2018,2018-06-30,3,2018,356971430,59589
Agency,Neighborhood Reinvestment Corporation,null,Non-CFO,0.0,0.0,0,0,0,0,30,06,2,2018,2018-06-30,3,2018,0,0
Bureau,Other Agencies,Denali Commission,null,0.0,0.0,0,0,0,0,30,06,2,2018,2018-06-30,3,2018,0,0
Bureau,Department of Labor,Bureau of Labor Statistics,null,100.0,100.0,0,0,10969,1,30,06,2,2018,2018-06-30,3,2018,10969,1
Agency,Federal Labor Relations Authority,null,Non-CFO,0.0,0.0,0,0,0,0,30,06,2,2018,2018-06-30,3,2018,0,0
Bureau,Other Agencies,U.S. Inst. for Env. Conflict Resolution,null,0.0,0.0,2429,9,0,0,30,06,2,2018,2018-06-30,3,2018,2429,9
Bureau,The Judiciary,Administrative Office of the U.S. Courts,null,100.0,100.0,0,0,1561247,224,30,06,2,2018,2018-06-30,3,2018,1561247,224
Bureau,Department of Transportation,Office of the Secretary,null,100.0,100.0,0,0,1639207,24,30,06,2,2018,2018-06-30,3,2018,1639207,24
Agency,Department of Energy,null,CFO,100.0,100.0,0,0,30213452,125,30,06,2,2018,2018-06-30,3,2018,30213452,125
Bureau,Department of State,International Commissions,null,0.0,0.0,0,0,0,0,30,06,2,2018,2018-06-30,3,2018,0,0
Bureau,Department of Veterans Affairs,Life Insurance,null,100.0,100.0,0,0,477142,82,30,06,2,2018,2018-06-30,3,2018,477142,82
Bureau,Department of Commerce,Office of the Inspector General,null,0.0,0.0,0,0,0,0,30,06,2,2018,2018-06-30,3,2018,0,0
Bureau,Merit Systems Protection Board,Merit Systems Protection Board,null,100.0,100.0,0,0,120,1,30,06,2,2018,2018-06-30,3,2018,120,1
Bureau,Department of the Treasury,Treasury Forfeiture Fund,null,0.0,0.0,0,0,0,0,30,06,2,2018,2018-06-30,3,2018,0,0
Bureau,Department of Housing and Urban Development,Public and Indian Housing Programs,null,0.0,0.0,0,0,0,0,30,06,2,2018,2018-06-30,3,2018,0,0
Agency,Nuclear Regulatory Commission,null,CFO,82.97142505069662,89.91935483870968,254270,25,1238926,223,30,06,2,2018,2018-06-30,3,2018,1493196,248
Bureau,Office of Government Ethics,Office of Government Ethics,null,0.0,0.0,0,0,0,0,30,06,2,2018,2018-06-30,3,2018,0,0
Bureau,Department of Homeland Security,Transportation Safety Administration,null,100.0,100.0,0,0,10321946,4869,30,06,2,2018,2018-06-30,3,2018,10321946,4869
Agency,National Aeronautics and Space Administration,null,CFO,100.0,100.0,0,0,2504436,94,30,06,2,2018,2018-06-30,3,2018,2504436,94
Bureau,Environmental Protection Agency,Environmental Protection Agency,null,100.0,100.0,0,0,15763320,200,30,06,2,2018,2018-06-30,3,2018,15763320,200
Bureau,Department of Energy,Energy Consolidated Reports,null,100.0,100.0,0,0,29106294,95,30,06,2,2018,2018-06-30,3,2018,29106294,95
Bureau,Office of Special Counsel,Office of Special Counsel,null,0.0,0.0,0,0,0,0,30,06,2,2018,2018-06-30,3,2018,0,0
Bureau,Department of the Interior,Office of the Secretary,null,100.0,100.0,0,0,19899,16,30,06,2,2018,2018-06-30,3,2018,19899,16
Bureau,Department of the Treasury,D.C. Pension Program,null,100.0,100.0,0,0,143990,13,30,06,2,2018,2018-06-30,3,2018,143990,13
Bureau,Department of the Interior,Bureau of Land Management,null,100.0,100.0,0,0,12742958,288,30,06,2,2018,2018-06-30,3,2018,12742958,288
Bureau,Other Agencies,National Mediation Board,null,0.0,0.0,0,0,0,0,30,06,2,2018,2018-06-30,3,2018,0,0
Bureau,Department of Health & Human Services,Administration for Children and Families,null,100.0,100.0,0,0,22199390,1238,30,06,2,2018,2018-06-30,3,2018,22199390,1238
Bureau,Department of the Interior,"Bureau of Ocean Energy Mgmt., Reg & Enf",null,100.0,100.0,0,0,166,1,30,06,2,2018,2018-06-30,3,2018,166,1
Bureau,Department of Justice,Federal Prison Industries,null,100.0,100.0,0,0,1043089,183,30,06,2,2018,2018-06-30,3,2018,1043089,183
Bureau,Department of Homeland Security,U.S. Coast Guard,null,100.0,100.0,0,0,59385180,8570,30,06,2,2018,2018-06-30,3,2018,59385180,8570
Bureau,Department of the Treasury,U.S. Mint,null,100.0,100.0,0,0,32924,11,30,06,2,2018,2018-06-30,3,2018,32924,11
Bureau,National Science Foundation,National Science Foundation,null,100.0,100.0,0,0,663531,129,30,06,2,2018,2018-06-30,3,2018,663531,129
Bureau,Department of Commerce,Economic Development Administration,null,100.0,100.0,0,0,1307589,1,30,06,2,2018,2018-06-30,3,2018,1307589,1
Agency,Commodity Futures Trading Commission,null,Non-CFO,100.0,100.0,0,0,592082424,352,30,06,2,2018,2018-06-30,3,2018,592082424,352
Bureau,Department of Housing and Urban Development,Management and Administration,null,0.0,0.0,0,0,0,0,30,06,2,2018,2018-06-30,3,2018,0,0
Bureau,National Labor Relations Board,National Labor Relations Board,null,0.0,0.0,0,0,0,0,30,06,2,2018,2018-06-30,3,2018,0,0
Bureau,Other Agencies,Architect of the Capitol,null,0.0,0.0,0,0,0,0,30,06,2,2018,2018-06-30,3,2018,0,0
Bureau,Department of Education,Departmental Management,null,99.86998833098814,99.00176159718144,824180,17,633103533,1686,30,06,2,2018,2018-06-30,3,2018,633927713,1703
Bureau,Smithsonian Institution,JFK Center for the Performing Arts,null,0.0,0.0,0,0,0,0,30,06,2,2018,2018-06-30,3,2018,0,0
Agency,Legislative Branch-GPO,null,Non-CFO,0.0,0.0,132296,86,0,0,30,06,2,2018,2018-06-30,3,2018,132296,86
Bureau,Department of Veterans Affairs,Veterans Benefits,null,99.7671602079061,98.67659093566112,1292315,1698,553730943,126607,30,09,3,2018,2018-09-30,4,2018,555023258,128305
Bureau,Department of Health & Human Services,Centers for Medicare & Medicaid Services,null,97.30705320627263,99.38872535375602,315122305,10871,11386642681,1767544,30,09,3,2018,2018-09-30,4,2018,11701764986,1778415
Bureau,Department of Transportation,Pipeline Hazardous Material Safety Admin,null,100.0,100.0,0,0,378144,22,30,09,3,2018,2018-09-30,4,2018,378144,22
Bureau,Department of Veterans Affairs,Housing Credit Assistance,null,25.78032395247856,51.666666666666664,1459547,29,506976,31,30,09,3,2018,2018-09-30,4,2018,1966523,60
Bureau,Department of Commerce,Patent and Trademark Office,null,100.0,100.0,0,0,354050,542,30,09,3,2018,2018-09-30,4,2018,354050,542
Bureau,Department of Agriculture,Rural Development,null,99.9992294464027,99.99690105054387,5007,1,649787560,32268,30,09,3,2018,2018-09-30,4,2018,649792567,32269
Bureau,Department of Homeland Security,Office of the Inspector General DHS,null,100.0,100.0,0,0,1457,4,30,09,3,2018,2018-09-30,4,2018,1457,4
Bureau,Department of the Treasury,Financial Crimes Enforcement Network,null,100.0,100.0,0,0,45000,2,30,09,3,2018,2018-09-30,4,2018,45000,2
Bureau,Department of Housing and Urban Development,Management and Administration,null,0.0,0.0,0,0,0,0,30,09,3,2018,2018-09-30,4,2018,0,0
Bureau,Department of Housing and Urban Development,Public and Indian Housing Programs,null,0.0,0.0,0,0,0,0,30,09,3,2018,2018-09-30,4,2018,0,0
Bureau,Farm Credit Administration,Farm Credit System Insurance Corporation,null,0.0,0.0,0,0,0,0,30,09,3,2018,2018-09-30,4,2018,0,0
Bureau,Overseas Private Investment Corp Accts,Overseas Private Investment Corp Accts,null,0.0,0.0,0,0,0,0,30,09,3,2018,2018-09-30,4,2018,0,0
Bureau,National Foundation  Arts & Humanities,National Endowment for the Arts,null,0.0,0.0,0,0,0,0,30,09,3,2018,2018-09-30,4,2018,0,0
Bureau,Department of the Interior,"Bureau of Ocean Energy Mgmt., Reg & Enf",null,100.0,100.0,0,0,166,1,30,09,3,2018,2018-09-30,4,2018,166,1
Bureau,Funds Appropriated to the President,Inter-American Foundation,null,0.0,0.0,0,0,0,0,30,09,3,2018,2018-09-30,4,2018,0,0
Bureau,Department of Health & Human Services,Office of the Inspector General,null,0.0,0.0,0,0,0,0,30,09,3,2018,2018-09-30,4,2018,0,0
Bureau,Department of Homeland Security,U.S. Secret Service,null,0.0,0.0,0,0,0,0,30,09,3,2018,2018-09-30,4,2018,0,0
Bureau,Department of Commerce,Nat'l Telecomm & Information Admin.,null,100.0,100.0,0,0,2903,1,30,09,3,2018,2018-09-30,4,2018,2903,1
Bureau,Department of Agriculture,U.S. Department of Agriculture,null,65.43877573589424,52.44167962674961,8875621,1529,16805243,1686,30,09,3,2018,2018-09-30,4,2018,25680864,3215
Agency,Department of Defense,null,CFO,52.39534350622283,21.205766550096598,1208889669,1159911,1330546088,312165,30,09,3,2018,2018-09-30,4,2018,2539435757,1472076
Bureau,National Credit Union Administration,Nat'l Credit Union Admin. Treasury Acct.,null,0.0,0.0,0,0,0,0,30,09,3,2018,2018-09-30,4,2018,0,0
Bureau,Other Agencies,U.S. Institute of Peace,null,0.0,0.0,0,0,0,0,30,09,3,2018,2018-09-30,4,2018,0,0
Bureau,Other Agencies,Chemical Safety Board,null,0.0,0.0,0,0,0,0,30,09,3,2018,2018-09-30,4,2018,0,0
Bureau,Federal Mediation/Conciliation Service,Federal Mediation/Conciliation Service,null,0.0,0.0,0,0,0,0,30,09,3,2018,2018-09-30,4,2018,0,0
Bureau,Department of Education,Office of Postsecondary Education,null,0.0,0.0,0,0,0,0,30,09,3,2018,2018-09-30,4,2018,0,0
Bureau,Smithsonian Institution,Administrative Conference of the US,null,0.0,0.0,0,0,0,0,30,09,3,2018,2018-09-30,4,2018,0,0
Bureau,Department of the Treasury,Treasury Forfeiture Fund,null,0.0,0.0,0,0,0,0,30,09,3,2018,2018-09-30,4,2018,0,0
Bureau,Smithsonian Institution,National Gallery of Art,null,0.0,0.0,0,0,0,0,30,09,3,2018,2018-09-30,4,2018,0,0
Bureau,Department of Housing and Urban Development,"Policy, Development and Research",null,0.0,0.0,0,0,0,0,30,09,3,2018,2018-09-30,4,2018,0,0
Bureau,Department of Agriculture,Commodity Credit Corporation,null,99.87978368321696,99.9517188103515,136468,5,113382232,10351,30,09,3,2018,2018-09-30,4,2018,113518700,10356
Agency,Social Security Administration,null,CFO,28.067446200327257,12.45050945435425,4960102951,2432616,1935388296,345945,30,09,3,2018,2018-09-30,4,2018,6895491247,2778561
Bureau,Funds Appropriated to the President,African Development Foundation,null,0.0,0.0,0,0,0,0,30,09,3,2018,2018-09-30,4,2018,0,0
Bureau,Other Agencies,National Capital Planning Commission,null,0.0,0.0,0,0,0,0,30,09,3,2018,2018-09-30,4,2018,0,0
Bureau,National Credit Union Administration,National Credit Union Administration,null,0.0,0.0,0,0,0,0,30,09,3,2018,2018-09-30,4,2018,0,0
Bureau,Department of the Treasury,Departmental Offices,null,94.50869853493816,98.1786643538595,2156731,21,37118676,1132,30,09,3,2018,2018-09-30,4,2018,39275407,1153
Agency,Department of Commerce,null,CFO,100.0,100.0,0,0,7159495,1336,30,09,3,2018,2018-09-30,4,2018,7159495,1336
Agency,Farm Credit Administration,null,Non-CFO,100.0,100.0,0,0,604,1,30,09,3,2018,2018-09-30,4,2018,604,1
Agency,Other Agencies/Boards/Commissions,null,Non-CFO,0.0,0.0,0,0,0,0,30,09,3,2018,2018-09-30,4,2018,0,0
Agency,Department of Transportation,null,CFO,99.91454591581979,99.5775969962453,52980,27,61945227,6365,30,09,3,2018,2018-09-30,4,2018,61998207,6392
Bureau,Federal Maritime Commission,Salaries and Expenses,null,99.77031518914724,63.63636363636363,1089,4,473039,7,30,09,3,2018,2018-09-30,4,2018,474128,11
Bureau,Department of Justice,Bureau of ATF and Explosives,null,100.0,100.0,0,0,23927,5,30,09,3,2018,2018-09-30,4,2018,23927,5
Bureau,Office of Personnel Management,Office of Personnel Management,null,81.5371175920294,75.98343685300208,4104858,348,18128171,1101,30,09,3,2018,2018-09-30,4,2018,22233029,1449
Bureau,Corp. for National and Community Service,Corp. for National and Community Service,null,97.92764927455435,93.38235294117646,74196,18,3506086,254,30,09,3,2018,2018-09-30,4,2018,3580282,272
Bureau,Department of Labor,Occupational Safety and Health Admin,null,92.62686818670193,76.52994791666667,2181630,721,27407289,2351,30,09,3,2018,2018-09-30,4,2018,29588919,3072
Agency,Office of Compliance,null,Non-CFO,0.0,0.0,0,0,0,0,30,09,3,2018,2018-09-30,4,2018,0,0
Bureau,Department of Transportation,Office of the Secretary,null,100.0,100.0,0,0,1301754,22,30,09,3,2018,2018-09-30,4,2018,1301754,22
Bureau,Department of State,Department of State,null,97.76718075035566,98.72146118721462,362263,70,15862203,5405,30,09,3,2018,2018-09-30,4,2018,16224466,5475
Bureau,Department of the Treasury,U.S. Treasury IG Office,null,0.0,0.0,0,0,0,0,30,09,3,2018,2018-09-30,4,2018,0,0
Agency,Smithsonian Institution,null,Non-CFO,0.0,0.0,1065,2,0,0,30,09,3,2018,2018-09-30,4,2018,1065,2
Bureau,Other Agencies,Comm. for Purchase from Blind/Handic.,null,0.0,0.0,0,0,0,0,30,09,3,2018,2018-09-30,4,2018,0,0
Bureau,Other Agencies,James Madison Memorial Fellowship,null,0.0,0.0,228525,21,0,0,30,09,3,2018,2018-09-30,4,2018,228525,21
Bureau,Funds Appropriated to the President,Executive Branch,null,0.0,0.0,0,0,0,0,30,09,3,2018,2018-09-30,4,2018,0,0
Bureau,Other Agencies,Advisory Council on Hist. Preservation,null,0.0,0.0,0,0,0,0,30,09,3,2018,2018-09-30,4,2018,0,0
Bureau,Department of Homeland Security,Federal Law Enforcement Training Ctr.,null,100.0,100.0,0,0,4915,1,30,09,3,2018,2018-09-30,4,2018,4915,1
Bureau,Department of Transportation,Federal Railroad Administration,null,100.0,100.0,0,0,239362,17,30,09,3,2018,2018-09-30,4,2018,239362,17
Bureau,Department of the Treasury,U.S. Mint,null,100.0,100.0,0,0,33459,13,30,09,3,2018,2018-09-30,4,2018,33459,13
Bureau,Department of Commerce,Office of the Inspector General,null,0.0,0.0,0,0,0,0,30,09,3,2018,2018-09-30,4,2018,0,0
Bureau,Other Agencies,Federal Mine Safety & Health Review Comm,null,0.0,0.0,0,0,0,0,30,09,3,2018,2018-09-30,4,2018,0,0
Bureau,Other Agencies,Consumer Financial Protection Bureau,null,0.0,0.0,219672,61,0,0,30,09,3,2018,2018-09-30,4,2018,219672,61
Bureau,Department of Justice,Federal Bureau of Investigation,null,0.0,0.0,357247,87,0,0,30,09,3,2018,2018-09-30,4,2018,357247,87
Bureau,Department of the Interior,Office of Natural Resources Revenue,null,100.0,100.0,0,0,8928921,397,30,09,3,2018,2018-09-30,4,2018,8928921,397
Bureau,Department of Health & Human Services,Administration for Community Living,null,0.0,0.0,0,0,0,0,30,09,3,2018,2018-09-30,4,2018,0,0
Bureau,Department of Homeland Security,Science and Technology,null,0.0,0.0,0,0,0,0,30,09,3,2018,2018-09-30,4,2018,0,0
Bureau,Department of the Treasury,D.C. Pension Program,null,100.0,100.0,0,0,296127,15,30,09,3,2018,2018-09-30,4,2018,296127,15
Bureau,Department of Justice,U.S. Marshals Service,null,0.0,0.0,0,0,0,0,30,09,3,2018,2018-09-30,4,2018,0,0
Bureau,Funds Appropriated to the President,Peace Corps,null,0.0,0.0,0,0,0,0,30,09,3,2018,2018-09-30,4,2018,0,0
Agency,General Services Administration,null,CFO,68.44008962889748,89.77006100422336,4913167,436,10654580,3826,30,09,3,2018,2018-09-30,4,2018,15567747,4262
Agency,Environmental Protection Agency,null,CFO,100.0,100.0,0,0,15865559,201,30,09,3,2018,2018-09-30,4,2018,15865559,201
Agency,Department of State,null,CFO,98.06993721141002,99.6702313091817,362263,70,18407230,21157,30,09,3,2018,2018-09-30,4,2018,18769493,21227
Agency,Agency for International Development,null,CFO,99.99871125748116,98.18181818181819,372,1,28864975,54,30,09,3,2018,2018-09-30,4,2018,28865347,55
Agency,Department of the Treasury,null,CFO,95.59395401194796,99.67750981491868,2548230,23,55286618,7109,30,09,3,2018,2018-09-30,4,2018,57834848,7132
Bureau,Department of Energy,Energy Consolidated Reports,null,100.0,100.0,0,0,31601438,98,30,09,3,2018,2018-09-30,4,2018,31601438,98
Agency,Department of Justice,null,CFO,98.62836283860005,99.4184517373389,1080754,199,77712241,34020,30,09,3,2018,2018-09-30,4,2018,78792995,34219
Agency,Department of Housing and Urban Development,null,CFO,99.94901894616582,99.90657116163189,80251,6,157333129,6416,30,09,3,2018,2018-09-30,4,2018,157413380,6422
Bureau,Department of the Treasury,Interest on Tax/Deposit of Earnings,null,100.0,100.0,0,0,3240,2,30,09,3,2018,2018-09-30,4,2018,3240,2
Agency,Department of Labor,null,CFO,83.28994761046506,67.74804842176717,37167837,11403,185260173,23953,30,09,3,2018,2018-09-30,4,2018,222428010,35356
Agency,Department of Veterans Affairs,null,CFO,91.37663777128725,98.4841581633384,102492047,126960,1086047229,8248584,30,09,3,2018,2018-09-30,4,2018,1188539276,8375544
Agency,Department of Agriculture,null,CFO,98.97052676308004,94.51453647833242,16242343,3500,1561491047,60305,30,09,3,2018,2018-09-30,4,2018,1577733390,63805
Agency,Department of Health & Human Services,null,CFO,96.933584407039,99.04495736257,365729081,17076,11561195692,1770907,30,09,3,2018,2018-09-30,4,2018,11926924773,1787983
Agency,Office of Government Ethics,null,Non-CFO,0.0,0.0,0,0,0,0,30,09,3,2018,2018-09-30,4,2018,0,0
Agency,Overseas Private Investment Corp Accts,null,Non-CFO,0.0,0.0,0,0,0,0,30,09,3,2018,2018-09-30,4,2018,0,0
Agency,National Credit Union Administration,null,Non-CFO,0.0,0.0,0,0,0,0,30,09,3,2018,2018-09-30,4,2018,0,0
Agency,Legislative Branch-CBO,null,Non-CFO,0.0,0.0,0,0,0,0,30,09,3,2018,2018-09-30,4,2018,0,0
Agency,Legislative Branch-GAO,null,Non-CFO,100.0,100.0,0,0,28857,11,30,09,3,2018,2018-09-30,4,2018,28857,11
Agency,Armed Forces Retirement Home,null,Non-CFO,92.80420445703061,92.92929292929293,5641,7,72752,92,30,09,3,2018,2018-09-30,4,2018,78393,99
Bureau,Department of the Treasury,Office of Financial Research,null,0.0,0.0,0,0,0,0,30,09,3,2018,2018-09-30,4,2018,0,0
Bureau,Other Agencies,U.S. Holocaust Memorial Council,null,0.0,0.0,0,0,0,0,30,09,3,2018,2018-09-30,4,2018,0,0
Bureau,Department of the Treasury,Office of Sec International Affairs,null,0.0,0.0,0,0,0,0,30,09,3,2018,2018-09-30,4,2018,0,0
Bureau,Legislative Branch-Office of Tech.,Medicaid & CHIP Payment & Access Comm.,null,0.0,0.0,0,0,0,0,30,09,3,2018,2018-09-30,4,2018,0,0
Bureau,Tennessee Valley Authority,Tennessee Valley Authority,null,0.0,0.0,0,0,0,0,30,09,3,2018,2018-09-30,4,2018,0,0
Bureau,Neighborhood Reinvestment Corporation,Neighborhood Reinvestment Corporation,null,0.0,0.0,0,0,0,0,30,09,3,2018,2018-09-30,4,2018,0,0
Bureau,Other Agencies,Federal Housing Finance Agency OIG,null,0.0,0.0,0,0,0,0,30,09,3,2018,2018-09-30,4,2018,0,0
Bureau,Other Agencies,District of Columbia Government,null,0.0,0.0,0,0,0,0,30,09,3,2018,2018-09-30,4,2018,0,0
Bureau,Other Agencies,Election Assistance Commission,null,0.0,0.0,0,0,0,0,30,09,3,2018,2018-09-30,4,2018,0,0
Bureau,Department of Commerce,Economic and Statistical Analysis,null,0.0,0.0,0,0,0,0,30,09,3,2018,2018-09-30,4,2018,0,0
Bureau,Other Agencies,National Transportation Safety Board,null,0.0,0.0,0,0,0,0,30,09,3,2018,2018-09-30,4,2018,0,0
Bureau,Federal Labor Relations Authority,Federal Labor Relations Authority,null,0.0,0.0,0,0,0,0,30,09,3,2018,2018-09-30,4,2018,0,0
Bureau,National Foundation  Arts & Humanities,National Endowment for the Humanities,null,0.0,0.0,0,0,0,0,30,09,3,2018,2018-09-30,4,2018,0,0
Agency,Merit Systems Protection Board,null,Non-CFO,100.0,100.0,0,0,133,1,30,09,3,2018,2018-09-30,4,2018,133,1
Bureau,Legislative Branch-CBO,Congressional Budget Office,null,0.0,0.0,0,0,0,0,30,09,3,2018,2018-09-30,4,2018,0,0
Bureau,Department of Labor,Departmental Management,null,0.0,0.0,0,0,0,0,30,09,3,2018,2018-09-30,4,2018,0,0
Bureau,Department of the Treasury,Treasury Franchise Fund,null,0.0,0.0,0,0,0,0,30,09,3,2018,2018-09-30,4,2018,0,0
Bureau,Other Agencies,Denali Commission,null,0.0,0.0,0,0,0,0,30,09,3,2018,2018-09-30,4,2018,0,0
Bureau,Smithsonian Institution,Smithsonian Institution,null,0.0,0.0,0,0,0,0,30,09,3,2018,2018-09-30,4,2018,0,0
Bureau,National Labor Relations Board,National Labor Relations Board,null,0.0,0.0,0,0,0,0,30,09,3,2018,2018-09-30,4,2018,0,0
Agency,Consumer Product Safety Commission,null,Non-CFO,100.0,100.0,0,0,462,1,30,09,3,2018,2018-09-30,4,2018,462,1
Bureau,Department of Commerce,National Technical Information Service,null,0.0,0.0,0,0,0,0,30,09,3,2018,2018-09-30,4,2018,0,0
Bureau,Department of Homeland Security,Domestic Nuclear Detection Office,null,0.0,0.0,0,0,0,0,30,09,3,2018,2018-09-30,4,2018,0,0
Bureau,Department of the Interior,Bureau of Indian Affairs,null,98.98956377982145,98.69116987897803,101300,292,9924073,22018,30,09,3,2018,2018-09-30,4,2018,10025373,22310
Bureau,Office of Compliance,Office of Compliance,null,0.0,0.0,0,0,0,0,30,09,3,2018,2018-09-30,4,2018,0,0
Bureau,Other Agencies,Defense Nuclear Facilities Safety Board,null,0.0,0.0,0,0,0,0,30,09,3,2018,2018-09-30,4,2018,0,0
Agency,Office of Personnel Management,null,CFO,81.5371175920294,75.98343685300208,4104858,348,18128171,1101,30,09,3,2018,2018-09-30,4,2018,22233029,1449
Agency,Equal Employment Opportunity Commission,null,Non-CFO,100.0,100.0,0,0,33402,22,30,09,3,2018,2018-09-30,4,2018,33402,22
Bureau,Department of Homeland Security,Management Headquarters,null,0.0,0.0,0,0,0,0,30,09,3,2018,2018-09-30,4,2018,0,0
Bureau,Department of the Treasury,Bureau of Public Debt,null,0.0,0.0,0,0,0,0,30,09,3,2018,2018-09-30,4,2018,0,0
Bureau,Legislative Branch-Office of Tech.,Open World Leadership,null,0.0,0.0,0,0,0,0,30,09,3,2018,2018-09-30,4,2018,0,0
Bureau,Department of Homeland Security,Office of Biometric Identity Management,null,0.0,0.0,0,0,0,0,30,09,3,2018,2018-09-30,4,2018,0,0
Bureau,Department of Transportation,Surface Transportation Board,null,0.0,0.0,0,0,0,0,30,09,3,2018,2018-09-30,4,2018,0,0
Bureau,Department of Transportation,Federal Highway Administration,null,100.0,100.0,0,0,8932,8,30,09,3,2018,2018-09-30,4,2018,8932,8
Bureau,Department of the Interior,Office of Surface Mining,null,100.0,100.0,0,0,2074668,237,30,09,3,2018,2018-09-30,4,2018,2074668,237
Bureau,Department of Labor,Employment and Training Administration,null,100.0,100.0,0,0,2811570,2,30,09,3,2018,2018-09-30,4,2018,2811570,2
Bureau,Department of Transportation,Office of the Inspector General,null,100.0,100.0,0,0,212,1,30,09,3,2018,2018-09-30,4,2018,212,1
Bureau,Consumer Product Safety Commission,Consumer Product Safety Commission,null,100.0,100.0,0,0,462,1,30,09,3,2018,2018-09-30,4,2018,462,1
Bureau,U.S. Court of Appeals / Veterans Claims,U.S. Court of Appeals / Veterans Claims,null,0.0,0.0,3458,14,0,0,30,09,3,2018,2018-09-30,4,2018,3458,14
Agency,National Archives & Records Admin,null,Non-CFO,100.0,100.0,0,0,126170,275,30,09,3,2018,2018-09-30,4,2018,126170,275
Bureau,Other Agencies,Morris K. Udall Scholarship,null,0.0,0.0,982,1,0,0,30,09,3,2018,2018-09-30,4,2018,982,1
Bureau,Smithsonian Institution,JFK Center for the Performing Arts,null,0.0,0.0,1065,2,0,0,30,09,3,2018,2018-09-30,4,2018,1065,2
Bureau,Federal Trade Commission,Federal Trade Commission,null,100.0,100.0,0,0,483091358,56,30,09,3,2018,2018-09-30,4,2018,483091358,56
Agency,Legislative Branch - U.S. House/Senate,null,Non-CFO,0.0,0.0,267891,255,0,0,30,09,3,2018,2018-09-30,4,2018,267891,255
Agency,The Judiciary,null,Non-CFO,100.0,100.0,0,0,1628320,281,30,09,3,2018,2018-09-30,4,2018,1628320,281
Bureau,Department of Health & Human Services,Centers for Disease Control,null,73.32234587168006,40.625,18291,19,50272,13,30,09,3,2018,2018-09-30,4,2018,68563,32
Bureau,Other Agencies,Architect of the Capitol,null,0.0,0.0,169134,69,0,0,30,09,3,2018,2018-09-30,4,2018,169134,69
Bureau,Department of the Interior,Geological Survey,null,100.0,100.0,0,0,285415,134,30,09,3,2018,2018-09-30,4,2018,285415,134
Bureau,National Science Foundation,National Science Foundation,null,100.0,100.0,0,0,691837,115,30,09,3,2018,2018-09-30,4,2018,691837,115
Bureau,Department of Transportation,Federal Transit Administration,null,100.0,100.0,0,0,784322,2,30,09,3,2018,2018-09-30,4,2018,784322,2
Agency,Federal Maritime Commission,null,Non-CFO,99.77031518914724,63.63636363636363,1089,4,473039,7,30,09,3,2018,2018-09-30,4,2018,474128,11
Bureau,Funds Appropriated to the President,Trade and Development Agency,null,100.0,100.0,0,0,791105,4,30,09,3,2018,2018-09-30,4,2018,791105,4
Bureau,Department of Agriculture,Food Safety and Inspection Service,null,100.0,100.0,0,0,964525,942,30,09,3,2018,2018-09-30,4,2018,964525,942
Bureau,Presidio Trust Corporation,Presidio Trust Corporation,null,96.99931008119111,89.74358974358974,39405,8,1273793,70,30,09,3,2018,2018-09-30,4,2018,1313198,78
Bureau,Department of State,Passport NSF,null,100.0,100.0,0,0,2545027,15752,30,09,3,2018,2018-09-30,4,2018,2545027,15752
Bureau,Department of Agriculture,Food and Nutrition Service,null,23.782284538259546,15.789473684210526,1986505,144,619851,27,30,09,3,2018,2018-09-30,4,2018,2606356,171
Bureau,Department of the Treasury,Community Dev Financial Inst Fund,null,88.93165252975432,85.71428571428571,391000,1,3141596,6,30,09,3,2018,2018-09-30,4,2018,3532596,7
Agency,U.S. Court of Appeals / Veterans Claims,null,Non-CFO,0.0,0.0,3458,14,0,0,30,09,3,2018,2018-09-30,4,2018,3458,14
Agency,Federal Election Commission,null,Non-CFO,100.0,100.0,0,0,607916,84,30,09,3,2018,2018-09-30,4,2018,607916,84
Agency,Other Agencies,null,Non-CFO,1.6789461014114486,2.9411764705882355,620807,165,10601,5,30,09,3,2018,2018-09-30,4,2018,631408,170
Agency,Funds Appropriated to the President,null,Non-CFO,100.0,100.0,0,0,791105,4,30,09,3,2018,2018-09-30,4,2018,791105,4
Agency,Presidio Trust Corporation,null,Non-CFO,96.99931008119111,89.74358974358974,39405,8,1273793,70,30,09,3,2018,2018-09-30,4,2018,1313198,78
Bureau,Department of Health & Human Services,National Institutes of Health,null,38.36883669181052,20.37037037037037,7131353,301,4439665,77,30,09,3,2018,2018-09-30,4,2018,11571018,378
Agency,Corp. for National and Community Service,null,Non-CFO,97.92764927455435,93.38235294117646,74196,18,3506086,254,30,09,3,2018,2018-09-30,4,2018,3580282,272
Agency,Railroad Retirement Board,null,Non-CFO,100.0,100.0,0,0,18406076,3858,30,09,3,2018,2018-09-30,4,2018,18406076,3858
Bureau,Department of Justice,Federal Prison Industries,null,100.0,100.0,0,0,1043089,183,30,09,3,2018,2018-09-30,4,2018,1043089,183
Bureau,Department of Transportation,Federal Aviation Administration,null,98.5618766891087,94.88888888888889,52814,23,3619611,427,30,09,3,2018,2018-09-30,4,2018,3672425,450
Agency,U.S. Postal Service,null,Non-CFO,65.42879122597111,78.51615937072503,19552535,10051,37004744,36733,30,09,3,2018,2018-09-30,4,2018,56557279,46784
Agency,Federal Communications Commission,null,Non-CFO,100.0,100.0,0,0,194539120,11423,30,09,3,2018,2018-09-30,4,2018,194539120,11423
Bureau,Department of Health & Human Services,Indian Health Services,null,53.31222636010485,5.496828752642706,19103516,2682,21814083,156,30,09,3,2018,2018-09-30,4,2018,40917599,2838
Bureau,Department of Health & Human Services,Food and Drug Administration,null,48.65551500728256,18.56089499110094,24353616,3203,23078189,730,30,09,3,2018,2018-09-30,4,2018,47431805,3933
Bureau,Department of the Treasury,Office of the Secretary,null,0.0,0.0,0,0,0,0,30,09,3,2018,2018-09-30,4,2018,0,0
Bureau,Department of Transportation,Federal Motor Carrier Safety Admin,null,99.99965426119022,99.93165897830173,166,4,48012957,5849,30,09,3,2018,2018-09-30,4,2018,48013123,5853
Bureau,Department of Housing and Urban Development,Housing Programs,null,99.94901894616582,99.90657116163189,80251,6,157333129,6416,30,09,3,2018,2018-09-30,4,2018,157413380,6422
Bureau,Department of State,Civil Monetary Penalties,null,0.0,0.0,0,0,0,0,30,09,3,2018,2018-09-30,4,2018,0,0
Bureau,Federal Communications Commission,Federal Communications Commission,null,100.0,100.0,0,0,194539120,11423,30,09,3,2018,2018-09-30,4,2018,194539120,11423
Bureau,Department of Agriculture,Farm Service Agency,null,100.0,100.0,0,0,725428300,13741,30,09,3,2018,2018-09-30,4,2018,725428300,13741
Bureau,Department of Defense,Consolidated Report,null,52.39534350622283,21.205766550096598,1208889669,1159911,1330546088,312165,30,09,3,2018,2018-09-30,4,2018,2539435757,1472076
Bureau,Social Security Administration,Social Security Administration,null,28.067446200327257,12.45050945435425,4960102951,2432616,1935388296,345945,30,09,3,2018,2018-09-30,4,2018,6895491247,2778561
Agency,Federal Trade Commission,null,Non-CFO,100.0,100.0,0,0,483091358,56,30,09,3,2018,2018-09-30,4,2018,483091358,56
Bureau,Other Agencies,Delta Regional Authority,null,0.0,0.0,0,0,0,0,30,09,3,2018,2018-09-30,4,2018,0,0
Bureau,Small Business Administration,Small Business Administration,null,99.86505450729707,99.90234628181308,15743403,113,11650747033,115602,30,09,3,2018,2018-09-30,4,2018,11666490436,115715
Agency,Securities & Exchange Commission,null,Non-CFO,100.0,100.0,0,0,2526304694,928,30,09,3,2018,2018-09-30,4,2018,2526304694,928
Bureau,Department of Commerce,Nat'l Institute of Standards& Technology,null,100.0,100.0,0,0,1091421,10,30,09,3,2018,2018-09-30,4,2018,1091421,10
Bureau,Other Agencies/Boards/Commissions,U.S. Comm. on Int. Religious Freedom,null,0.0,0.0,0,0,0,0,30,09,3,2018,2018-09-30,4,2018,0,0
Bureau,Department of the Interior,Fish and Wildlife Service,null,100.0,100.0,0,0,594988,98,30,09,3,2018,2018-09-30,4,2018,594988,98
Bureau,Department of the Treasury,Comptroller of the Currency,null,99.95720932785201,96.42857142857143,499,1,1165643,27,30,09,3,2018,2018-09-30,4,2018,1166142,28
Bureau,Nuclear Regulatory Commission,Nuclear Regulatory Commission,null,100.0,100.0,0,0,1591754,261,30,09,3,2018,2018-09-30,4,2018,1591754,261
Bureau,U.S. Postal Service,U.S. Postal Service,null,65.42879122597111,78.51615937072503,19552535,10051,37004744,36733,30,09,3,2018,2018-09-30,4,2018,56557279,46784
Bureau,Department of Homeland Security,Emergency Preparedness & Resp,null,100.0,100.0,0,0,268040328,43165,30,09,3,2018,2018-09-30,4,2018,268040328,43165
Bureau,Department of Commerce,Economic Development Administration,null,100.0,100.0,0,0,1307589,1,30,09,3,2018,2018-09-30,4,2018,1307589,1
Bureau,Department of Agriculture,Agricultural Marketing Service,null,58.68781542898342,68.36158192090396,1896057,280,2693526,605,30,09,3,2018,2018-09-30,4,2018,4589583,885
Bureau,Department of Veterans Affairs,Administration and Cemeteries,null,0.4360002439349659,1.9005847953216375,1485695,671,6506,13,30,09,3,2018,2018-09-30,4,2018,1492201,684
Bureau,Securities & Exchange Commission,Securities and Exchange Commission,null,100.0,100.0,0,0,2526304694,928,30,09,3,2018,2018-09-30,4,2018,2526304694,928
Bureau,Department of Housing and Urban Development,Community Planning and Development,null,0.0,0.0,0,0,0,0,30,09,3,2018,2018-09-30,4,2018,0,0
Agency,National Aeronautics and Space Administration,null,CFO,100.0,100.0,0,0,2515049,106,30,09,3,2018,2018-09-30,4,2018,2515049,106
Agency,Federal Labor Relations Authority,null,Non-CFO,0.0,0.0,0,0,0,0,30,09,3,2018,2018-09-30,4,2018,0,0
Bureau,Selective Service System,Selective Service System,null,0.0,0.0,0,0,0,0,30,09,3,2018,2018-09-30,4,2018,0,0
Bureau,Department of Health & Human Services,Office of the Secretary,null,100.0,100.0,0,0,4644,7,30,09,3,2018,2018-09-30,4,2018,4644,7
Bureau,Department of Labor,Bureau of Labor Statistics,null,100.0,100.0,0,0,10969,1,30,09,3,2018,2018-09-30,4,2018,10969,1
Bureau,Department of Health & Human Services,Substance Abuse & Mental Health Admin.,null,100.0,100.0,0,0,687202,13,30,09,3,2018,2018-09-30,4,2018,687202,13
Bureau,Department of the Interior,Bureau of Land Management,null,100.0,100.0,0,0,12803692,280,30,09,3,2018,2018-09-30,4,2018,12803692,280
Bureau,Department of Veterans Affairs,Medical and Construction,null,84.39273929339774,98.48949973000363,98254490,124562,531288976,8121845,30,09,3,2018,2018-09-30,4,2018,629543466,8246407
Bureau,Other Agencies,National Mediation Board,null,0.0,0.0,0,0,0,0,30,09,3,2018,2018-09-30,4,2018,0,0
Bureau,Legis Branch-Library of Congress,Library of Congress,null,0.0,0.0,172204,31,0,0,30,09,3,2018,2018-09-30,4,2018,172204,31
Bureau,Department of Transportation,St. Lawrence Seaway Development Corp.,null,0.0,0.0,0,0,0,0,30,09,3,2018,2018-09-30,4,2018,0,0
Bureau,Other Agencies,Surface Transportation Board,null,0.0,0.0,0,0,0,0,30,09,3,2018,2018-09-30,4,2018,0,0
Bureau,Export - Import  Bank,Export-Import Bank,null,0.0,0.0,0,0,0,0,30,09,3,2018,2018-09-30,4,2018,0,0
Bureau,Other Agencies,National Council on Disability,null,0.0,0.0,467,2,0,0,30,09,3,2018,2018-09-30,4,2018,467,2
Bureau,Department of Commerce,Minority Business Development Agency,null,0.0,0.0,0,0,0,0,30,09,3,2018,2018-09-30,4,2018,0,0
Agency,Department of Homeland Security,null,CFO,100.0,100.0,0,0,372256813,61180,30,09,3,2018,2018-09-30,4,2018,372256813,61180
Bureau,Other Agencies,Gulf Coast Ecosystem Restoration Council,null,0.0,0.0,0,0,0,0,30,09,3,2018,2018-09-30,4,2018,0,0
Agency,Pension Benefit Guaranty Corp,null,Non-CFO,100.0,100.0,0,0,1854564,1589,30,09,3,2018,2018-09-30,4,2018,1854564,1589
Bureau,Department of the Treasury,Treasury IG for Tax Admin,null,0.0,0.0,0,0,0,0,30,09,3,2018,2018-09-30,4,2018,0,0
Bureau,Other Agencies,U.S.  Agency of Global Media,null,100.0,100.0,0,0,10601,5,30,09,3,2018,2018-09-30,4,2018,10601,5
Bureau,Department of Energy,Bonneville Power Administration,null,100.0,100.0,0,0,1104324,31,30,09,3,2018,2018-09-30,4,2018,1104324,31
Bureau,Commodity Futures Trading Commission,Commodity Futures Trading Commission,null,100.0,100.0,0,0,636579921,377,30,09,3,2018,2018-09-30,4,2018,636579921,377
Bureau,Department of Education,Departmental Management,null,99.5124263594663,98.2407916437603,3387077,32,691293012,1787,30,09,3,2018,2018-09-30,4,2018,694680089,1819
Bureau,American Battle Monuments Commission,American Battle Monuments Commission,null,0.0,0.0,0,0,0,0,30,09,3,2018,2018-09-30,4,2018,0,0
Bureau,Equal Employment Opportunity Commission,Equal Employment Opportunity Commission,null,100.0,100.0,0,0,33402,22,30,09,3,2018,2018-09-30,4,2018,33402,22
Agency,Department of the Interior,null,CFO,99.75108809272517,98.84975971007643,101300,292,40595829,25094,30,09,3,2018,2018-09-30,4,2018,40697129,25386
Bureau,Department of Transportation,Research Innovative Technology Admin,null,100.0,100.0,0,0,8808,6,30,09,3,2018,2018-09-30,4,2018,8808,6
Bureau,Federal Election Commission,Federal Election Commission,null,100.0,100.0,0,0,607916,84,30,09,3,2018,2018-09-30,4,2018,607916,84
Bureau,Legislative Branch-GAO,Government Accountability Office,null,100.0,100.0,0,0,28857,11,30,09,3,2018,2018-09-30,4,2018,28857,11
Bureau,Department of Commerce,Bureau of Industry and Security,null,100.0,100.0,0,0,424797,9,30,09,3,2018,2018-09-30,4,2018,424797,9
Bureau,General Services Administration,General Services Administration,null,68.44008962889748,89.77006100422336,4913167,436,10654580,3826,30,09,3,2018,2018-09-30,4,2018,15567747,4262
Bureau,Railroad Retirement Board,Railroad Retirement Board,null,100.0,100.0,0,0,18406076,3858,30,09,3,2018,2018-09-30,4,2018,18406076,3858
Agency,National Foundation  Arts & Humanities,null,Non-CFO,0.0,0.0,0,0,0,0,30,09,3,2018,2018-09-30,4,2018,0,0
Bureau,Department of Housing and Urban Development,Government National Mortgage Association,null,0.0,0.0,0,0,0,0,30,09,3,2018,2018-09-30,4,2018,0,0
Bureau,Department of the Treasury,Tobacco Tax and Trade,null,100.0,100.0,0,0,1000,1,30,09,3,2018,2018-09-30,4,2018,1000,1
Bureau,Department of Veterans Affairs,Life Insurance,null,100.0,100.0,0,0,513828,88,30,09,3,2018,2018-09-30,4,2018,513828,88
Bureau,National Aeronautics and Space Administration,National Aeronautics and Space Admin,null,100.0,100.0,0,0,2515049,106,30,09,3,2018,2018-09-30,4,2018,2515049,106
Bureau,Other Agencies,Council of Insps. Gen. of Intg. & Effy.,null,0.0,0.0,0,0,0,0,30,09,3,2018,2018-09-30,4,2018,0,0
Bureau,Department of Homeland Security,Info Analysis Infrastructure Prot-NPPD,null,100.0,100.0,0,0,4610,1,30,09,3,2018,2018-09-30,4,2018,4610,1
Bureau,Department of Homeland Security,Transportation Safety Administration,null,100.0,100.0,0,0,11922090,5239,30,09,3,2018,2018-09-30,4,2018,11922090,5239
Agency,Nuclear Regulatory Commission,null,CFO,100.0,100.0,0,0,1591754,261,30,09,3,2018,2018-09-30,4,2018,1591754,261
Agency,Federal Deposit Insurance Corporation,null,Non-CFO,0.0,0.0,0,0,0,0,30,09,3,2018,2018-09-30,4,2018,0,0
Bureau,Farm Credit Administration,Farm Credit Administration,null,100.0,100.0,0,0,604,1,30,09,3,2018,2018-09-30,4,2018,604,1
Bureau,National Archives & Records Admin,Nat'l Archives & Records Administration,null,100.0,100.0,0,0,126170,275,30,09,3,2018,2018-09-30,4,2018,126170,275
Bureau,Department of Justice,Legal Activities,null,99.03046520871128,99.66785290628707,723507,112,73900633,33608,30,09,3,2018,2018-09-30,4,2018,74624140,33720
Agency,Legislative Branch-GPO,null,Non-CFO,0.0,0.0,129224,81,0,0,30,09,3,2018,2018-09-30,4,2018,129224,81
Bureau,Other Agencies/Boards/Commissions,Medicare Payment Advisory Commission,null,0.0,0.0,0,0,0,0,30,09,3,2018,2018-09-30,4,2018,0,0
Bureau,Occupational Safety & Health Rev Comm,Occupational Safety & Health Rev Comm,null,0.0,0.0,0,0,0,0,30,09,3,2018,2018-09-30,4,2018,0,0
Bureau,Department of Health & Human Services,Administration for Children and Families,null,100.0,100.0,0,0,23961505,1243,30,09,3,2018,2018-09-30,4,2018,23961505,1243
Agency,Department of Education,null,CFO,49.404898191086545,46.321727429345565,79793448187,14729734,77916380105,12711041,30,09,3,2018,2018-09-30,4,2018,157709828292,27440775
Agency,Neighborhood Reinvestment Corporation,null,Non-CFO,0.0,0.0,0,0,0,0,30,09,3,2018,2018-09-30,4,2018,0,0
Agency,Occupational Safety & Health Rev Comm,null,Non-CFO,0.0,0.0,0,0,0,0,30,09,3,2018,2018-09-30,4,2018,0,0
Bureau,Department of Homeland Security,Citizenship and Immigration Services,null,100.0,100.0,0,0,1014146,1266,30,09,3,2018,2018-09-30,4,2018,1014146,1266
Bureau,Department of Transportation,National Highway Traffic Safety Admin.,null,100.0,100.0,0,0,7584385,5,30,09,3,2018,2018-09-30,4,2018,7584385,5
Bureau,Agency for International Development,Agency for International Development,null,99.99871125748116,98.18181818181819,372,1,28864975,54,30,09,3,2018,2018-09-30,4,2018,28865347,55
Bureau,Department of Homeland Security,U.S. Coast Guard,null,100.0,100.0,0,0,71851177,10416,30,09,3,2018,2018-09-30,4,2018,71851177,10416
Agency,National Labor Relations Board,null,Non-CFO,0.0,0.0,0,0,0,0,30,09,3,2018,2018-09-30,4,2018,0,0
Agency,Legislative Branch-Office of Tech.,null,Non-CFO,0.0,0.0,0,0,0,0,30,09,3,2018,2018-09-30,4,2018,0,0
Bureau,Department of Commerce,International Trade Administration,null,0.0,0.0,0,0,0,0,30,09,3,2018,2018-09-30,4,2018,0,0
Agency,Tennessee Valley Authority,null,Non-CFO,0.0,0.0,0,0,0,0,30,09,3,2018,2018-09-30,4,2018,0,0
Bureau,Armed Forces Retirement Home,Armed Forces Retirement Home,null,92.80420445703061,92.92929292929293,5641,7,72752,92,30,09,3,2018,2018-09-30,4,2018,78393,99
Bureau,Department of the Treasury,Bureau of Engraving and Printing,null,100.0,100.0,0,0,84528,1,30,09,3,2018,2018-09-30,4,2018,84528,1
Bureau,Environmental Protection Agency,Environmental Protection Agency,null,100.0,100.0,0,0,15865559,201,30,09,3,2018,2018-09-30,4,2018,15865559,201
Bureau,Department of Labor,Mine Safety and Health Administration,null,95.85919611621276,95.83778014941302,2245556,702,51984397,16164,30,09,3,2018,2018-09-30,4,2018,54229953,16866
Bureau,Department of Health & Human Services,Health Resources and Services Admin,null,100.0,100.0,0,0,86436909,504,30,09,3,2018,2018-09-30,4,2018,86436909,504
Agency,American Battle Monuments Commission,null,Non-CFO,0.0,0.0,0,0,0,0,30,09,3,2018,2018-09-30,4,2018,0,0
Bureau,Other Agencies,Federal Housing Finance Agency,null,0.0,0.0,143,2,0,0,30,09,3,2018,2018-09-30,4,2018,143,2
Agency,Small Business Administration,null,CFO,99.86505450729707,99.90234628181308,15743403,113,11650747033,115602,30,09,3,2018,2018-09-30,4,2018,11666490436,115715
Agency,Federal Mediation/Conciliation Service,null,Non-CFO,0.0,0.0,0,0,0,0,30,09,3,2018,2018-09-30,4,2018,0,0
Bureau,Department of the Treasury,Spec Insp Gen-Troubled Asset Rel Prog,null,100.0,100.0,0,0,3916,1,30,09,3,2018,2018-09-30,4,2018,3916,1
Agency,Commodity Futures Trading Commission,null,Non-CFO,100.0,100.0,0,0,636579921,377,30,09,3,2018,2018-09-30,4,2018,636579921,377
Agency,Export - Import  Bank,null,Non-CFO,0.0,0.0,0,0,0,0,30,09,3,2018,2018-09-30,4,2018,0,0
Agency,Department of Energy,null,CFO,100.0,100.0,0,0,32705762,129,30,09,3,2018,2018-09-30,4,2018,32705762,129
Bureau,Other Agencies/Boards/Commissions,U.S.-China Security Review Commission,null,0.0,0.0,0,0,0,0,30,09,3,2018,2018-09-30,4,2018,0,0
Bureau,Department of Agriculture,Federal Crop Insurance Corporation,null,100.0,100.0,0,0,131225,358,30,09,3,2018,2018-09-30,4,2018,131225,358
Bureau,Federal Deposit Insurance Corporation,Federal Deposit Insurance Corporation,null,0.0,0.0,0,0,0,0,30,09,3,2018,2018-09-30,4,2018,0,0
Bureau,Department of the Treasury,Bureau of the Fiscal Service,null,100.0,100.0,0,0,13153147,5800,30,09,3,2018,2018-09-30,4,2018,13153147,5800
Bureau,Department of the Treasury,Interest on Public Debt,null,0.0,0.0,0,0,0,0,30,09,3,2018,2018-09-30,4,2018,0,0
Bureau,The Judiciary,Administrative Office of the U.S. Courts,null,100.0,100.0,0,0,1628320,281,30,09,3,2018,2018-09-30,4,2018,1628320,281
Bureau,Department of Labor,Employee Benefit Security Administration,null,100.0,100.0,0,0,17625519,390,30,09,3,2018,2018-09-30,4,2018,17625519,390
Bureau,Department of the Treasury,Internal Revenue Service,null,100.0,100.0,0,0,240286,109,30,09,3,2018,2018-09-30,4,2018,240286,109
Bureau,Department of Commerce,Bureau of the Census,null,100.0,100.0,0,0,190776,237,30,09,3,2018,2018-09-30,4,2018,190776,237
Bureau,Other Agencies,Millennium Challenge Corporation,null,0.0,0.0,0,0,0,0,30,09,3,2018,2018-09-30,4,2018,0,0
Agency,Office of Special Counsel,null,Non-CFO,0.0,0.0,0,0,0,0,30,09,3,2018,2018-09-30,4,2018,0,0
Bureau,Department of State,International Commissions,null,0.0,0.0,0,0,0,0,30,09,3,2018,2018-09-30,4,2018,0,0
Bureau,Department of the Interior,Bureau of Safety and Environmental Enf.,null,100.0,100.0,0,0,14571,5,30,09,3,2018,2018-09-30,4,2018,14571,5
Bureau,Department of the Treasury,International Monetary Funds,null,0.0,0.0,0,0,0,0,30,09,3,2018,2018-09-30,4,2018,0,0
Bureau,Department of Transportation,Maritime Administration,null,100.0,100.0,0,0,6740,6,30,09,3,2018,2018-09-30,4,2018,6740,6
Bureau,Pension Benefit Guaranty Corp,Pension Benefit Guaranty Corporation,null,100.0,100.0,0,0,1854564,1589,30,09,3,2018,2018-09-30,4,2018,1854564,1589
Agency,Selective Service System,null,Non-CFO,0.0,0.0,0,0,0,0,30,09,3,2018,2018-09-30,4,2018,0,0
Bureau,Department of Justice,Drug Enforcement Administration,null,100.0,100.0,0,0,341407,24,30,09,3,2018,2018-09-30,4,2018,341407,24
Bureau,Department of Commerce,General Administration,null,100.0,100.0,0,0,4660,1,30,09,3,2018,2018-09-30,4,2018,4660,1
Bureau,Department of Agriculture,Forest Service,null,93.92474037767576,17.505353319057814,3342685,1541,51678585,327,30,09,3,2018,2018-09-30,4,2018,55021270,1868
Agency,National Science Foundation,null,CFO,100.0,100.0,0,0,691837,115,30,09,3,2018,2018-09-30,4,2018,691837,115
Bureau,Office of Government Ethics,Office of Government Ethics,null,0.0,0.0,0,0,0,0,30,09,3,2018,2018-09-30,4,2018,0,0
Bureau,Legislative Branch-GPO,Government Publishing Office,null,0.0,0.0,129224,81,0,0,30,09,3,2018,2018-09-30,4,2018,129224,81
Bureau,Department of Commerce,NOAA,null,100.0,100.0,0,0,3783299,535,30,09,3,2018,2018-09-30,4,2018,3783299,535
Bureau,Department of Justice,General Administration,null,0.0,0.0,0,0,0,0,30,09,3,2018,2018-09-30,4,2018,0,0
Bureau,Merit Systems Protection Board,Merit Systems Protection Board,null,100.0,100.0,0,0,133,1,30,09,3,2018,2018-09-30,4,2018,133,1
Agency,Legis Branch-Library of Congress,null,Non-CFO,0.0,0.0,172204,31,0,0,30,09,3,2018,2018-09-30,4,2018,172204,31
Bureau,Office of Special Counsel,Office of Special Counsel,null,0.0,0.0,0,0,0,0,30,09,3,2018,2018-09-30,4,2018,0,0
Bureau,Department of the Interior,National Park Service,null,100.0,100.0,0,0,5862057,1828,30,09,3,2018,2018-09-30,4,2018,5862057,1828
Bureau,Other Agencies,Archit.&Trans. Barriers Compliance Bd,null,0.0,0.0,0,0,0,0,30,09,3,2018,2018-09-30,4,2018,0,0
Bureau,Department of Health & Human Services,Program Support Center,null,100.0,100.0,0,0,14080542,620,30,09,3,2018,2018-09-30,4,2018,14080542,620
Bureau,Department of the Interior,Bureau of Reclamation,null,100.0,100.0,0,0,88226,81,30,09,3,2018,2018-09-30,4,2018,88226,81
Bureau,Legislative Branch - U.S. House/Senate,U.S. House of Representatives,null,0.0,0.0,267891,255,0,0,30,09,3,2018,2018-09-30,4,2018,267891,255
Bureau,Department of Education,Federal Student Aid,null,49.18320810241703,46.318285579086904,79790061110,14729702,77225087093,12709254,30,09,3,2018,2018-09-30,4,2018,157015148203,27438956
Bureau,Department of Homeland Security,Office of Health Affairs,null,0.0,0.0,0,0,0,0,30,09,3,2018,2018-09-30,4,2018,0,0
Bureau,Other Agencies,U.S. Inst. for Env. Conflict Resolution,null,0.0,0.0,1884,9,0,0,30,09,3,2018,2018-09-30,4,2018,1884,9
Bureau,Department of the Interior,Office of the Secretary,null,100.0,100.0,0,0,19052,15,30,09,3,2018,2018-09-30,4,2018,19052,15
Bureau,Other Agencies,Commission On Fine Arts,null,0.0,0.0,0,0,0,0,30,09,3,2018,2018-09-30,4,2018,0,0
Bureau,Department of Justice,Office of Justice Assistance Programs,null,100.0,100.0,0,0,906181,108,30,09,3,2018,2018-09-30,4,2018,906181,108
Bureau,Department of Justice,Federal Prison System,null,100.0,100.0,0,0,1497004,92,30,09,3,2018,2018-09-30,4,2018,1497004,92
Bureau,Department of Homeland Security,Bureau of Customs & Border Protection,null,100.0,100.0,0,0,10506327,697,30,09,3,2018,2018-09-30,4,2018,10506327,697
Bureau,Department of Homeland Security,Immigration and Customs Enforcement,null,100.0,100.0,0,0,8911763,391,30,09,3,2018,2018-09-30,4,2018,8911763,391
Bureau,Department of Labor,Employment Standards Administration,null,72.29151003020623,33.577371048252914,32740651,9980,85420429,5045,30,09,3,2018,2018-09-30,4,2018,118161080,15025
Bureau,Funds Appropriated to the President,Defense Security Assistance Agency,null,0.0,0.0,0,0,0,0,30,09,3,2018,2018-09-30,4,2018,0,0
Agency,Selective Service System,null,Non-CFO,0.0,0.0,0,0,0,0,31,12,4,2018,2018-12-31,1,2019,0,0
Agency,Department of Health & Human Services,null,CFO,97.0934464739626,98.80779606527815,303130442,18327,10126075120,1518910,31,12,4,2018,2018-12-31,1,2019,10429205562,1537237
Agency,Department of Education,null,CFO,70.73128215724172,69.46809673438848,46374544128,8458175,112069513371,19244569,31,12,4,2018,2018-12-31,1,2019,158444057499,27702744
Agency,Funds Appropriated to the President,null,Non-CFO,100.0,100.0,0,0,791105,4,31,12,4,2018,2018-12-31,1,2019,791105,4
Agency,National Foundation  Arts & Humanities,null,Non-CFO,0.0,0.0,0,0,0,0,31,12,4,2018,2018-12-31,1,2019,0,0
Agency,Social Security Administration,null,CFO,29.04240729631951,13.157767373129662,5142798842,2494115,2104908762,377892,31,12,4,2018,2018-12-31,1,2019,7247707604,2872007
Agency,Pension Benefit Guaranty Corp,null,Non-CFO,100.0,100.0,0,0,1604991,1465,31,12,4,2018,2018-12-31,1,2019,1604991,1465
Agency,Legis Branch-Library of Congress,null,Non-CFO,0.0,0.0,0,0,0,0,31,12,4,2018,2018-12-31,1,2019,0,0
Agency,Railroad Retirement Board,null,Non-CFO,100.0,100.0,0,0,18515889,3840,31,12,4,2018,2018-12-31,1,2019,18515889,3840
Agency,Federal Trade Commission,null,Non-CFO,100.0,100.0,0,0,483089469,55,31,12,4,2018,2018-12-31,1,2019,483089469,55
Agency,Corp. for National and Community Service,null,Non-CFO,97.10411783938757,92.46575342465754,105310,22,3531233,270,31,12,4,2018,2018-12-31,1,2019,3636543,292
Bureau,Department of Homeland Security,Office of Biometric Identity Management,null,0.0,0.0,0,0,0,0,31,12,4,2018,2018-12-31,1,2019,0,0
Agency,Other Agencies/Boards/Commissions,null,Non-CFO,0.0,0.0,0,0,0,0,31,12,4,2018,2018-12-31,1,2019,0,0
Bureau,Department of Education,Federal Student Aid,null,70.60243683419688,69.46622353279412,46371810451,8458126,111368510369,19242758,31,12,4,2018,2018-12-31,1,2019,157740320820,27700884
Agency,Farm Credit Administration,null,Non-CFO,100.0,100.0,0,0,613,1,31,12,4,2018,2018-12-31,1,2019,613,1
Bureau,Department of Health & Human Services,Office of the Inspector General,null,0.0,0.0,0,0,0,0,31,12,4,2018,2018-12-31,1,2019,0,0
Agency,Department of Veterans Affairs,null,CFO,90.85273750574368,98.57293962287211,111198038,119563,1104444763,8258709,31,12,4,2018,2018-12-31,1,2019,1215642801,8378272
Bureau,Other Agencies,Chemical Safety Board,null,0.0,0.0,0,0,0,0,31,12,4,2018,2018-12-31,1,2019,0,0
Agency,Small Business Administration,null,CFO,99.85678641237331,99.90450052051519,16989239,111,11845878860,116120,31,12,4,2018,2018-12-31,1,2019,11862868099,116231
Agency,Merit Systems Protection Board,null,Non-CFO,100.0,100.0,0,0,135,1,31,12,4,2018,2018-12-31,1,2019,135,1
Agency,National Credit Union Administration,null,Non-CFO,0.0,0.0,0,0,0,0,31,12,4,2018,2018-12-31,1,2019,0,0
Bureau,Department of the Treasury,Interest on Tax/Deposit of Earnings,null,0.0,0.0,0,0,0,0,31,12,4,2018,2018-12-31,1,2019,0,0
Bureau,Federal Election Commission,Federal Election Commission,null,95.70252628383109,96.51162790697674,26328,3,586311,83,31,12,4,2018,2018-12-31,1,2019,612639,86
Bureau,Tennessee Valley Authority,Tennessee Valley Authority,null,0.0,0.0,0,0,0,0,31,12,4,2018,2018-12-31,1,2019,0,0
Bureau,Department of Housing and Urban Development,Public and Indian Housing Programs,null,0.0,0.0,0,0,0,0,31,12,4,2018,2018-12-31,1,2019,0,0
Agency,Department of Agriculture,null,CFO,98.21782757357143,93.03774217764219,28537636,4359,1572746032,58250,31,12,4,2018,2018-12-31,1,2019,1601283668,62609
Bureau,Department of Housing and Urban Development,"Policy, Development and Research",null,0.0,0.0,0,0,0,0,31,12,4,2018,2018-12-31,1,2019,0,0
Bureau,Farm Credit Administration,Farm Credit Administration,null,100.0,100.0,0,0,613,1,31,12,4,2018,2018-12-31,1,2019,613,1
Bureau,Department of Homeland Security,U.S. Secret Service,null,0.0,0.0,0,0,0,0,31,12,4,2018,2018-12-31,1,2019,0,0
Bureau,Department of Commerce,National Technical Information Service,null,0.0,0.0,0,0,0,0,31,12,4,2018,2018-12-31,1,2019,0,0
Bureau,Consumer Product Safety Commission,Consumer Product Safety Commission,null,100.0,100.0,0,0,468,1,31,12,4,2018,2018-12-31,1,2019,468,1
Bureau,Department of Justice,U.S. Marshals Service,null,0.0,0.0,1438,1,0,0,31,12,4,2018,2018-12-31,1,2019,1438,1
Bureau,U.S. Postal Service,U.S. Postal Service,null,62.578324037559035,78.17241599455215,22185844,10257,37100234,36734,31,12,4,2018,2018-12-31,1,2019,59286078,46991
Agency,Securities & Exchange Commission,null,Non-CFO,100.0,100.0,0,0,2100375439,870,31,12,4,2018,2018-12-31,1,2019,2100375439,870
Bureau,Legislative Branch-GAO,Government Accountability Office,null,0.0,0.0,0,0,0,0,31,12,4,2018,2018-12-31,1,2019,0,0
Bureau,Commodity Futures Trading Commission,Commodity Futures Trading Commission,null,100.0,100.0,0,0,635574518,377,31,12,4,2018,2018-12-31,1,2019,635574518,377
Bureau,Smithsonian Institution,National Gallery of Art,null,0.0,0.0,0,0,0,0,31,12,4,2018,2018-12-31,1,2019,0,0
Agency,National Labor Relations Board,null,Non-CFO,0.0,0.0,0,0,0,0,31,12,4,2018,2018-12-31,1,2019,0,0
Bureau,Pension Benefit Guaranty Corp,Pension Benefit Guaranty Corporation,null,100.0,100.0,0,0,1604991,1465,31,12,4,2018,2018-12-31,1,2019,1604991,1465
Bureau,Department of Health & Human Services,Health Resources and Services Admin,null,100.0,100.0,0,0,81009649,506,31,12,4,2018,2018-12-31,1,2019,81009649,506
Bureau,Corp. for National and Community Service,Corp. for National and Community Service,null,97.10411783938757,92.46575342465754,105310,22,3531233,270,31,12,4,2018,2018-12-31,1,2019,3636543,292
Bureau,Department of Commerce,Patent and Trademark Office,null,100.0,100.0,0,0,383656,519,31,12,4,2018,2018-12-31,1,2019,383656,519
Bureau,Legislative Branch-Office of Tech.,Medicaid & CHIP Payment & Access Comm.,null,0.0,0.0,0,0,0,0,31,12,4,2018,2018-12-31,1,2019,0,0
Bureau,Department of the Treasury,Tobacco Tax and Trade,null,100.0,100.0,0,0,1000,1,31,12,4,2018,2018-12-31,1,2019,1000,1
Bureau,Department of Homeland Security,Federal Law Enforcement Training Ctr.,null,100.0,100.0,0,0,4915,1,31,12,4,2018,2018-12-31,1,2019,4915,1
Bureau,Other Agencies,U.S.  Agency of Global Media,null,100.0,100.0,0,0,9610,4,31,12,4,2018,2018-12-31,1,2019,9610,4
Bureau,Railroad Retirement Board,Railroad Retirement Board,null,100.0,100.0,0,0,18515889,3840,31,12,4,2018,2018-12-31,1,2019,18515889,3840
Bureau,Department of Energy,Energy Consolidated Reports,null,100.0,100.0,0,0,33375334,111,31,12,4,2018,2018-12-31,1,2019,33375334,111
Bureau,Department of Homeland Security,Emergency Preparedness & Resp,null,100.0,100.0,0,0,260951320,42831,31,12,4,2018,2018-12-31,1,2019,260951320,42831
Bureau,National Foundation  Arts & Humanities,National Endowment for the Humanities,null,0.0,0.0,0,0,0,0,31,12,4,2018,2018-12-31,1,2019,0,0
Bureau,Equal Employment Opportunity Commission,Equal Employment Opportunity Commission,null,100.0,100.0,0,0,30071,23,31,12,4,2018,2018-12-31,1,2019,30071,23
Bureau,Legislative Branch-CBO,Congressional Budget Office,null,0.0,0.0,0,0,0,0,31,12,4,2018,2018-12-31,1,2019,0,0
Agency,Armed Forces Retirement Home,null,Non-CFO,91.0595156142437,91.08910891089108,7143,9,72752,92,31,12,4,2018,2018-12-31,1,2019,79895,101
Bureau,Department of Education,Departmental Management,null,99.61154831322925,97.36559139784946,2733677,49,701003002,1811,31,12,4,2018,2018-12-31,1,2019,703736679,1860
Bureau,Department of Commerce,Economic and Statistical Analysis,null,0.0,0.0,0,0,0,0,31,12,4,2018,2018-12-31,1,2019,0,0
Agency,Federal Election Commission,null,Non-CFO,95.70252628383109,96.51162790697674,26328,3,586311,83,31,12,4,2018,2018-12-31,1,2019,612639,86
Bureau,National Labor Relations Board,National Labor Relations Board,null,0.0,0.0,0,0,0,0,31,12,4,2018,2018-12-31,1,2019,0,0
Bureau,Securities & Exchange Commission,Securities and Exchange Commission,null,100.0,100.0,0,0,2100375439,870,31,12,4,2018,2018-12-31,1,2019,2100375439,870
Bureau,Department of Homeland Security,Science and Technology,null,0.0,0.0,0,0,0,0,31,12,4,2018,2018-12-31,1,2019,0,0
Bureau,Other Agencies,Federal Mine Safety & Health Review Comm,null,0.0,0.0,0,0,0,0,31,12,4,2018,2018-12-31,1,2019,0,0
Agency,Department of the Treasury,null,CFO,94.6762023211078,99.4328028990074,3184263,36,56627608,6311,31,12,4,2018,2018-12-31,1,2019,59811871,6347
Bureau,Department of the Interior,"Bureau of Ocean Energy Mgmt., Reg & Enf",null,100.0,100.0,0,0,166,1,31,12,4,2018,2018-12-31,1,2019,166,1
Bureau,Department of Homeland Security,Management Headquarters,null,100.0,100.0,0,0,267,1,31,12,4,2018,2018-12-31,1,2019,267,1
Bureau,Department of the Interior,Bureau of Reclamation,null,100.0,100.0,0,0,96568,88,31,12,4,2018,2018-12-31,1,2019,96568,88
Bureau,Other Agencies,Comm. for Purchase from Blind/Handic.,null,0.0,0.0,3526,1,0,0,31,12,4,2018,2018-12-31,1,2019,3526,1
Bureau,Federal Communications Commission,Federal Communications Commission,null,100.0,100.0,0,0,173870223,18840,31,12,4,2018,2018-12-31,1,2019,173870223,18840
Agency,The Judiciary,null,Non-CFO,100.0,100.0,0,0,1592613,274,31,12,4,2018,2018-12-31,1,2019,1592613,274
Bureau,Department of the Interior,Bureau of Safety and Environmental Enf.,null,100.0,100.0,0,0,14571,5,31,12,4,2018,2018-12-31,1,2019,14571,5
Bureau,Department of the Treasury,Community Dev Financial Inst Fund,null,100.0,100.0,0,0,4076830,7,31,12,4,2018,2018-12-31,1,2019,4076830,7
Bureau,Department of Homeland Security,Office of Health Affairs,null,0.0,0.0,0,0,0,0,31,12,4,2018,2018-12-31,1,2019,0,0
Agency,Legislative Branch-GAO,null,Non-CFO,0.0,0.0,0,0,0,0,31,12,4,2018,2018-12-31,1,2019,0,0
Bureau,Department of Transportation,Research Innovative Technology Admin,null,100.0,100.0,0,0,9834,7,31,12,4,2018,2018-12-31,1,2019,9834,7
Agency,Office of Compliance,null,Non-CFO,0.0,0.0,0,0,0,0,31,12,4,2018,2018-12-31,1,2019,0,0
Bureau,Department of Commerce,International Trade Administration,null,0.0,0.0,0,0,0,0,31,12,4,2018,2018-12-31,1,2019,0,0
Bureau,Department of Labor,Employment Standards Administration,null,66.77385030017894,27.812902829783315,39984312,11760,80355578,4531,31,12,4,2018,2018-12-31,1,2019,120339890,16291
Bureau,National Aeronautics and Space Administration,National Aeronautics and Space Admin,null,100.0,100.0,0,0,2516722,96,31,12,4,2018,2018-12-31,1,2019,2516722,96
Bureau,Other Agencies,Surface Transportation Board,null,0.0,0.0,0,0,0,0,31,12,4,2018,2018-12-31,1,2019,0,0
Agency,Office of Personnel Management,null,CFO,95.26724361989687,87.4356333676622,747858,122,15053885,849,31,12,4,2018,2018-12-31,1,2019,15801743,971
Agency,General Services Administration,null,CFO,74.0783049271219,89.24562191288729,4188252,479,11969071,3975,31,12,4,2018,2018-12-31,1,2019,16157323,4454
Agency,Department of State,null,CFO,73.52777651643788,99.66130005103697,4967014,73,13796102,21480,31,12,4,2018,2018-12-31,1,2019,18763116,21553
Agency,Department of Energy,null,CFO,100.0,100.0,0,0,34469910,146,31,12,4,2018,2018-12-31,1,2019,34469910,146
Bureau,Department of Commerce,Bureau of Industry and Security,null,100.0,100.0,0,0,424797,12,31,12,4,2018,2018-12-31,1,2019,424797,12
Bureau,Department of Health & Human Services,Administration for Children and Families,null,100.0,100.0,0,0,24613902,1480,31,12,4,2018,2018-12-31,1,2019,24613902,1480
Agency,Department of the Interior,null,CFO,99.5580727827626,96.17598816453864,204414,1189,46050714,29904,31,12,4,2018,2018-12-31,1,2019,46255128,31093
Bureau,Other Agencies,Architect of the Capitol,null,0.0,0.0,0,0,0,0,31,12,4,2018,2018-12-31,1,2019,0,0
Agency,Federal Deposit Insurance Corporation,null,Non-CFO,0.0,0.0,0,0,0,0,31,12,4,2018,2018-12-31,1,2019,0,0
Agency,American Battle Monuments Commission,null,Non-CFO,0.0,0.0,0,0,0,0,31,12,4,2018,2018-12-31,1,2019,0,0
Agency,Legislative Branch-Office of Tech.,null,Non-CFO,0.0,0.0,0,0,0,0,31,12,4,2018,2018-12-31,1,2019,0,0
Bureau,Department of Homeland Security,Office of the Inspector General DHS,null,100.0,100.0,0,0,1477,4,31,12,4,2018,2018-12-31,1,2019,1477,4
Bureau,Agency for International Development,Agency for International Development,null,99.97441780835396,96.42857142857143,7670,2,29974124,54,31,12,4,2018,2018-12-31,1,2019,29981794,56
Bureau,Smithsonian Institution,JFK Center for the Performing Arts,null,0.0,0.0,1065,2,0,0,31,12,4,2018,2018-12-31,1,2019,1065,2
Bureau,Department of Transportation,Pipeline Hazardous Material Safety Admin,null,100.0,100.0,0,0,329254,21,31,12,4,2018,2018-12-31,1,2019,329254,21
Bureau,Department of Transportation,Federal Motor Carrier Safety Admin,null,99.9903113163906,99.39969984992496,4756,36,49083440,5961,31,12,4,2018,2018-12-31,1,2019,49088196,5997
Agency,Federal Mediation/Conciliation Service,null,Non-CFO,0.0,0.0,0,0,0,0,31,12,4,2018,2018-12-31,1,2019,0,0
Bureau,Other Agencies,National Council on Disability,null,0.0,0.0,467,2,0,0,31,12,4,2018,2018-12-31,1,2019,467,2
Bureau,Legislative Branch-GPO,Government Publishing Office,null,0.0,0.0,91856,63,0,0,31,12,4,2018,2018-12-31,1,2019,91856,63
Bureau,Department of Agriculture,Food Safety and Inspection Service,null,99.91122240656719,99.70149253731343,831,3,935216,1002,31,12,4,2018,2018-12-31,1,2019,936047,1005
Bureau,Department of the Treasury,Departmental Offices,null,92.0064064966883,96.90189328743546,3184263,36,36650925,1126,31,12,4,2018,2018-12-31,1,2019,39835188,1162
Agency,Department of Housing and Urban Development,null,CFO,99.98598311538917,99.98462720983859,22754,1,162310037,6504,31,12,4,2018,2018-12-31,1,2019,162332791,6505
Agency,Department of Defense,null,CFO,49.44570317999473,19.554952853388794,1152611929,1259401,1127336565,306141,31,12,4,2018,2018-12-31,1,2019,2279948494,1565542
Agency,Neighborhood Reinvestment Corporation,null,Non-CFO,0.0,0.0,0,0,0,0,31,12,4,2018,2018-12-31,1,2019,0,0
Bureau,Neighborhood Reinvestment Corporation,Neighborhood Reinvestment Corporation,null,0.0,0.0,0,0,0,0,31,12,4,2018,2018-12-31,1,2019,0,0
Bureau,Overseas Private Investment Corp Accts,Overseas Private Investment Corp Accts,null,0.0,0.0,0,0,0,0,31,12,4,2018,2018-12-31,1,2019,0,0
Bureau,Department of Homeland Security,Immigration and Customs Enforcement,null,100.0,100.0,0,0,8828433,396,31,12,4,2018,2018-12-31,1,2019,8828433,396
Bureau,Department of the Interior,Office of Natural Resources Revenue,null,100.0,100.0,0,0,11978472,371,31,12,4,2018,2018-12-31,1,2019,11978472,371
Agency,Department of Commerce,null,CFO,99.85140671215578,98.99068322981367,8872,13,5961788,1275,31,12,4,2018,2018-12-31,1,2019,5970660,1288
Agency,Equal Employment Opportunity Commission,null,Non-CFO,100.0,100.0,0,0,30071,23,31,12,4,2018,2018-12-31,1,2019,30071,23
Agency,Consumer Product Safety Commission,null,Non-CFO,100.0,100.0,0,0,468,1,31,12,4,2018,2018-12-31,1,2019,468,1
Agency,Legislative Branch-GPO,null,Non-CFO,0.0,0.0,91856,63,0,0,31,12,4,2018,2018-12-31,1,2019,91856,63
Agency,National Archives & Records Admin,null,Non-CFO,87.48920198981264,98.96907216494846,21000,1,146855,96,31,12,4,2018,2018-12-31,1,2019,167855,97
Bureau,Other Agencies,Morris K. Udall Scholarship,null,0.0,0.0,982,1,0,0,31,12,4,2018,2018-12-31,1,2019,982,1
Bureau,Other Agencies/Boards/Commissions,Medicare Payment Advisory Commission,null,0.0,0.0,0,0,0,0,31,12,4,2018,2018-12-31,1,2019,0,0
Agency,Presidio Trust Corporation,null,Non-CFO,92.82556519381164,80.0,99481,14,1287123,56,31,12,4,2018,2018-12-31,1,2019,1386604,70
Bureau,Department of Commerce,Minority Business Development Agency,null,0.0,0.0,0,0,0,0,31,12,4,2018,2018-12-31,1,2019,0,0
Bureau,Department of Housing and Urban Development,Community Planning and Development,null,0.0,0.0,0,0,0,0,31,12,4,2018,2018-12-31,1,2019,0,0
Bureau,Department of Health & Human Services,Food and Drug Administration,null,63.05484045688586,21.623546166627108,15328260,3302,26160964,911,31,12,4,2018,2018-12-31,1,2019,41489224,4213
Agency,Department of Transportation,null,CFO,99.92351375071114,99.23324643459593,48197,50,62965744,6471,31,12,4,2018,2018-12-31,1,2019,63013941,6521
Bureau,Department of the Treasury,Spec Insp Gen-Troubled Asset Rel Prog,null,100.0,100.0,0,0,3916,1,31,12,4,2018,2018-12-31,1,2019,3916,1
Bureau,Department of Homeland Security,Bureau of Customs & Border Protection,null,100.0,100.0,0,0,9128418,746,31,12,4,2018,2018-12-31,1,2019,9128418,746
Agency,U.S. Postal Service,null,Non-CFO,62.578324037559035,78.17241599455215,22185844,10257,37100234,36734,31,12,4,2018,2018-12-31,1,2019,59286078,46991
Agency,Federal Communications Commission,null,Non-CFO,100.0,100.0,0,0,173870223,18840,31,12,4,2018,2018-12-31,1,2019,173870223,18840
Bureau,Department of Transportation,Federal Transit Administration,null,100.0,100.0,0,0,784374,2,31,12,4,2018,2018-12-31,1,2019,784374,2
Bureau,Department of Labor,Mine Safety and Health Administration,null,94.53774269766939,91.62079156284406,2788490,1446,48261650,15811,31,12,4,2018,2018-12-31,1,2019,51050140,17257
Bureau,Farm Credit Administration,Farm Credit System Insurance Corporation,null,0.0,0.0,0,0,0,0,31,12,4,2018,2018-12-31,1,2019,0,0
Bureau,Department of the Treasury,Bureau of Engraving and Printing,null,100.0,100.0,0,0,84528,1,31,12,4,2018,2018-12-31,1,2019,84528,1
Agency,Environmental Protection Agency,null,CFO,100.0,100.0,0,0,16042329,203,31,12,4,2018,2018-12-31,1,2019,16042329,203
Agency,Commodity Futures Trading Commission,null,Non-CFO,100.0,100.0,0,0,635574518,377,31,12,4,2018,2018-12-31,1,2019,635574518,377
Agency,Department of Justice,null,CFO,99.0352118369227,99.39263097294186,769749,211,79014501,34529,31,12,4,2018,2018-12-31,1,2019,79784250,34740
Agency,Department of Labor,null,CFO,79.4625317704614,62.39530526779811,44926837,13649,173828642,22647,31,12,4,2018,2018-12-31,1,2019,218755479,36296
Agency,Legislative Branch-CBO,null,Non-CFO,0.0,0.0,0,0,0,0,31,12,4,2018,2018-12-31,1,2019,0,0
Agency,Office of Special Counsel,null,Non-CFO,0.0,0.0,0,0,0,0,31,12,4,2018,2018-12-31,1,2019,0,0
Bureau,Funds Appropriated to the President,Trade and Development Agency,null,100.0,100.0,0,0,791105,4,31,12,4,2018,2018-12-31,1,2019,791105,4
Agency,Tennessee Valley Authority,null,Non-CFO,0.0,0.0,0,0,0,0,31,12,4,2018,2018-12-31,1,2019,0,0
Bureau,Department of the Treasury,Treasury Franchise Fund,null,0.0,0.0,0,0,0,0,31,12,4,2018,2018-12-31,1,2019,0,0
Bureau,Other Agencies,U.S. Holocaust Memorial Council,null,0.0,0.0,0,0,0,0,31,12,4,2018,2018-12-31,1,2019,0,0
Bureau,Department of Veterans Affairs,Housing Credit Assistance,null,5.295977934405051,24.793388429752067,8135442,91,454945,30,31,12,4,2018,2018-12-31,1,2019,8590387,121
Bureau,Funds Appropriated to the President,African Development Foundation,null,0.0,0.0,0,0,0,0,31,12,4,2018,2018-12-31,1,2019,0,0
Bureau,Other Agencies/Boards/Commissions,U.S. Comm. on Int. Religious Freedom,null,0.0,0.0,0,0,0,0,31,12,4,2018,2018-12-31,1,2019,0,0
Agency,Office of Government Ethics,null,Non-CFO,0.0,0.0,0,0,0,0,31,12,4,2018,2018-12-31,1,2019,0,0
Bureau,Department of the Treasury,Treasury IG for Tax Admin,null,0.0,0.0,0,0,0,0,31,12,4,2018,2018-12-31,1,2019,0,0
Bureau,Department of the Interior,Bureau of Land Management,null,100.0,100.0,0,0,12796235,277,31,12,4,2018,2018-12-31,1,2019,12796235,277
Agency,Occupational Safety & Health Rev Comm,null,Non-CFO,0.0,0.0,0,0,0,0,31,12,4,2018,2018-12-31,1,2019,0,0
Agency,Federal Labor Relations Authority,null,Non-CFO,0.0,0.0,0,0,0,0,31,12,4,2018,2018-12-31,1,2019,0,0
Bureau,Other Agencies,Advisory Council on Hist. Preservation,null,0.0,0.0,0,0,0,0,31,12,4,2018,2018-12-31,1,2019,0,0
Bureau,Other Agencies,Defense Nuclear Facilities Safety Board,null,0.0,0.0,0,0,0,0,31,12,4,2018,2018-12-31,1,2019,0,0
Bureau,Department of Justice,Federal Bureau of Investigation,null,0.0,0.0,0,0,0,0,31,12,4,2018,2018-12-31,1,2019,0,0
Bureau,Nuclear Regulatory Commission,Nuclear Regulatory Commission,null,100.0,100.0,0,0,1761660,281,31,12,4,2018,2018-12-31,1,2019,1761660,281
Bureau,Other Agencies,National Transportation Safety Board,null,0.0,0.0,0,0,0,0,31,12,4,2018,2018-12-31,1,2019,0,0
Bureau,Department of Labor,Departmental Management,null,0.0,0.0,0,0,0,0,31,12,4,2018,2018-12-31,1,2019,0,0
Agency,National Aeronautics and Space Administration,null,CFO,100.0,100.0,0,0,2516722,96,31,12,4,2018,2018-12-31,1,2019,2516722,96
Bureau,National Science Foundation,National Science Foundation,null,100.0,100.0,0,0,681310,112,31,12,4,2018,2018-12-31,1,2019,681310,112
Bureau,Other Agencies,Council of Insps. Gen. of Intg. & Effy.,null,0.0,0.0,1100,2,0,0,31,12,4,2018,2018-12-31,1,2019,1100,2
Bureau,Department of Commerce,Nat'l Institute of Standards& Technology,null,100.0,100.0,0,0,1088187,6,31,12,4,2018,2018-12-31,1,2019,1088187,6
Bureau,Other Agencies,U.S. Inst. for Env. Conflict Resolution,null,0.0,0.0,1883,8,0,0,31,12,4,2018,2018-12-31,1,2019,1883,8
Bureau,Department of the Treasury,Comptroller of the Currency,null,100.0,100.0,0,0,1252142,24,31,12,4,2018,2018-12-31,1,2019,1252142,24
Bureau,Department of Commerce,NOAA,null,100.0,100.0,0,0,3810830,559,31,12,4,2018,2018-12-31,1,2019,3810830,559
Bureau,Department of Labor,Employment and Training Administration,null,100.0,100.0,0,0,2898431,3,31,12,4,2018,2018-12-31,1,2019,2898431,3
Bureau,Department of Transportation,National Highway Traffic Safety Admin.,null,100.0,100.0,0,0,7868739,6,31,12,4,2018,2018-12-31,1,2019,7868739,6
Bureau,Department of Justice,Drug Enforcement Administration,null,100.0,100.0,0,0,342543,24,31,12,4,2018,2018-12-31,1,2019,342543,24
Bureau,Smithsonian Institution,Smithsonian Institution,null,0.0,0.0,0,0,0,0,31,12,4,2018,2018-12-31,1,2019,0,0
Bureau,Smithsonian Institution,Administrative Conference of the US,null,0.0,0.0,0,0,0,0,31,12,4,2018,2018-12-31,1,2019,0,0
Agency,Legislative Branch - U.S. House/Senate,null,Non-CFO,0.0,0.0,271754,301,0,0,31,12,4,2018,2018-12-31,1,2019,271754,301
Bureau,Department of the Treasury,Internal Revenue Service,null,100.0,100.0,0,0,246256,109,31,12,4,2018,2018-12-31,1,2019,246256,109
Bureau,Department of Health & Human Services,Program Support Center,null,100.0,100.0,0,0,4154197,625,31,12,4,2018,2018-12-31,1,2019,4154197,625
Agency,Nuclear Regulatory Commission,null,CFO,100.0,100.0,0,0,1761660,281,31,12,4,2018,2018-12-31,1,2019,1761660,281
Bureau,Other Agencies,U.S. Institute of Peace,null,0.0,0.0,0,0,0,0,31,12,4,2018,2018-12-31,1,2019,0,0
Bureau,Office of Government Ethics,Office of Government Ethics,null,0.0,0.0,0,0,0,0,31,12,4,2018,2018-12-31,1,2019,0,0
Bureau,Department of the Interior,Geological Survey,null,100.0,100.0,0,0,267668,153,31,12,4,2018,2018-12-31,1,2019,267668,153
Bureau,Department of Labor,Employee Benefit Security Administration,null,100.0,100.0,0,0,18152560,424,31,12,4,2018,2018-12-31,1,2019,18152560,424
Bureau,Other Agencies,Millennium Challenge Corporation,null,0.0,0.0,0,0,0,0,31,12,4,2018,2018-12-31,1,2019,0,0
Bureau,U.S. Court of Appeals / Veterans Claims,U.S. Court of Appeals / Veterans Claims,null,100.0,100.0,0,0,3706,4,31,12,4,2018,2018-12-31,1,2019,3706,4
Bureau,Department of the Treasury,Office of Sec International Affairs,null,0.0,0.0,0,0,0,0,31,12,4,2018,2018-12-31,1,2019,0,0
Bureau,Department of the Interior,Office of Surface Mining,null,100.0,100.0,0,0,2143321,245,31,12,4,2018,2018-12-31,1,2019,2143321,245
Agency,Department of Homeland Security,null,CFO,100.0,100.0,0,0,365503349,61789,31,12,4,2018,2018-12-31,1,2019,365503349,61789
Bureau,Federal Deposit Insurance Corporation,Federal Deposit Insurance Corporation,null,0.0,0.0,0,0,0,0,31,12,4,2018,2018-12-31,1,2019,0,0
Bureau,Department of Agriculture,Food and Nutrition Service,null,0.5383801671034885,0.9453781512605042,9025403,943,48854,9,31,12,4,2018,2018-12-31,1,2019,9074257,952
Bureau,Department of Energy,Bonneville Power Administration,null,100.0,100.0,0,0,1094576,35,31,12,4,2018,2018-12-31,1,2019,1094576,35
Bureau,Legislative Branch - U.S. House/Senate,U.S. House of Representatives,null,0.0,0.0,271754,301,0,0,31,12,4,2018,2018-12-31,1,2019,271754,301
Bureau,Office of Compliance,Office of Compliance,null,0.0,0.0,0,0,0,0,31,12,4,2018,2018-12-31,1,2019,0,0
Bureau,Department of the Treasury,U.S. Mint,null,100.0,100.0,0,0,39358,15,31,12,4,2018,2018-12-31,1,2019,39358,15
Bureau,Other Agencies,James Madison Memorial Fellowship,null,0.0,0.0,233129,24,0,0,31,12,4,2018,2018-12-31,1,2019,233129,24
Bureau,Department of Agriculture,Forest Service,null,92.72608347573791,19.5906432748538,4122775,1375,52556113,335,31,12,4,2018,2018-12-31,1,2019,56678888,1710
Bureau,Department of Homeland Security,Citizenship and Immigration Services,null,100.0,100.0,0,0,1058119,1311,31,12,4,2018,2018-12-31,1,2019,1058119,1311
Bureau,Department of the Interior,Bureau of Indian Affairs,null,98.38890087892462,95.74681728527882,203421,1186,12422804,26699,31,12,4,2018,2018-12-31,1,2019,12626225,27885
Bureau,Department of Defense,Consolidated Report,null,49.44570317999473,19.554952853388794,1152611929,1259401,1127336565,306141,31,12,4,2018,2018-12-31,1,2019,2279948494,1565542
Bureau,Other Agencies,Delta Regional Authority,null,0.0,0.0,0,0,0,0,31,12,4,2018,2018-12-31,1,2019,0,0
Bureau,Department of Education,Office of Postsecondary Education,null,0.0,0.0,0,0,0,0,31,12,4,2018,2018-12-31,1,2019,0,0
Bureau,Department of the Treasury,Bureau of the Fiscal Service,null,100.0,100.0,0,0,12405146,5006,31,12,4,2018,2018-12-31,1,2019,12405146,5006
Bureau,Other Agencies/Boards/Commissions,U.S.-China Security Review Commission,null,0.0,0.0,0,0,0,0,31,12,4,2018,2018-12-31,1,2019,0,0
Bureau,Department of the Interior,Fish and Wildlife Service,null,100.0,100.0,0,0,590294,94,31,12,4,2018,2018-12-31,1,2019,590294,94
Bureau,Other Agencies,District of Columbia Government,null,0.0,0.0,0,0,0,0,31,12,4,2018,2018-12-31,1,2019,0,0
Bureau,Department of Veterans Affairs,Life Insurance,null,100.0,100.0,0,0,554781,97,31,12,4,2018,2018-12-31,1,2019,554781,97
Bureau,Department of the Treasury,Office of Financial Research,null,0.0,0.0,0,0,0,0,31,12,4,2018,2018-12-31,1,2019,0,0
Bureau,Selective Service System,Selective Service System,null,0.0,0.0,0,0,0,0,31,12,4,2018,2018-12-31,1,2019,0,0
Bureau,Department of Transportation,Federal Railroad Administration,null,100.0,100.0,0,0,182073,17,31,12,4,2018,2018-12-31,1,2019,182073,17
Bureau,Department of Agriculture,Farm Service Agency,null,100.0,100.0,0,0,758516233,14156,31,12,4,2018,2018-12-31,1,2019,758516233,14156
Agency,National Science Foundation,null,CFO,100.0,100.0,0,0,681310,112,31,12,4,2018,2018-12-31,1,2019,681310,112
Bureau,Department of Justice,Office of Justice Assistance Programs,null,100.0,100.0,0,0,1025267,130,31,12,4,2018,2018-12-31,1,2019,1025267,130
Bureau,Legislative Branch-Office of Tech.,Open World Leadership,null,0.0,0.0,0,0,0,0,31,12,4,2018,2018-12-31,1,2019,0,0
Bureau,Funds Appropriated to the President,Peace Corps,null,0.0,0.0,0,0,0,0,31,12,4,2018,2018-12-31,1,2019,0,0
Bureau,Other Agencies,Consumer Financial Protection Bureau,null,0.0,0.0,483062,61,0,0,31,12,4,2018,2018-12-31,1,2019,483062,61
Bureau,Department of Homeland Security,Transportation Safety Administration,null,100.0,100.0,0,0,11490247,6118,31,12,4,2018,2018-12-31,1,2019,11490247,6118
Bureau,Department of Commerce,Nat'l Telecomm & Information Admin.,null,100.0,100.0,0,0,112571,2,31,12,4,2018,2018-12-31,1,2019,112571,2
Bureau,Department of the Treasury,D.C. Pension Program,null,100.0,100.0,0,0,303040,17,31,12,4,2018,2018-12-31,1,2019,303040,17
Bureau,Environmental Protection Agency,Environmental Protection Agency,null,100.0,100.0,0,0,16042329,203,31,12,4,2018,2018-12-31,1,2019,16042329,203
Bureau,Other Agencies,National Mediation Board,null,0.0,0.0,0,0,0,0,31,12,4,2018,2018-12-31,1,2019,0,0
Bureau,Department of State,Department of State,null,69.32587390752681,98.69782376025687,4967014,73,11225832,5533,31,12,4,2018,2018-12-31,1,2019,16192846,5606
Bureau,Department of Agriculture,U.S. Department of Agriculture,null,55.11558624123797,49.70220369267421,13506322,1689,16585019,1669,31,12,4,2018,2018-12-31,1,2019,30091341,3358
Bureau,National Archives & Records Admin,Nat'l Archives & Records Administration,null,87.48920198981264,98.96907216494846,21000,1,146855,96,31,12,4,2018,2018-12-31,1,2019,167855,97
Bureau,Office of Personnel Management,Office of Personnel Management,null,95.26724361989687,87.4356333676622,747858,122,15053885,849,31,12,4,2018,2018-12-31,1,2019,15801743,971
Bureau,Department of Labor,Occupational Safety and Health Admin,null,91.81083923885535,80.90517241379311,2154035,443,24149454,1877,31,12,4,2018,2018-12-31,1,2019,26303489,2320
Bureau,Department of Health & Human Services,Indian Health Services,null,45.95437230424802,5.444587628865979,26320472,2935,22379993,169,31,12,4,2018,2018-12-31,1,2019,48700465,3104
Bureau,Department of Agriculture,Commodity Credit Corporation,null,99.9015205286428,99.96067636649626,107527,4,109079696,10168,31,12,4,2018,2018-12-31,1,2019,109187223,10172
Bureau,Federal Trade Commission,Federal Trade Commission,null,100.0,100.0,0,0,483089469,55,31,12,4,2018,2018-12-31,1,2019,483089469,55
Bureau,Department of Veterans Affairs,Veterans Benefits,null,99.77636385125034,98.77051307720258,1276278,1658,569417685,133195,31,12,4,2018,2018-12-31,1,2019,570693963,134853
Bureau,Other Agencies,Federal Housing Finance Agency,null,0.0,0.0,29,1,0,0,31,12,4,2018,2018-12-31,1,2019,29,1
Bureau,Department of Agriculture,Rural Development,null,99.99899322871575,99.9866457450005,6365,4,632212700,29949,31,12,4,2018,2018-12-31,1,2019,632219065,29953
Bureau,Social Security Administration,Social Security Administration,null,29.04240729631951,13.157767373129662,5142798842,2494115,2104908762,377892,31,12,4,2018,2018-12-31,1,2019,7247707604,2872007
Agency,Agency for International Development,null,CFO,99.97441780835396,96.42857142857143,7670,2,29974124,54,31,12,4,2018,2018-12-31,1,2019,29981794,56
Bureau,Legis Branch-Library of Congress,Library of Congress,null,0.0,0.0,0,0,0,0,31,12,4,2018,2018-12-31,1,2019,0,0
Bureau,Merit Systems Protection Board,Merit Systems Protection Board,null,100.0,100.0,0,0,135,1,31,12,4,2018,2018-12-31,1,2019,135,1
Bureau,Department of Transportation,Office of the Inspector General,null,100.0,100.0,0,0,213,1,31,12,4,2018,2018-12-31,1,2019,213,1
Bureau,Department of Homeland Security,Info Analysis Infrastructure Prot-NPPD,null,100.0,100.0,0,0,4610,1,31,12,4,2018,2018-12-31,1,2019,4610,1
Bureau,Department of Commerce,General Administration,null,100.0,100.0,0,0,4660,1,31,12,4,2018,2018-12-31,1,2019,4660,1
Bureau,Department of Health & Human Services,Office of the Secretary,null,100.0,100.0,0,0,4848,8,31,12,4,2018,2018-12-31,1,2019,4848,8
Bureau,Department of Transportation,Maritime Administration,null,100.0,100.0,0,0,6698,6,31,12,4,2018,2018-12-31,1,2019,6698,6
Bureau,Department of Transportation,Federal Highway Administration,null,100.0,100.0,0,0,7613,7,31,12,4,2018,2018-12-31,1,2019,7613,7
Bureau,Department of Labor,Bureau of Labor Statistics,null,100.0,100.0,0,0,10969,1,31,12,4,2018,2018-12-31,1,2019,10969,1
Bureau,Department of the Interior,Office of the Secretary,null,100.0,100.0,0,0,25462,17,31,12,4,2018,2018-12-31,1,2019,25462,17
Agency,Overseas Private Investment Corp Accts,null,Non-CFO,0.0,0.0,0,0,0,0,31,12,4,2018,2018-12-31,1,2019,0,0
Bureau,Department of Agriculture,Federal Crop Insurance Corporation,null,100.0,100.0,0,0,119709,358,31,12,4,2018,2018-12-31,1,2019,119709,358
Bureau,Department of State,Passport NSF,null,100.0,100.0,0,0,2570270,15947,31,12,4,2018,2018-12-31,1,2019,2570270,15947
Bureau,Federal Maritime Commission,Salaries and Expenses,null,99.76647540291958,60.0,1107,4,472933,6,31,12,4,2018,2018-12-31,1,2019,474040,10
Bureau,Department of Veterans Affairs,Medical and Construction,null,84.89146763363077,98.57848412970809,95039478,117169,534005592,8125370,31,12,4,2018,2018-12-31,1,2019,629045070,8242539
Bureau,General Services Administration,General Services Administration,null,74.0783049271219,89.24562191288729,4188252,479,11969071,3975,31,12,4,2018,2018-12-31,1,2019,16157323,4454
Bureau,Small Business Administration,Small Business Administration,null,99.85678641237331,99.90450052051519,16989239,111,11845878860,116120,31,12,4,2018,2018-12-31,1,2019,11862868099,116231
Bureau,Other Agencies,Election Assistance Commission,null,0.0,0.0,0,0,0,0,31,12,4,2018,2018-12-31,1,2019,0,0
Bureau,Other Agencies,Commission On Fine Arts,null,0.0,0.0,0,0,0,0,31,12,4,2018,2018-12-31,1,2019,0,0
Bureau,Department of Housing and Urban Development,Government National Mortgage Association,null,0.0,0.0,0,0,0,0,31,12,4,2018,2018-12-31,1,2019,0,0
Bureau,Department of Homeland Security,U.S. Coast Guard,null,100.0,100.0,0,0,74035543,10380,31,12,4,2018,2018-12-31,1,2019,74035543,10380
Bureau,Department of Commerce,Office of the Inspector General,null,0.0,0.0,0,0,0,0,31,12,4,2018,2018-12-31,1,2019,0,0
Bureau,Department of the Treasury,Office of the Secretary,null,0.0,0.0,0,0,0,0,31,12,4,2018,2018-12-31,1,2019,0,0
Bureau,Department of Justice,Legal Activities,null,99.00408160874775,99.42822136001634,754999,196,75054325,34083,31,12,4,2018,2018-12-31,1,2019,75809324,34279
Bureau,Department of Housing and Urban Development,Housing Programs,null,99.98598311538917,99.98462720983859,22754,1,162310037,6504,31,12,4,2018,2018-12-31,1,2019,162332791,6505
Bureau,Department of Transportation,Federal Aviation Administration,null,98.81201499933273,96.7816091954023,43441,14,3613255,421,31,12,4,2018,2018-12-31,1,2019,3656696,435
Bureau,Department of Health & Human Services,Centers for Medicare & Medicaid Services,null,97.51402246208268,99.23069819411215,253972757,11746,9962240106,1515093,31,12,4,2018,2018-12-31,1,2019,10216212863,1526839
Bureau,Other Agencies,National Capital Planning Commission,null,0.0,0.0,0,0,0,0,31,12,4,2018,2018-12-31,1,2019,0,0
Bureau,Department of the Treasury,Financial Crimes Enforcement Network,null,100.0,100.0,0,0,1564467,4,31,12,4,2018,2018-12-31,1,2019,1564467,4
Bureau,The Judiciary,Administrative Office of the U.S. Courts,null,100.0,100.0,0,0,1592613,274,31,12,4,2018,2018-12-31,1,2019,1592613,274
Bureau,Department of Agriculture,Agricultural Marketing Service,null,60.35752834906818,63.91534391534392,1768413,341,2692492,604,31,12,4,2018,2018-12-31,1,2019,4460905,945
Bureau,Department of the Interior,National Park Service,null,99.98262815540402,99.84670413898824,993,3,5715153,1954,31,12,4,2018,2018-12-31,1,2019,5716146,1957
Bureau,Department of Veterans Affairs,Administration and Cemeteries,null,0.1740005326546918,2.56797583081571,6746840,645,11760,17,31,12,4,2018,2018-12-31,1,2019,6758600,662
Bureau,Department of Health & Human Services,National Institutes of Health,null,38.727366513005165,21.105527638190956,7417029,314,4687933,84,31,12,4,2018,2018-12-31,1,2019,12104962,398
Agency,Export - Import  Bank,null,Non-CFO,0.0,0.0,0,0,0,0,31,12,4,2018,2018-12-31,1,2019,0,0
Agency,Federal Maritime Commission,null,Non-CFO,99.76647540291958,60.0,1107,4,472933,6,31,12,4,2018,2018-12-31,1,2019,474040,10
Agency,Other Agencies,null,Non-CFO,1.3096425670629663,3.8461538461538463,724178,100,9610,4,31,12,4,2018,2018-12-31,1,2019,733788,104
Bureau,Department of Transportation,St. Lawrence Seaway Development Corp.,null,0.0,0.0,0,0,0,0,31,12,4,2018,2018-12-31,1,2019,0,0
Bureau,Funds Appropriated to the President,Defense Security Assistance Agency,null,0.0,0.0,0,0,0,0,31,12,4,2018,2018-12-31,1,2019,0,0
Bureau,Other Agencies,Gulf Coast Ecosystem Restoration Council,null,0.0,0.0,0,0,0,0,31,12,4,2018,2018-12-31,1,2019,0,0
Bureau,Other Agencies,Federal Housing Finance Agency OIG,null,0.0,0.0,0,0,0,0,31,12,4,2018,2018-12-31,1,2019,0,0
Bureau,Other Agencies,Denali Commission,null,0.0,0.0,0,0,0,0,31,12,4,2018,2018-12-31,1,2019,0,0
Bureau,Department of Commerce,Economic Development Administration,null,0.0,0.0,0,0,0,0,31,12,4,2018,2018-12-31,1,2019,0,0
Bureau,Other Agencies,Archit.&Trans. Barriers Compliance Bd,null,0.0,0.0,0,0,0,0,31,12,4,2018,2018-12-31,1,2019,0,0
Bureau,Department of Justice,General Administration,null,0.0,0.0,0,0,0,0,31,12,4,2018,2018-12-31,1,2019,0,0
Bureau,Export - Import  Bank,Export-Import Bank,null,0.0,0.0,0,0,0,0,31,12,4,2018,2018-12-31,1,2019,0,0
Bureau,Department of the Treasury,U.S. Treasury IG Office,null,0.0,0.0,0,0,0,0,31,12,4,2018,2018-12-31,1,2019,0,0
Bureau,Department of the Treasury,Treasury Forfeiture Fund,null,0.0,0.0,0,0,0,0,31,12,4,2018,2018-12-31,1,2019,0,0
Bureau,National Credit Union Administration,National Credit Union Administration,null,0.0,0.0,0,0,0,0,31,12,4,2018,2018-12-31,1,2019,0,0
Bureau,Department of Health & Human Services,Administration for Community Living,null,0.0,0.0,0,0,0,0,31,12,4,2018,2018-12-31,1,2019,0,0
Bureau,Office of Special Counsel,Office of Special Counsel,null,0.0,0.0,0,0,0,0,31,12,4,2018,2018-12-31,1,2019,0,0
Bureau,Federal Labor Relations Authority,Federal Labor Relations Authority,null,0.0,0.0,0,0,0,0,31,12,4,2018,2018-12-31,1,2019,0,0
Bureau,Federal Mediation/Conciliation Service,Federal Mediation/Conciliation Service,null,0.0,0.0,0,0,0,0,31,12,4,2018,2018-12-31,1,2019,0,0
Bureau,Department of State,International Commissions,null,0.0,0.0,0,0,0,0,31,12,4,2018,2018-12-31,1,2019,0,0
Bureau,Funds Appropriated to the President,Inter-American Foundation,null,0.0,0.0,0,0,0,0,31,12,4,2018,2018-12-31,1,2019,0,0
Bureau,Department of Homeland Security,Domestic Nuclear Detection Office,null,0.0,0.0,0,0,0,0,31,12,4,2018,2018-12-31,1,2019,0,0
Bureau,Department of Housing and Urban Development,Management and Administration,null,0.0,0.0,0,0,0,0,31,12,4,2018,2018-12-31,1,2019,0,0
Bureau,Department of Justice,Bureau of ATF and Explosives,null,61.973319621789926,26.31578947368421,13312,14,21695,5,31,12,4,2018,2018-12-31,1,2019,35007,19
Bureau,Armed Forces Retirement Home,Armed Forces Retirement Home,null,91.0595156142437,91.08910891089108,7143,9,72752,92,31,12,4,2018,2018-12-31,1,2019,79895,101
Bureau,Department of Commerce,Bureau of the Census,null,93.92158071787283,93.12169312169313,8872,13,137087,176,31,12,4,2018,2018-12-31,1,2019,145959,189
Bureau,Department of Health & Human Services,Centers for Disease Control,null,57.63089970501475,37.5,91924,30,125036,18,31,12,4,2018,2018-12-31,1,2019,216960,48
Bureau,Department of Health & Human Services,Substance Abuse & Mental Health Admin.,null,100.0,100.0,0,0,698492,16,31,12,4,2018,2018-12-31,1,2019,698492,16
Bureau,Department of Justice,Federal Prison Industries,null,100.0,100.0,0,0,1043089,183,31,12,4,2018,2018-12-31,1,2019,1043089,183
Bureau,Department of Transportation,Office of the Secretary,null,100.0,100.0,0,0,1080251,22,31,12,4,2018,2018-12-31,1,2019,1080251,22
Bureau,Presidio Trust Corporation,Presidio Trust Corporation,null,92.82556519381164,80.0,99481,14,1287123,56,31,12,4,2018,2018-12-31,1,2019,1386604,70
Agency,Smithsonian Institution,null,Non-CFO,0.0,0.0,1065,2,0,0,31,12,4,2018,2018-12-31,1,2019,1065,2
Bureau,Funds Appropriated to the President,Executive Branch,null,0.0,0.0,0,0,0,0,31,12,4,2018,2018-12-31,1,2019,0,0
Bureau,Department of the Treasury,International Monetary Funds,null,0.0,0.0,0,0,0,0,31,12,4,2018,2018-12-31,1,2019,0,0
Bureau,American Battle Monuments Commission,American Battle Monuments Commission,null,0.0,0.0,0,0,0,0,31,12,4,2018,2018-12-31,1,2019,0,0
Bureau,National Foundation  Arts & Humanities,National Endowment for the Arts,null,0.0,0.0,0,0,0,0,31,12,4,2018,2018-12-31,1,2019,0,0
Bureau,Department of Transportation,Surface Transportation Board,null,0.0,0.0,0,0,0,0,31,12,4,2018,2018-12-31,1,2019,0,0
Bureau,Occupational Safety & Health Rev Comm,Occupational Safety & Health Rev Comm,null,0.0,0.0,0,0,0,0,31,12,4,2018,2018-12-31,1,2019,0,0
Bureau,Department of State,Civil Monetary Penalties,null,0.0,0.0,0,0,0,0,31,12,4,2018,2018-12-31,1,2019,0,0
Bureau,Department of Justice,Federal Prison System,null,100.0,100.0,0,0,1527582,104,31,12,4,2018,2018-12-31,1,2019,1527582,104
Agency,U.S. Court of Appeals / Veterans Claims,null,Non-CFO,100.0,100.0,0,0,3706,4,31,12,4,2018,2018-12-31,1,2019,3706,4
Bureau,Department of Commerce,International Trade Administration,null,0.0,0.0,0,0,0,0,31,03,1,2019,2019-03-31,2,2019,0,0
Bureau,Department of the Treasury,Office of Financial Research,null,0.0,0.0,0,0,0,0,31,03,1,2019,2019-03-31,2,2019,0,0
Bureau,Department of Health & Human Services,Centers for Disease Control,null,65.50595284862008,29.09090909090909,65855,39,125062,16,31,03,1,2019,2019-03-31,2,2019,190917,55
Bureau,Department of Housing and Urban Development,"Policy, Development and Research",null,0.0,0.0,0,0,0,0,31,03,1,2019,2019-03-31,2,2019,0,0
Bureau,Other Agencies,National Capital Planning Commission,null,0.0,0.0,0,0,0,0,31,03,1,2019,2019-03-31,2,2019,0,0
Agency,Federal Deposit Insurance Corporation,null,Non-CFO,0.0,0.0,0,0,0,0,31,03,1,2019,2019-03-31,2,2019,0,0
Bureau,Department of Commerce,Economic Development Administration,null,0.0,0.0,0,0,0,0,31,03,1,2019,2019-03-31,2,2019,0,0
Bureau,Department of Justice,General Administration,null,0.0,0.0,0,0,0,0,31,03,1,2019,2019-03-31,2,2019,0,0
Bureau,Other Agencies,Council of Insps. Gen. of Intg. & Effy.,null,0.0,0.0,1100,2,0,0,31,03,1,2019,2019-03-31,2,2019,1100,2
Bureau,Department of the Treasury,Spec Insp Gen-Troubled Asset Rel Prog,null,100.0,100.0,0,0,3916,1,31,03,1,2019,2019-03-31,2,2019,3916,1
Agency,Department of Commerce,null,CFO,99.77336609421874,98.94662921348315,16196,15,7130131,1409,31,03,1,2019,2019-03-31,2,2019,7146327,1424
Agency,Federal Mediation/Conciliation Service,null,Non-CFO,0.0,0.0,0,0,0,0,31,03,1,2019,2019-03-31,2,2019,0,0
Agency,Legislative Branch-GPO,null,Non-CFO,0.0,0.0,104300,73,0,0,31,03,1,2019,2019-03-31,2,2019,104300,73
Agency,Railroad Retirement Board,null,Non-CFO,100.0,100.0,0,0,18672856,3789,31,03,1,2019,2019-03-31,2,2019,18672856,3789
Bureau,Office of Special Counsel,Office of Special Counsel,null,0.0,0.0,0,0,0,0,31,03,1,2019,2019-03-31,2,2019,0,0
Bureau,Smithsonian Institution,JFK Center for the Performing Arts,null,0.0,0.0,0,0,0,0,31,03,1,2019,2019-03-31,2,2019,0,0
Bureau,Department of Transportation,Federal Highway Administration,null,100.0,100.0,0,0,8609,7,31,03,1,2019,2019-03-31,2,2019,8609,7
Agency,Legis Branch-Library of Congress,null,Non-CFO,0.0,0.0,0,0,0,0,31,03,1,2019,2019-03-31,2,2019,0,0
Bureau,National Foundation  Arts & Humanities,National Endowment for the Arts,null,0.0,0.0,0,0,0,0,31,03,1,2019,2019-03-31,2,2019,0,0
Bureau,Department of Housing and Urban Development,Government National Mortgage Association,null,0.0,0.0,0,0,0,0,31,03,1,2019,2019-03-31,2,2019,0,0
Bureau,Office of Government Ethics,Office of Government Ethics,null,0.0,0.0,0,0,0,0,31,03,1,2019,2019-03-31,2,2019,0,0
Bureau,Other Agencies,Federal Housing Finance Agency OIG,null,0.0,0.0,0,0,0,0,31,03,1,2019,2019-03-31,2,2019,0,0
Bureau,Occupational Safety & Health Rev Comm,Occupational Safety & Health Rev Comm,null,0.0,0.0,209,1,0,0,31,03,1,2019,2019-03-31,2,2019,209,1
Agency,Funds Appropriated to the President,null,Non-CFO,100.0,100.0,0,0,791105,4,31,03,1,2019,2019-03-31,2,2019,791105,4
Bureau,Funds Appropriated to the President,Executive Branch,null,0.0,0.0,0,0,0,0,31,03,1,2019,2019-03-31,2,2019,0,0
Bureau,Department of the Interior,"Bureau of Ocean Energy Mgmt., Reg & Enf",null,0.0,0.0,0,0,0,0,31,03,1,2019,2019-03-31,2,2019,0,0
Bureau,Other Agencies,Defense Nuclear Facilities Safety Board,null,0.0,0.0,0,0,0,0,31,03,1,2019,2019-03-31,2,2019,0,0
Bureau,Department of the Treasury,International Monetary Funds,null,0.0,0.0,0,0,0,0,31,03,1,2019,2019-03-31,2,2019,0,0
Bureau,Consumer Product Safety Commission,Consumer Product Safety Commission,null,100.0,100.0,0,0,473,1,31,03,1,2019,2019-03-31,2,2019,473,1
Bureau,Department of Justice,Federal Bureau of Investigation,null,100.0,100.0,0,0,11340,3,31,03,1,2019,2019-03-31,2,2019,11340,3
Bureau,Office of Compliance,Office of Compliance,null,0.0,0.0,0,0,0,0,31,03,1,2019,2019-03-31,2,2019,0,0
Bureau,Other Agencies,Advisory Council on Hist. Preservation,null,0.0,0.0,0,0,0,0,31,03,1,2019,2019-03-31,2,2019,0,0
Bureau,Other Agencies,Delta Regional Authority,null,0.0,0.0,0,0,0,0,31,03,1,2019,2019-03-31,2,2019,0,0
Bureau,Department of Commerce,Economic and Statistical Analysis,null,0.0,0.0,0,0,0,0,31,03,1,2019,2019-03-31,2,2019,0,0
Bureau,Neighborhood Reinvestment Corporation,Neighborhood Reinvestment Corporation,null,0.0,0.0,0,0,0,0,31,03,1,2019,2019-03-31,2,2019,0,0
Bureau,Other Agencies,Chemical Safety Board,null,0.0,0.0,0,0,0,0,31,03,1,2019,2019-03-31,2,2019,0,0
Bureau,Department of State,Passport NSF,null,0.0,0.0,0,0,0,0,31,03,1,2019,2019-03-31,2,2019,0,0
Bureau,Legislative Branch-GAO,Government Accountability Office,null,0.0,0.0,0,0,0,0,31,03,1,2019,2019-03-31,2,2019,0,0
Bureau,Department of the Interior,Office of the Secretary,null,100.0,100.0,0,0,24995,17,31,03,1,2019,2019-03-31,2,2019,24995,17
Bureau,Department of the Treasury,U.S. Mint,null,100.0,100.0,0,0,37306,15,31,03,1,2019,2019-03-31,2,2019,37306,15
Agency,National Science Foundation,null,CFO,100.0,100.0,0,0,616204,97,31,03,1,2019,2019-03-31,2,2019,616204,97
Bureau,Other Agencies,Gulf Coast Ecosystem Restoration Council,null,0.0,0.0,0,0,0,0,31,03,1,2019,2019-03-31,2,2019,0,0
Bureau,Legislative Branch-Office of Tech.,Open World Leadership,null,0.0,0.0,0,0,0,0,31,03,1,2019,2019-03-31,2,2019,0,0
Bureau,National Foundation  Arts & Humanities,National Endowment for the Humanities,null,0.0,0.0,0,0,0,0,31,03,1,2019,2019-03-31,2,2019,0,0
Bureau,Overseas Private Investment Corp Accts,Overseas Private Investment Corp Accts,null,0.0,0.0,0,0,0,0,31,03,1,2019,2019-03-31,2,2019,0,0
Bureau,Other Agencies,U.S. Institute of Peace,null,0.0,0.0,0,0,0,0,31,03,1,2019,2019-03-31,2,2019,0,0
Bureau,Other Agencies,District of Columbia Government,null,0.0,0.0,0,0,0,0,31,03,1,2019,2019-03-31,2,2019,0,0
Bureau,Other Agencies,National Council on Disability,null,0.0,0.0,387,1,0,0,31,03,1,2019,2019-03-31,2,2019,387,1
Bureau,Department of Commerce,General Administration,null,100.0,100.0,0,0,4660,1,31,03,1,2019,2019-03-31,2,2019,4660,1
Bureau,Department of Labor,Bureau of Labor Statistics,null,100.0,100.0,0,0,11381,1,31,03,1,2019,2019-03-31,2,2019,11381,1
Bureau,Department of Commerce,Bureau of the Census,null,100.0,100.0,0,0,234985,263,31,03,1,2019,2019-03-31,2,2019,234985,263
Agency,Department of Labor,null,CFO,82.14313236423045,62.484624846248465,36940936,13420,169931494,22352,31,03,1,2019,2019-03-31,2,2019,206872430,35772
Agency,Legislative Branch-GAO,null,Non-CFO,0.0,0.0,0,0,0,0,31,03,1,2019,2019-03-31,2,2019,0,0
Agency,National Foundation  Arts & Humanities,null,Non-CFO,0.0,0.0,0,0,0,0,31,03,1,2019,2019-03-31,2,2019,0,0
Agency,Export - Import  Bank,null,Non-CFO,0.0,0.0,0,0,0,0,31,03,1,2019,2019-03-31,2,2019,0,0
Agency,Selective Service System,null,Non-CFO,0.0,0.0,0,0,0,0,31,03,1,2019,2019-03-31,2,2019,0,0
Bureau,Department of the Interior,Fish and Wildlife Service,null,100.0,100.0,0,0,587058,93,31,03,1,2019,2019-03-31,2,2019,587058,93
Bureau,National Science Foundation,National Science Foundation,null,100.0,100.0,0,0,616204,97,31,03,1,2019,2019-03-31,2,2019,616204,97
Bureau,Department of Justice,Office of Justice Assistance Programs,null,100.0,100.0,0,0,888015,73,31,03,1,2019,2019-03-31,2,2019,888015,73
Bureau,Department of Agriculture,Food Safety and Inspection Service,null,100.0,100.0,0,0,954707,1100,31,03,1,2019,2019-03-31,2,2019,954707,1100
Bureau,Department of Commerce,Nat'l Institute of Standards& Technology,null,100.0,100.0,0,0,1088187,6,31,03,1,2019,2019-03-31,2,2019,1088187,6
Bureau,Department of the Treasury,Comptroller of the Currency,null,100.0,100.0,0,0,1150487,23,31,03,1,2019,2019-03-31,2,2019,1150487,23
Bureau,Department of the Treasury,Financial Crimes Enforcement Network,null,100.0,100.0,0,0,1564467,4,31,03,1,2019,2019-03-31,2,2019,1564467,4
Bureau,The Judiciary,Administrative Office of the U.S. Courts,null,100.0,100.0,0,0,1573540,259,31,03,1,2019,2019-03-31,2,2019,1573540,259
Bureau,Nuclear Regulatory Commission,Nuclear Regulatory Commission,null,98.92917475330071,99.65156794425087,19587,1,1809563,286,31,03,1,2019,2019-03-31,2,2019,1829150,287
Bureau,Department of Transportation,Federal Aviation Administration,null,92.943360324185,91.29353233830845,181940,35,2396341,367,31,03,1,2019,2019-03-31,2,2019,2578281,402
Bureau,Department of Agriculture,Food and Nutrition Service,null,1.3393602570213845,3.0100334448160537,3580661,290,48609,9,31,03,1,2019,2019-03-31,2,2019,3629270,299
Agency,National Credit Union Administration,null,Non-CFO,0.0,0.0,0,0,0,0,31,03,1,2019,2019-03-31,2,2019,0,0
Bureau,Department of Housing and Urban Development,Public and Indian Housing Programs,null,100.0,100.0,0,0,564,1,31,03,1,2019,2019-03-31,2,2019,564,1
Bureau,Department of Health & Human Services,National Institutes of Health,null,0.0,0.0,13594899,424,0,0,31,03,1,2019,2019-03-31,2,2019,13594899,424
Bureau,Department of Health & Human Services,Centers for Medicare & Medicaid Services,null,97.52839993057003,99.23483569823495,252419310,11465,9960370094,1486906,31,03,1,2019,2019-03-31,2,2019,10212789404,1498371
Bureau,Department of the Treasury,Treasury Franchise Fund,null,100.0,100.0,0,0,568,1,31,03,1,2019,2019-03-31,2,2019,568,1
Agency,Presidio Trust Corporation,null,Non-CFO,94.65233679490728,90.625,74756,9,1323163,87,31,03,1,2019,2019-03-31,2,2019,1397919,96
Bureau,Department of Commerce,Minority Business Development Agency,null,0.0,0.0,0,0,0,0,31,03,1,2019,2019-03-31,2,2019,0,0
Bureau,Department of the Treasury,Interest on Tax/Deposit of Earnings,null,0.0,0.0,0,0,0,0,31,03,1,2019,2019-03-31,2,2019,0,0
Bureau,Selective Service System,Selective Service System,null,0.0,0.0,0,0,0,0,31,03,1,2019,2019-03-31,2,2019,0,0
Agency,Department of the Treasury,null,CFO,94.90241694495413,97.9996693668375,3072548,121,57202056,5928,31,03,1,2019,2019-03-31,2,2019,60274604,6049
Bureau,Other Agencies,Surface Transportation Board,null,0.0,0.0,0,0,0,0,31,03,1,2019,2019-03-31,2,2019,0,0
Bureau,National Archives & Records Admin,Nat'l Archives & Records Administration,null,87.17099753213253,96.03960396039604,22977,4,156125,97,31,03,1,2019,2019-03-31,2,2019,179102,101
Bureau,Department of Transportation,Research Innovative Technology Admin,null,100.0,100.0,0,0,10238,8,31,03,1,2019,2019-03-31,2,2019,10238,8
Bureau,Department of Veterans Affairs,Housing Credit Assistance,null,45.26298315127369,68.88888888888889,600106,14,496238,31,31,03,1,2019,2019-03-31,2,2019,1096344,45
Bureau,Other Agencies/Boards/Commissions,Medicare Payment Advisory Commission,null,0.0,0.0,0,0,0,0,31,03,1,2019,2019-03-31,2,2019,0,0
Bureau,Other Agencies,Consumer Financial Protection Bureau,null,0.0,0.0,483263,62,0,0,31,03,1,2019,2019-03-31,2,2019,483263,62
Bureau,Department of Energy,Bonneville Power Administration,null,100.0,100.0,0,0,1092697,37,31,03,1,2019,2019-03-31,2,2019,1092697,37
Agency,Federal Communications Commission,null,Non-CFO,100.0,100.0,0,0,204572605,13372,31,03,1,2019,2019-03-31,2,2019,204572605,13372
Bureau,Presidio Trust Corporation,Presidio Trust Corporation,null,94.65233679490728,90.625,74756,9,1323163,87,31,03,1,2019,2019-03-31,2,2019,1397919,96
Agency,Department of Housing and Urban Development,null,CFO,99.99694171007081,99.9846508058327,5112,1,167147124,6514,31,03,1,2019,2019-03-31,2,2019,167152236,6515
Agency,Federal Trade Commission,null,Non-CFO,100.0,100.0,0,0,483082464,55,31,03,1,2019,2019-03-31,2,2019,483082464,55
Bureau,Merit Systems Protection Board,Merit Systems Protection Board,null,100.0,100.0,0,0,137,1,31,03,1,2019,2019-03-31,2,2019,137,1
Agency,Department of Agriculture,null,CFO,99.02189996935329,95.99334378079713,15502779,2480,1569486334,59417,31,03,1,2019,2019-03-31,2,2019,1584989113,61897
Agency,Federal Maritime Commission,null,Non-CFO,99.74236266727436,54.54545454545455,1221,5,472701,6,31,03,1,2019,2019-03-31,2,2019,473922,11
Agency,Department of Defense,null,CFO,47.6460983966445,19.817451344505184,1212587953,1212037,1103548793,299560,31,03,1,2019,2019-03-31,2,2019,2316136746,1511597
Agency,Pension Benefit Guaranty Corp,null,Non-CFO,100.0,100.0,0,0,2679885,1034,31,03,1,2019,2019-03-31,2,2019,2679885,1034
Agency,Corp. for National and Community Service,null,Non-CFO,95.96638408756925,95.72953736654804,148386,12,3530348,269,31,03,1,2019,2019-03-31,2,2019,3678734,281
Agency,Legislative Branch-CBO,null,Non-CFO,0.0,0.0,0,0,0,0,31,03,1,2019,2019-03-31,2,2019,0,0
Agency,Legislative Branch-Office of Tech.,null,Non-CFO,0.0,0.0,0,0,0,0,31,03,1,2019,2019-03-31,2,2019,0,0
Agency,Overseas Private Investment Corp Accts,null,Non-CFO,0.0,0.0,0,0,0,0,31,03,1,2019,2019-03-31,2,2019,0,0
Bureau,Other Agencies/Boards/Commissions,U.S. Comm. on Int. Religious Freedom,null,0.0,0.0,393,1,0,0,31,03,1,2019,2019-03-31,2,2019,393,1
Bureau,Department of Labor,Employment and Training Administration,null,100.0,100.0,0,0,2898431,3,31,03,1,2019,2019-03-31,2,2019,2898431,3
Bureau,Legislative Branch-GPO,Government Publishing Office,null,0.0,0.0,104300,73,0,0,31,03,1,2019,2019-03-31,2,2019,104300,73
Agency,Commodity Futures Trading Commission,null,Non-CFO,100.0,100.0,0,0,636592127,376,31,03,1,2019,2019-03-31,2,2019,636592127,376
Agency,Securities & Exchange Commission,null,Non-CFO,100.0,100.0,0,0,2050557175,857,31,03,1,2019,2019-03-31,2,2019,2050557175,857
Bureau,Funds Appropriated to the President,Inter-American Foundation,null,0.0,0.0,0,0,0,0,31,03,1,2019,2019-03-31,2,2019,0,0
Bureau,Department of Homeland Security,Transportation Safety Administration,null,100.0,100.0,0,0,13078188,5729,31,03,1,2019,2019-03-31,2,2019,13078188,5729
Agency,Office of Compliance,null,Non-CFO,0.0,0.0,0,0,0,0,31,03,1,2019,2019-03-31,2,2019,0,0
Bureau,Tennessee Valley Authority,Tennessee Valley Authority,null,0.0,0.0,0,0,0,0,31,03,1,2019,2019-03-31,2,2019,0,0
Agency,Department of Health & Human Services,null,CFO,97.09939829560005,98.7743492352848,302681663,18503,10132451935,1491144,31,03,1,2019,2019-03-31,2,2019,10435133598,1509647
Bureau,Funds Appropriated to the President,African Development Foundation,null,0.0,0.0,0,0,0,0,31,03,1,2019,2019-03-31,2,2019,0,0
Agency,Office of Special Counsel,null,Non-CFO,0.0,0.0,0,0,0,0,31,03,1,2019,2019-03-31,2,2019,0,0
Bureau,Department of Labor,Departmental Management,null,0.0,0.0,0,0,0,0,31,03,1,2019,2019-03-31,2,2019,0,0
Bureau,Department of State,Civil Monetary Penalties,null,0.0,0.0,0,0,0,0,31,03,1,2019,2019-03-31,2,2019,0,0
Agency,Department of Veterans Affairs,null,CFO,89.96410376888895,98.46037240488447,119712659,130798,1073132068,8364633,31,03,1,2019,2019-03-31,2,2019,1192844727,8495431
Bureau,Smithsonian Institution,National Gallery of Art,null,0.0,0.0,0,0,0,0,31,03,1,2019,2019-03-31,2,2019,0,0
Bureau,Department of Homeland Security,Info Analysis Infrastructure Prot-NPPD,null,0.0,0.0,0,0,0,0,31,03,1,2019,2019-03-31,2,2019,0,0
Bureau,Farm Credit Administration,Farm Credit System Insurance Corporation,null,0.0,0.0,0,0,0,0,31,03,1,2019,2019-03-31,2,2019,0,0
Bureau,Export - Import  Bank,Export-Import Bank,null,0.0,0.0,0,0,0,0,31,03,1,2019,2019-03-31,2,2019,0,0
Bureau,Department of Transportation,Federal Motor Carrier Safety Admin,null,99.98945484414334,99.89986648865154,5254,6,49818571,5986,31,03,1,2019,2019-03-31,2,2019,49823825,5992
Bureau,Department of Homeland Security,Office of Health Affairs,null,0.0,0.0,0,0,0,0,31,03,1,2019,2019-03-31,2,2019,0,0
Bureau,Department of the Interior,National Park Service,null,100.0,100.0,0,0,6264991,1986,31,03,1,2019,2019-03-31,2,2019,6264991,1986
Bureau,Department of the Treasury,Bureau of the Fiscal Service,null,100.0,100.0,0,0,13231652,4630,31,03,1,2019,2019-03-31,2,2019,13231652,4630
Bureau,Department of Agriculture,Commodity Credit Corporation,null,99.94450569442974,99.78791092258749,68444,22,123266733,10351,31,03,1,2019,2019-03-31,2,2019,123335177,10373
Agency,Department of Education,null,CFO,81.34853899904616,78.94095650461112,30077086841,5942272,131181523621,22274926,31,03,1,2019,2019-03-31,2,2019,161258610462,28217198
Agency,Neighborhood Reinvestment Corporation,null,Non-CFO,0.0,0.0,0,0,0,0,31,03,1,2019,2019-03-31,2,2019,0,0
Agency,Office of Government Ethics,null,Non-CFO,0.0,0.0,0,0,0,0,31,03,1,2019,2019-03-31,2,2019,0,0
Bureau,Department of the Treasury,Treasury IG for Tax Admin,null,0.0,0.0,0,0,0,0,31,03,1,2019,2019-03-31,2,2019,0,0
Agency,The Judiciary,null,Non-CFO,100.0,100.0,0,0,1573540,259,31,03,1,2019,2019-03-31,2,2019,1573540,259
Bureau,Department of the Treasury,U.S. Treasury IG Office,null,0.0,0.0,0,0,0,0,31,03,1,2019,2019-03-31,2,2019,0,0
Bureau,Department of Education,Office of Postsecondary Education,null,0.0,0.0,0,0,0,0,31,03,1,2019,2019-03-31,2,2019,0,0
Bureau,Department of Health & Human Services,Office of the Inspector General,null,0.0,0.0,0,0,0,0,31,03,1,2019,2019-03-31,2,2019,0,0
Bureau,Department of Transportation,Surface Transportation Board,null,0.0,0.0,0,0,0,0,31,03,1,2019,2019-03-31,2,2019,0,0
Bureau,Department of the Treasury,Office of the Secretary,null,0.0,0.0,0,0,0,0,31,03,1,2019,2019-03-31,2,2019,0,0
Bureau,Other Agencies/Boards/Commissions,U.S.-China Security Review Commission,null,0.0,0.0,0,0,0,0,31,03,1,2019,2019-03-31,2,2019,0,0
Bureau,Department of the Interior,Geological Survey,null,100.0,100.0,0,0,743623,162,31,03,1,2019,2019-03-31,2,2019,743623,162
Bureau,Department of Transportation,Office of the Secretary,null,100.0,100.0,0,0,1421247,22,31,03,1,2019,2019-03-31,2,2019,1421247,22
Bureau,Farm Credit Administration,Farm Credit Administration,null,100.0,100.0,0,0,622,1,31,03,1,2019,2019-03-31,2,2019,622,1
Bureau,Department of Homeland Security,Emergency Preparedness & Resp,null,100.0,100.0,0,0,257341226,43003,31,03,1,2019,2019-03-31,2,2019,257341226,43003
Agency,Merit Systems Protection Board,null,Non-CFO,100.0,100.0,0,0,137,1,31,03,1,2019,2019-03-31,2,2019,137,1
Bureau,American Battle Monuments Commission,American Battle Monuments Commission,null,0.0,0.0,0,0,0,0,31,03,1,2019,2019-03-31,2,2019,0,0
Bureau,Department of Homeland Security,Domestic Nuclear Detection Office,null,0.0,0.0,0,0,0,0,31,03,1,2019,2019-03-31,2,2019,0,0
Bureau,Legis Branch-Library of Congress,Library of Congress,null,0.0,0.0,0,0,0,0,31,03,1,2019,2019-03-31,2,2019,0,0
Agency,Occupational Safety & Health Rev Comm,null,Non-CFO,0.0,0.0,209,1,0,0,31,03,1,2019,2019-03-31,2,2019,209,1
Bureau,Legislative Branch - U.S. House/Senate,U.S. House of Representatives,null,0.0,0.0,304682,429,0,0,31,03,1,2019,2019-03-31,2,2019,304682,429
Bureau,Equal Employment Opportunity Commission,Equal Employment Opportunity Commission,null,100.0,100.0,0,0,29677,21,31,03,1,2019,2019-03-31,2,2019,29677,21
Agency,National Aeronautics and Space Administration,null,CFO,98.58793879512407,96.06299212598425,24507,5,1711041,122,31,03,1,2019,2019-03-31,2,2019,1735548,127
Agency,Other Agencies/Boards/Commissions,null,Non-CFO,0.0,0.0,393,1,0,0,31,03,1,2019,2019-03-31,2,2019,393,1
Agency,Consumer Product Safety Commission,null,Non-CFO,100.0,100.0,0,0,473,1,31,03,1,2019,2019-03-31,2,2019,473,1
Bureau,Department of Health & Human Services,Substance Abuse & Mental Health Admin.,null,100.0,100.0,0,0,707339,12,31,03,1,2019,2019-03-31,2,2019,707339,12
Bureau,Department of Health & Human Services,Indian Health Services,null,46.515683019502816,4.903147699757869,25736725,3142,22383409,162,31,03,1,2019,2019-03-31,2,2019,48120134,3304
Agency,Farm Credit Administration,null,Non-CFO,100.0,100.0,0,0,622,1,31,03,1,2019,2019-03-31,2,2019,622,1
Agency,U.S. Court of Appeals / Veterans Claims,null,Non-CFO,100.0,100.0,0,0,3921,5,31,03,1,2019,2019-03-31,2,2019,3921,5
Bureau,Department of Transportation,St. Lawrence Seaway Development Corp.,null,0.0,0.0,0,0,0,0,31,03,1,2019,2019-03-31,2,2019,0,0
Bureau,Department of Justice,Drug Enforcement Administration,null,100.0,100.0,0,0,336134,22,31,03,1,2019,2019-03-31,2,2019,336134,22
Bureau,Department of the Treasury,Office of Sec International Affairs,null,0.0,0.0,0,0,0,0,31,03,1,2019,2019-03-31,2,2019,0,0
Agency,Equal Employment Opportunity Commission,null,Non-CFO,100.0,100.0,0,0,29677,21,31,03,1,2019,2019-03-31,2,2019,29677,21
Bureau,Department of Homeland Security,Office of Biometric Identity Management,null,0.0,0.0,0,0,0,0,31,03,1,2019,2019-03-31,2,2019,0,0
Bureau,Department of the Treasury,Treasury Forfeiture Fund,null,0.0,0.0,0,0,0,0,31,03,1,2019,2019-03-31,2,2019,0,0
Bureau,Other Agencies,Archit.&Trans. Barriers Compliance Bd,null,0.0,0.0,0,0,0,0,31,03,1,2019,2019-03-31,2,2019,0,0
Bureau,Department of the Interior,Office of Surface Mining,null,100.0,100.0,0,0,2272725,252,31,03,1,2019,2019-03-31,2,2019,2272725,252
Agency,Nuclear Regulatory Commission,null,CFO,98.92917475330071,99.65156794425087,19587,1,1809563,286,31,03,1,2019,2019-03-31,2,2019,1829150,287
Agency,Armed Forces Retirement Home,null,Non-CFO,93.2505278554325,89.7196261682243,5722,11,79055,96,31,03,1,2019,2019-03-31,2,2019,84777,107
Agency,National Archives & Records Admin,null,Non-CFO,87.17099753213253,96.03960396039604,22977,4,156125,97,31,03,1,2019,2019-03-31,2,2019,179102,101
Agency,Office of Personnel Management,null,CFO,89.63480472335118,81.79190751445087,1740802,189,15053884,849,31,03,1,2019,2019-03-31,2,2019,16794686,1038
Agency,Legislative Branch - U.S. House/Senate,null,Non-CFO,0.0,0.0,304682,429,0,0,31,03,1,2019,2019-03-31,2,2019,304682,429
Bureau,Department of Justice,Bureau of ATF and Explosives,null,43.16297512716786,14.285714285714286,28381,24,21553,4,31,03,1,2019,2019-03-31,2,2019,49934,28
Bureau,U.S. Court of Appeals / Veterans Claims,U.S. Court of Appeals / Veterans Claims,null,100.0,100.0,0,0,3921,5,31,03,1,2019,2019-03-31,2,2019,3921,5
Agency,Federal Election Commission,null,Non-CFO,94.52861450981746,96.55172413793103,34871,3,602463,84,31,03,1,2019,2019-03-31,2,2019,637334,87
Bureau,Department of Housing and Urban Development,Community Planning and Development,null,0.0,0.0,0,0,0,0,31,03,1,2019,2019-03-31,2,2019,0,0
Bureau,Department of Commerce,Bureau of Industry and Security,null,100.0,100.0,0,0,424797,12,31,03,1,2019,2019-03-31,2,2019,424797,12
Bureau,Department of the Treasury,Bureau of Engraving and Printing,null,100.0,100.0,0,0,84528,1,31,03,1,2019,2019-03-31,2,2019,84528,1
Bureau,Armed Forces Retirement Home,Armed Forces Retirement Home,null,93.2505278554325,89.7196261682243,5722,11,79055,96,31,03,1,2019,2019-03-31,2,2019,84777,107
Bureau,Department of Transportation,Office of the Inspector General,null,100.0,100.0,0,0,203,1,31,03,1,2019,2019-03-31,2,2019,203,1
Bureau,Other Agencies,Comm. for Purchase from Blind/Handic.,null,0.0,0.0,0,0,0,0,31,03,1,2019,2019-03-31,2,2019,0,0
Bureau,Department of Homeland Security,Federal Law Enforcement Training Ctr.,null,100.0,100.0,0,0,4915,1,31,03,1,2019,2019-03-31,2,2019,4915,1
Bureau,Department of Agriculture,Federal Crop Insurance Corporation,null,100.0,100.0,0,0,108060,377,31,03,1,2019,2019-03-31,2,2019,108060,377
Bureau,National Aeronautics and Space Administration,National Aeronautics and Space Admin,null,98.58793879512407,96.06299212598425,24507,5,1711041,122,31,03,1,2019,2019-03-31,2,2019,1735548,127
Agency,Department of the Interior,null,CFO,99.95445727025289,99.43332569032722,29324,173,64358560,30356,31,03,1,2019,2019-03-31,2,2019,64387884,30529
Bureau,Department of Homeland Security,Office of the Inspector General DHS,null,100.0,100.0,0,0,1036,10,31,03,1,2019,2019-03-31,2,2019,1036,10
Agency,U.S. Postal Service,null,Non-CFO,71.60944167347208,82.52308426689738,17838451,11716,44993885,55321,31,03,1,2019,2019-03-31,2,2019,62832336,67037
Agency,Social Security Administration,null,CFO,30.997080495364624,13.63096995069205,5098924293,2478374,2290508400,391143,31,03,1,2019,2019-03-31,2,2019,7389432693,2869517
Bureau,Department of the Treasury,Internal Revenue Service,null,99.9812099929433,99.07407407407408,45,1,239444,107,31,03,1,2019,2019-03-31,2,2019,239489,108
Bureau,Other Agencies,U.S. Inst. for Env. Conflict Resolution,null,0.0,0.0,1884,8,0,0,31,03,1,2019,2019-03-31,2,2019,1884,8
Bureau,Department of Health & Human Services,Office of the Secretary,null,100.0,100.0,0,0,4848,8,31,03,1,2019,2019-03-31,2,2019,4848,8
Bureau,Department of the Interior,Bureau of Safety and Environmental Enf.,null,100.0,100.0,0,0,14571,5,31,03,1,2019,2019-03-31,2,2019,14571,5
Bureau,Department of Commerce,National Technical Information Service,null,0.0,0.0,16196,15,0,0,31,03,1,2019,2019-03-31,2,2019,16196,15
Bureau,Department of Commerce,Nat'l Telecomm & Information Admin.,null,100.0,100.0,0,0,408340,3,31,03,1,2019,2019-03-31,2,2019,408340,3
Bureau,Department of Transportation,Federal Transit Administration,null,100.0,100.0,0,0,784403,2,31,03,1,2019,2019-03-31,2,2019,784403,2
Bureau,Department of Health & Human Services,Health Resources and Services Admin,null,100.0,100.0,0,0,89775769,516,31,03,1,2019,2019-03-31,2,2019,89775769,516
Bureau,Federal Trade Commission,Federal Trade Commission,null,100.0,100.0,0,0,483082464,55,31,03,1,2019,2019-03-31,2,2019,483082464,55
Bureau,Corp. for National and Community Service,Corp. for National and Community Service,null,95.96638408756925,95.72953736654804,148386,12,3530348,269,31,03,1,2019,2019-03-31,2,2019,3678734,281
Bureau,Department of Health & Human Services,Administration for Children and Families,null,100.0,100.0,0,0,25262939,1668,31,03,1,2019,2019-03-31,2,2019,25262939,1668
Bureau,Department of Homeland Security,Citizenship and Immigration Services,null,100.0,100.0,0,0,992168,1230,31,03,1,2019,2019-03-31,2,2019,992168,1230
Bureau,Department of Justice,Federal Prison Industries,null,100.0,100.0,0,0,1043089,183,31,03,1,2019,2019-03-31,2,2019,1043089,183
Bureau,Department of Labor,Employee Benefit Security Administration,null,100.0,100.0,0,0,17173133,390,31,03,1,2019,2019-03-31,2,2019,17173133,390
Agency,Environmental Protection Agency,null,CFO,100.0,100.0,0,0,16527386,211,31,03,1,2019,2019-03-31,2,2019,16527386,211
Bureau,Department of Homeland Security,Science and Technology,null,0.0,0.0,0,0,0,0,31,03,1,2019,2019-03-31,2,2019,0,0
Agency,Department of Justice,null,CFO,98.7027258947418,99.03824200913242,1090302,337,82955313,34703,31,03,1,2019,2019-03-31,2,2019,84045615,35040
Agency,National Labor Relations Board,null,Non-CFO,0.0,0.0,0,0,0,0,31,03,1,2019,2019-03-31,2,2019,0,0
Bureau,Other Agencies,Election Assistance Commission,null,0.0,0.0,0,0,0,0,31,03,1,2019,2019-03-31,2,2019,0,0
Agency,Federal Labor Relations Authority,null,Non-CFO,0.0,0.0,0,0,0,0,31,03,1,2019,2019-03-31,2,2019,0,0
Bureau,Department of the Treasury,Tobacco Tax and Trade,null,100.0,100.0,0,0,1000,1,31,03,1,2019,2019-03-31,2,2019,1000,1
Bureau,Department of Commerce,Patent and Trademark Office,null,100.0,100.0,0,0,369961,528,31,03,1,2019,2019-03-31,2,2019,369961,528
Agency,American Battle Monuments Commission,null,Non-CFO,0.0,0.0,0,0,0,0,31,03,1,2019,2019-03-31,2,2019,0,0
Bureau,Legislative Branch-CBO,Congressional Budget Office,null,0.0,0.0,0,0,0,0,31,03,1,2019,2019-03-31,2,2019,0,0
Agency,Agency for International Development,null,CFO,99.92176056314433,93.33333333333333,22651,4,28928222,56,31,03,1,2019,2019-03-31,2,2019,28950873,60
Bureau,Other Agencies,U.S. Holocaust Memorial Council,null,0.0,0.0,0,0,0,0,31,03,1,2019,2019-03-31,2,2019,0,0
Bureau,Other Agencies,National Mediation Board,null,0.0,0.0,153,1,0,0,31,03,1,2019,2019-03-31,2,2019,153,1
Bureau,Federal Mediation/Conciliation Service,Federal Mediation/Conciliation Service,null,0.0,0.0,0,0,0,0,31,03,1,2019,2019-03-31,2,2019,0,0
Agency,Other Agencies,null,Non-CFO,1.9158783419301357,4.854368932038835,718220,98,14029,5,31,03,1,2019,2019-03-31,2,2019,732249,103
Bureau,Federal Election Commission,Federal Election Commission,null,94.52861450981746,96.55172413793103,34871,3,602463,84,31,03,1,2019,2019-03-31,2,2019,637334,87
Bureau,Federal Communications Commission,Federal Communications Commission,null,100.0,100.0,0,0,204572605,13372,31,03,1,2019,2019-03-31,2,2019,204572605,13372
Agency,General Services Administration,null,CFO,83.23449731837424,88.64541832669323,2808301,399,13942172,3115,31,03,1,2019,2019-03-31,2,2019,16750473,3514
Bureau,Other Agencies,Federal Mine Safety & Health Review Comm,null,0.0,0.0,0,0,0,0,31,03,1,2019,2019-03-31,2,2019,0,0
Bureau,Department of Homeland Security,Immigration and Customs Enforcement,null,100.0,100.0,0,0,9045883,404,31,03,1,2019,2019-03-31,2,2019,9045883,404
Agency,Department of Transportation,null,CFO,99.7019156593325,99.36777178103316,187194,41,62611811,6444,31,03,1,2019,2019-03-31,2,2019,62799005,6485
Bureau,Department of State,Department of State,null,98.0169561555492,98.61366293636212,324638,83,16046054,5904,31,03,1,2019,2019-03-31,2,2019,16370692,5987
Bureau,Department of Transportation,Federal Railroad Administration,null,100.0,100.0,0,0,184449,17,31,03,1,2019,2019-03-31,2,2019,184449,17
Bureau,Department of Education,Departmental Management,null,96.42430872507934,96.1640916355887,26204147,72,706637281,1805,31,03,1,2019,2019-03-31,2,2019,732841428,1877
Bureau,Other Agencies,U.S.  Agency of Global Media,null,100.0,100.0,0,0,14029,5,31,03,1,2019,2019-03-31,2,2019,14029,5
Bureau,Department of Transportation,Maritime Administration,null,100.0,100.0,0,0,4157,5,31,03,1,2019,2019-03-31,2,2019,4157,5
Bureau,Department of Health & Human Services,Program Support Center,null,100.0,100.0,0,0,4355060,831,31,03,1,2019,2019-03-31,2,2019,4355060,831
Agency,Department of Homeland Security,null,CFO,100.0,100.0,0,0,365232979,61534,31,03,1,2019,2019-03-31,2,2019,365232979,61534
Bureau,Smithsonian Institution,Administrative Conference of the US,null,0.0,0.0,0,0,0,0,31,03,1,2019,2019-03-31,2,2019,0,0
Bureau,Department of the Interior,Bureau of Indian Affairs,null,99.78198367643297,99.36604492652717,29324,173,13421045,27116,31,03,1,2019,2019-03-31,2,2019,13450369,27289
Bureau,Funds Appropriated to the President,Defense Security Assistance Agency,null,0.0,0.0,0,0,0,0,31,03,1,2019,2019-03-31,2,2019,0,0
Agency,Small Business Administration,null,CFO,99.90522960845809,99.92124317229114,11410495,93,12028737081,117992,31,03,1,2019,2019-03-31,2,2019,12040147576,118085
Bureau,Federal Maritime Commission,Salaries and Expenses,null,99.74236266727436,54.54545454545455,1221,5,472701,6,31,03,1,2019,2019-03-31,2,2019,473922,11
Bureau,Department of Agriculture,Forest Service,null,94.16878717620033,21.363636363636363,3286098,1211,53067496,329,31,03,1,2019,2019-03-31,2,2019,56353594,1540
Bureau,Department of Homeland Security,Bureau of Customs & Border Protection,null,100.0,100.0,0,0,8408436,526,31,03,1,2019,2019-03-31,2,2019,8408436,526
Bureau,Department of the Treasury,D.C. Pension Program,null,100.0,100.0,0,0,303040,17,31,03,1,2019,2019-03-31,2,2019,303040,17
Bureau,Other Agencies,Architect of the Capitol,null,0.0,0.0,0,0,0,0,31,03,1,2019,2019-03-31,2,2019,0,0
Bureau,Department of Energy,Energy Consolidated Reports,null,100.0,100.0,0,0,16882390,73,31,03,1,2019,2019-03-31,2,2019,16882390,73
Agency,Tennessee Valley Authority,null,Non-CFO,0.0,0.0,0,0,0,0,31,03,1,2019,2019-03-31,2,2019,0,0
Bureau,Other Agencies,National Transportation Safety Board,null,0.0,0.0,0,0,0,0,31,03,1,2019,2019-03-31,2,2019,0,0
Bureau,Department of Veterans Affairs,Life Insurance,null,100.0,100.0,0,0,569515,98,31,03,1,2019,2019-03-31,2,2019,569515,98
Bureau,Department of Justice,Federal Prison System,null,100.0,100.0,0,0,5131876,108,31,03,1,2019,2019-03-31,2,2019,5131876,108
Bureau,Other Agencies,Denali Commission,null,0.0,0.0,0,0,0,0,31,03,1,2019,2019-03-31,2,2019,0,0
Bureau,Other Agencies,Morris K. Udall Scholarship,null,0.0,0.0,982,1,0,0,31,03,1,2019,2019-03-31,2,2019,982,1
Bureau,National Credit Union Administration,National Credit Union Administration,null,0.0,0.0,0,0,0,0,31,03,1,2019,2019-03-31,2,2019,0,0
Bureau,Smithsonian Institution,Smithsonian Institution,null,0.0,0.0,0,0,0,0,31,03,1,2019,2019-03-31,2,2019,0,0
Bureau,Funds Appropriated to the President,Trade and Development Agency,null,100.0,100.0,0,0,791105,4,31,03,1,2019,2019-03-31,2,2019,791105,4
Bureau,Department of Health & Human Services,Administration for Community Living,null,0.0,0.0,0,0,0,0,31,03,1,2019,2019-03-31,2,2019,0,0
Bureau,Department of Transportation,National Highway Traffic Safety Admin.,null,100.0,100.0,0,0,7622588,5,31,03,1,2019,2019-03-31,2,2019,7622588,5
Bureau,Other Agencies,Millennium Challenge Corporation,null,0.0,0.0,0,0,0,0,31,03,1,2019,2019-03-31,2,2019,0,0
Agency,Department of Energy,null,CFO,100.0,100.0,0,0,17975087,110,31,03,1,2019,2019-03-31,2,2019,17975087,110
Bureau,Other Agencies,Federal Housing Finance Agency,null,0.0,0.0,0,0,0,0,31,03,1,2019,2019-03-31,2,2019,0,0
Bureau,Pension Benefit Guaranty Corp,Pension Benefit Guaranty Corporation,null,100.0,100.0,0,0,2679885,1034,31,03,1,2019,2019-03-31,2,2019,2679885,1034
Bureau,Department of Commerce,NOAA,null,100.0,100.0,0,0,4599201,596,31,03,1,2019,2019-03-31,2,2019,4599201,596
Bureau,Department of Homeland Security,U.S. Secret Service,null,0.0,0.0,0,0,0,0,31,03,1,2019,2019-03-31,2,2019,0,0
Bureau,Department of Justice,U.S. Marshals Service,null,0.0,0.0,4476,3,0,0,31,03,1,2019,2019-03-31,2,2019,4476,3
Bureau,Department of Transportation,Pipeline Hazardous Material Safety Admin,null,100.0,100.0,0,0,361005,24,31,03,1,2019,2019-03-31,2,2019,361005,24
Bureau,Federal Deposit Insurance Corporation,Federal Deposit Insurance Corporation,null,0.0,0.0,0,0,0,0,31,03,1,2019,2019-03-31,2,2019,0,0
Bureau,Federal Labor Relations Authority,Federal Labor Relations Authority,null,0.0,0.0,0,0,0,0,31,03,1,2019,2019-03-31,2,2019,0,0
Bureau,Department of the Treasury,Community Dev Financial Inst Fund,null,100.0,100.0,0,0,4076830,7,31,03,1,2019,2019-03-31,2,2019,4076830,7
Bureau,Department of Commerce,Office of the Inspector General,null,0.0,0.0,0,0,0,0,31,03,1,2019,2019-03-31,2,2019,0,0
Agency,Department of State,null,CFO,98.0169561555492,98.61366293636212,324638,83,16046054,5904,31,03,1,2019,2019-03-31,2,2019,16370692,5987
Bureau,Department of State,International Commissions,null,0.0,0.0,0,0,0,0,31,03,1,2019,2019-03-31,2,2019,0,0
Bureau,Legislative Branch-Office of Tech.,Medicaid & CHIP Payment & Access Comm.,null,0.0,0.0,0,0,0,0,31,03,1,2019,2019-03-31,2,2019,0,0
Bureau,Department of Homeland Security,Management Headquarters,null,100.0,100.0,0,0,301,1,31,03,1,2019,2019-03-31,2,2019,301,1
Bureau,Other Agencies,James Madison Memorial Fellowship,null,0.0,0.0,230451,23,0,0,31,03,1,2019,2019-03-31,2,2019,230451,23
Bureau,Securities & Exchange Commission,SEC Enforcement,null,0.0,0.0,0,0,0,0,31,03,1,2019,2019-03-31,2,2019,0,0
Bureau,Funds Appropriated to the President,Peace Corps,null,0.0,0.0,0,0,0,0,31,03,1,2019,2019-03-31,2,2019,0,0
Bureau,Other Agencies,Commission On Fine Arts,null,0.0,0.0,0,0,0,0,31,03,1,2019,2019-03-31,2,2019,0,0
Bureau,Department of Homeland Security,U.S. Coast Guard,null,100.0,100.0,0,0,76360826,10630,31,03,1,2019,2019-03-31,2,2019,76360826,10630
Bureau,National Labor Relations Board,National Labor Relations Board,null,0.0,0.0,0,0,0,0,31,03,1,2019,2019-03-31,2,2019,0,0
Bureau,Department of Housing and Urban Development,Management and Administration,null,0.0,0.0,0,0,0,0,31,03,1,2019,2019-03-31,2,2019,0,0
Bureau,Environmental Protection Agency,Environmental Protection Agency,null,100.0,100.0,0,0,16527386,211,31,03,1,2019,2019-03-31,2,2019,16527386,211
Bureau,General Services Administration,General Services Administration,null,83.23449731837424,88.64541832669323,2808301,399,13942172,3115,31,03,1,2019,2019-03-31,2,2019,16750473,3514
Bureau,Railroad Retirement Board,Railroad Retirement Board,null,100.0,100.0,0,0,18672856,3789,31,03,1,2019,2019-03-31,2,2019,18672856,3789
Bureau,Department of Agriculture,U.S. Department of Agriculture,null,71.49162796370706,71.61204605845882,6609950,641,16576046,1617,31,03,1,2019,2019-03-31,2,2019,23185996,2258
Bureau,Department of the Interior,Office of Natural Resources Revenue,null,100.0,100.0,0,0,28145257,360,31,03,1,2019,2019-03-31,2,2019,28145257,360
Bureau,Department of Labor,Mine Safety and Health Administration,null,95.99024303696159,97.95068635742632,1857720,315,44472270,15056,31,03,1,2019,2019-03-31,2,2019,46329990,15371
Bureau,Department of Labor,Occupational Safety and Health Admin,null,92.13599329386038,91.96230598669624,1837414,145,21527444,1659,31,03,1,2019,2019-03-31,2,2019,23364858,1804
Bureau,Department of Justice,Legal Activities,null,98.61917650820635,99.10456383593299,1057445,310,75523306,34310,31,03,1,2019,2019-03-31,2,2019,76580751,34620
Bureau,Department of Labor,Employment Standards Administration,null,71.6077500628829,28.802944569576443,33245802,12960,83848835,5243,31,03,1,2019,2019-03-31,2,2019,117094637,18203
Bureau,Department of Housing and Urban Development,Housing Programs,null,99.99694169975159,99.98464844949339,5112,1,167146560,6513,31,03,1,2019,2019-03-31,2,2019,167151672,6514
Bureau,Department of Agriculture,Rural Development,null,100.0,100.0,0,0,631426397,32023,31,03,1,2019,2019-03-31,2,2019,631426397,32023
Agency,Smithsonian Institution,null,Non-CFO,0.0,0.0,0,0,0,0,31,03,1,2019,2019-03-31,2,2019,0,0
Bureau,Department of the Interior,Bureau of Reclamation,null,100.0,100.0,0,0,97980,91,31,03,1,2019,2019-03-31,2,2019,97980,91
Bureau,Department of Agriculture,Agricultural Marketing Service,null,57.941031377050656,65.87215601300109,1953245,315,2690818,608,31,03,1,2019,2019-03-31,2,2019,4644063,923
Bureau,Department of the Interior,Bureau of Land Management,null,100.0,100.0,0,0,12786315,274,31,03,1,2019,2019-03-31,2,2019,12786315,274
Bureau,Office of Personnel Management,Office of Personnel Management,null,89.63480472335118,81.79190751445087,1740802,189,15053884,849,31,03,1,2019,2019-03-31,2,2019,16794686,1038
Bureau,Agency for International Development,Agency for International Development,null,99.92176056314433,93.33333333333333,22651,4,28928222,56,31,03,1,2019,2019-03-31,2,2019,28950873,60
Bureau,Department of the Treasury,Departmental Offices,null,92.237492528357,90.3303787268332,3072503,120,36508818,1121,31,03,1,2019,2019-03-31,2,2019,39581321,1241
Bureau,Department of Health & Human Services,Food and Drug Administration,null,73.06159836353449,22.992373261552267,10864874,3433,29467415,1025,31,03,1,2019,2019-03-31,2,2019,40332289,4458
Bureau,Department of Veterans Affairs,Veterans Benefits,null,99.76229301978337,98.49809818349863,1289526,1690,541196016,110834,31,03,1,2019,2019-03-31,2,2019,542485542,112524
Bureau,Commodity Futures Trading Commission,Commodity Futures Trading Commission,null,100.0,100.0,0,0,636592127,376,31,03,1,2019,2019-03-31,2,2019,636592127,376
Bureau,Department of Veterans Affairs,Medical and Construction,null,82.67434066710247,98.46780383785133,111250173,128430,530862031,8253656,31,03,1,2019,2019-03-31,2,2019,642112204,8382086
Bureau,Department of Agriculture,Farm Service Agency,null,99.99940905252939,99.99231005844355,4381,1,741347468,13003,31,03,1,2019,2019-03-31,2,2019,741351849,13004
Bureau,Securities & Exchange Commission,Securities and Exchange Commission,null,100.0,100.0,0,0,2050557175,857,31,03,1,2019,2019-03-31,2,2019,2050557175,857
Bureau,U.S. Postal Service,U.S. Postal Service,null,71.60944167347208,82.52308426689738,17838451,11716,44993885,55321,31,03,1,2019,2019-03-31,2,2019,62832336,67037
Bureau,Department of Defense,Consolidated Report,null,47.6460983966445,19.817451344505184,1212587953,1212037,1103548793,299560,31,03,1,2019,2019-03-31,2,2019,2316136746,1511597
Bureau,Social Security Administration,Social Security Administration,null,30.997080495364624,13.63096995069205,5098924293,2478374,2290508400,391143,31,03,1,2019,2019-03-31,2,2019,7389432693,2869517
Bureau,Small Business Administration,Small Business Administration,null,99.90522960845809,99.92124317229114,11410495,93,12028737081,117992,31,03,1,2019,2019-03-31,2,2019,12040147576,118085
Bureau,Department of Education,Federal Student Aid,null,81.27971423227687,78.93981075033668,30050882694,5942200,130474886340,22273121,31,03,1,2019,2019-03-31,2,2019,160525769034,28215321
Bureau,Department of Veterans Affairs,Administration and Cemeteries,null,0.12563207307203847,2.0648967551622417,6572854,664,8268,14,31,03,1,2019,2019-03-31,2,2019,6581122,678
Bureau,Department of Commerce,International Trade Administration,null,0.0,0.0,0,0,0,0,30,06,2,2019,2019-06-30,3,2019,0,0
Bureau,Department of Commerce,Minority Business Development Agency,null,0.0,0.0,0,0,0,0,30,06,2,2019,2019-06-30,3,2019,0,0
Bureau,Legislative Branch-GPO,Government Publishing Office,null,0.0,0.0,91020,49,0,0,30,06,2,2019,2019-06-30,3,2019,91020,49
Bureau,Other Agencies,Millennium Challenge Corporation,null,0.0,0.0,0,0,0,0,30,06,2,2019,2019-06-30,3,2019,0,0
Bureau,Other Agencies,U.S. Holocaust Memorial Council,null,0.0,0.0,0,0,0,0,30,06,2,2019,2019-06-30,3,2019,0,0
Bureau,Other Agencies,Archit.&Trans. Barriers Compliance Bd,null,0.0,0.0,0,0,0,0,30,06,2,2019,2019-06-30,3,2019,0,0
Bureau,U.S. Court of Appeals / Veterans Claims,U.S. Court of Appeals / Veterans Claims,null,100.0,100.0,0,0,167,1,30,06,2,2019,2019-06-30,3,2019,167,1
Agency,Department of Commerce,null,CFO,100.0,100.0,0,0,19913468,1415,30,06,2,2019,2019-06-30,3,2019,19913468,1415
Bureau,Funds Appropriated to the President,African Development Foundation,null,0.0,0.0,0,0,0,0,30,06,2,2019,2019-06-30,3,2019,0,0
Bureau,Department of Health & Human Services,Office of the Secretary,null,100.0,100.0,0,0,6291,9,30,06,2,2019,2019-06-30,3,2019,6291,9
Bureau,Department of the Interior,Bureau of Safety and Environmental Enf.,null,100.0,100.0,0,0,14571,5,30,06,2,2019,2019-06-30,3,2019,14571,5
Bureau,Department of Justice,Federal Bureau of Investigation,null,100.0,100.0,0,0,42741,30,30,06,2,2019,2019-06-30,3,2019,42741,30
Bureau,Other Agencies,District of Columbia Government,null,0.0,0.0,0,0,0,0,30,06,2,2019,2019-06-30,3,2019,0,0
Bureau,Other Agencies,Delta Regional Authority,null,0.0,0.0,0,0,0,0,30,06,2,2019,2019-06-30,3,2019,0,0
Bureau,Department of Labor,Departmental Management,null,0.0,0.0,0,0,0,0,30,06,2,2019,2019-06-30,3,2019,0,0
Bureau,National Foundation  Arts & Humanities,National Endowment for the Arts,null,0.0,0.0,0,0,0,0,30,06,2,2019,2019-06-30,3,2019,0,0
Bureau,Office of Compliance,Office of Compliance,null,0.0,0.0,0,0,0,0,30,06,2,2019,2019-06-30,3,2019,0,0
Bureau,Department of the Treasury,Interest on Tax/Deposit of Earnings,null,0.0,0.0,0,0,0,0,30,06,2,2019,2019-06-30,3,2019,0,0
Bureau,Equal Employment Opportunity Commission,Equal Employment Opportunity Commission,null,100.0,100.0,0,0,31573,23,30,06,2,2019,2019-06-30,3,2019,31573,23
Bureau,Federal Election Commission,Federal Election Commission,null,97.16246609830246,97.72727272727273,17650,2,604369,86,30,06,2,2019,2019-06-30,3,2019,622019,88
Bureau,Department of Commerce,Economic and Statistical Analysis,null,0.0,0.0,0,0,0,0,30,06,2,2019,2019-06-30,3,2019,0,0
Bureau,Department of Veterans Affairs,Veterans Benefits,null,99.75924952368051,98.5257791559363,1286422,1683,533051877,112479,30,06,2,2019,2019-06-30,3,2019,534338299,114162
Bureau,Department of Transportation,Pipeline Hazardous Material Safety Admin,null,100.0,100.0,0,0,364247,24,30,06,2,2019,2019-06-30,3,2019,364247,24
Bureau,Department of the Treasury,Departmental Offices,null,91.19285540418839,84.41265060240964,3525917,207,36508818,1121,30,06,2,2019,2019-06-30,3,2019,40034735,1328
Bureau,Department of Health & Human Services,Food and Drug Administration,null,54.74990520745368,19.7726425642937,22649501,4305,27404540,1061,30,06,2,2019,2019-06-30,3,2019,50054041,5366
Bureau,Department of Labor,Employment Standards Administration,null,74.35007173482677,18.73357228195938,19259036,13604,55825135,3136,30,06,2,2019,2019-06-30,3,2019,75084171,16740
Bureau,Small Business Administration,Small Business Administration,null,99.87201975839766,99.91744066047471,15204610,96,11865230846,116184,30,06,2,2019,2019-06-30,3,2019,11880435456,116280
Bureau,Department of the Treasury,Office of the Secretary,null,0.0,0.0,0,0,0,0,30,06,2,2019,2019-06-30,3,2019,0,0
Bureau,Other Agencies,National Mediation Board,null,0.0,0.0,0,0,0,0,30,06,2,2019,2019-06-30,3,2019,0,0
Bureau,Farm Credit Administration,Farm Credit System Insurance Corporation,null,0.0,0.0,0,0,0,0,30,06,2,2019,2019-06-30,3,2019,0,0
Bureau,Other Agencies,Defense Nuclear Facilities Safety Board,null,0.0,0.0,0,0,0,0,30,06,2,2019,2019-06-30,3,2019,0,0
Bureau,Office of Government Ethics,Office of Government Ethics,null,0.0,0.0,0,0,0,0,30,06,2,2019,2019-06-30,3,2019,0,0
Bureau,Funds Appropriated to the President,Inter-American Foundation,null,0.0,0.0,0,0,0,0,30,06,2,2019,2019-06-30,3,2019,0,0
Bureau,Other Agencies/Boards/Commissions,U.S. Comm. on Int. Religious Freedom,null,0.0,0.0,393,1,0,0,30,06,2,2019,2019-06-30,3,2019,393,1
Bureau,Consumer Product Safety Commission,Consumer Product Safety Commission,null,100.0,100.0,0,0,479,1,30,06,2,2019,2019-06-30,3,2019,479,1
Bureau,Department of Housing and Urban Development,Public and Indian Housing Programs,null,100.0,100.0,0,0,564,1,30,06,2,2019,2019-06-30,3,2019,564,1
Bureau,Department of Commerce,General Administration,null,100.0,100.0,0,0,4660,1,30,06,2,2019,2019-06-30,3,2019,4660,1
Bureau,Other Agencies,Council of Insps. Gen. of Intg. & Effy.,null,0.0,0.0,1650,3,0,0,30,06,2,2019,2019-06-30,3,2019,1650,3
Bureau,Department of Transportation,Maritime Administration,null,100.0,100.0,0,0,4361,5,30,06,2,2019,2019-06-30,3,2019,4361,5
Bureau,Department of Homeland Security,Federal Law Enforcement Training Ctr.,null,100.0,100.0,0,0,4915,1,30,06,2,2019,2019-06-30,3,2019,4915,1
Bureau,Other Agencies,U.S.  Agency of Global Media,null,100.0,100.0,0,0,4930,2,30,06,2,2019,2019-06-30,3,2019,4930,2
Bureau,Other Agencies,Consumer Financial Protection Bureau,null,0.0,0.0,483278,63,0,0,30,06,2,2019,2019-06-30,3,2019,483278,63
Bureau,Department of Justice,General Administration,null,0.0,0.0,0,0,0,0,30,06,2,2019,2019-06-30,3,2019,0,0
Bureau,Department of Education,Office of Postsecondary Education,null,0.0,0.0,0,0,0,0,30,06,2,2019,2019-06-30,3,2019,0,0
Bureau,Department of Health & Human Services,Substance Abuse & Mental Health Admin.,null,100.0,100.0,0,0,939709,14,30,06,2,2019,2019-06-30,3,2019,939709,14
Bureau,Department of Justice,Drug Enforcement Administration,null,100.0,100.0,0,0,333821,22,30,06,2,2019,2019-06-30,3,2019,333821,22
Bureau,Department of Homeland Security,Citizenship and Immigration Services,null,100.0,100.0,0,0,978937,1217,30,06,2,2019,2019-06-30,3,2019,978937,1217
Bureau,Department of Veterans Affairs,Administration and Cemeteries,null,0.5155118050831659,1.8592297476759627,1595575,739,8268,14,30,06,2,2019,2019-06-30,3,2019,1603843,753
Bureau,National Aeronautics and Space Administration,National Aeronautics and Space Admin,null,98.51540989761072,93.12977099236642,25941,9,1721410,122,30,06,2,2019,2019-06-30,3,2019,1747351,131
Bureau,Corp. for National and Community Service,Corp. for National and Community Service,null,98.28745284519573,97.70642201834862,61472,5,3528035,213,30,06,2,2019,2019-06-30,3,2019,3589507,218
Bureau,Department of the Treasury,Community Dev Financial Inst Fund,null,100.0,100.0,0,0,4053448,7,30,06,2,2019,2019-06-30,3,2019,4053448,7
Bureau,Department of Justice,Federal Prison System,null,100.0,100.0,0,0,5118228,110,30,06,2,2019,2019-06-30,3,2019,5118228,110
Bureau,Department of Transportation,National Highway Traffic Safety Admin.,null,100.0,100.0,0,0,7648297,5,30,06,2,2019,2019-06-30,3,2019,7648297,5
Bureau,Department of the Interior,Bureau of Indian Affairs,null,99.98861393761001,99.91552108133016,1618,22,14208738,26020,30,06,2,2019,2019-06-30,3,2019,14210356,26042
Bureau,Agency for International Development,Agency for International Development,null,99.99453758659072,98.27586206896552,1643,1,30076637,57,30,06,2,2019,2019-06-30,3,2019,30078280,58
Bureau,Department of Health & Human Services,Health Resources and Services Admin,null,100.0,100.0,0,0,87976860,538,30,06,2,2019,2019-06-30,3,2019,87976860,538
Bureau,Department of Housing and Urban Development,Housing Programs,null,99.99757356390114,99.98403830806066,3942,1,162456549,6264,30,06,2,2019,2019-06-30,3,2019,162460491,6265
Bureau,Department of Homeland Security,Emergency Preparedness & Resp,null,100.0,100.0,0,0,252278472,41728,30,06,2,2019,2019-06-30,3,2019,252278472,41728
Bureau,Funds Appropriated to the President,Trade and Development Agency,null,100.0,100.0,0,0,791105,4,30,06,2,2019,2019-06-30,3,2019,791105,4
Bureau,Department of Education,Departmental Management,null,99.98924153895342,98.85807504078304,77675,21,721912205,1818,30,06,2,2019,2019-06-30,3,2019,721989880,1839
Bureau,Department of Agriculture,Farm Service Agency,null,100.0,100.0,0,0,738873332,12726,30,06,2,2019,2019-06-30,3,2019,738873332,12726
Bureau,Department of Health & Human Services,Centers for Medicare & Medicaid Services,null,99.19095065447003,99.39969694225276,82167029,8882,10073830186,1470704,30,06,2,2019,2019-06-30,3,2019,10155997215,1479586
Bureau,Department of Justice,Office of Justice Assistance Programs,null,100.0,100.0,0,0,839639,63,30,06,2,2019,2019-06-30,3,2019,839639,63
Bureau,Department of Homeland Security,Domestic Nuclear Detection Office,null,0.0,0.0,0,0,0,0,30,06,2,2019,2019-06-30,3,2019,0,0
Bureau,Department of the Treasury,U.S. Mint,null,100.0,100.0,0,0,41334,15,30,06,2,2019,2019-06-30,3,2019,41334,15
Bureau,The Judiciary,Administrative Office of the U.S. Courts,null,98.59907448675834,79.48717948717949,15276,56,1075146,217,30,06,2,2019,2019-06-30,3,2019,1090422,273
Bureau,Department of Homeland Security,Transportation Safety Administration,null,100.0,100.0,0,0,12568363,5558,30,06,2,2019,2019-06-30,3,2019,12568363,5558
Bureau,Department of the Interior,Office of the Secretary,null,100.0,100.0,0,0,28792,18,30,06,2,2019,2019-06-30,3,2019,28792,18
Bureau,Department of Health & Human Services,Indian Health Services,null,46.648490514547476,5.146618791143029,27289781,3170,23861126,172,30,06,2,2019,2019-06-30,3,2019,51150907,3342
Bureau,Federal Deposit Insurance Corporation,Federal Deposit Insurance Corporation,null,0.0,0.0,0,0,0,0,30,06,2,2019,2019-06-30,3,2019,0,0
Agency,Tennessee Valley Authority,null,Non-CFO,0.0,0.0,0,0,0,0,30,06,2,2019,2019-06-30,3,2019,0,0
Bureau,Department of Health & Human Services,Office of the Inspector General,null,0.0,0.0,0,0,0,0,30,06,2,2019,2019-06-30,3,2019,0,0
Bureau,Department of Agriculture,Rural Development,null,99.99961568035548,99.99018870392779,2792,3,726475815,30574,30,06,2,2019,2019-06-30,3,2019,726478607,30577
Bureau,Legislative Branch - U.S. House/Senate,U.S. House of Representatives,null,0.0,0.0,301227,411,0,0,30,06,2,2019,2019-06-30,3,2019,301227,411
Agency,Department of Labor,null,CFO,85.56555967034481,58.2814482575467,22420307,14138,132904780,19751,30,06,2,2019,2019-06-30,3,2019,155325087,33889
Bureau,Department of the Treasury,Office of Sec International Affairs,null,0.0,0.0,0,0,0,0,30,06,2,2019,2019-06-30,3,2019,0,0
Bureau,Department of the Treasury,U.S. Treasury IG Office,null,0.0,0.0,0,0,0,0,30,06,2,2019,2019-06-30,3,2019,0,0
Bureau,Federal Mediation/Conciliation Service,Federal Mediation/Conciliation Service,null,0.0,0.0,0,0,0,0,30,06,2,2019,2019-06-30,3,2019,0,0
Bureau,Other Agencies,Surface Transportation Board,null,0.0,0.0,0,0,0,0,30,06,2,2019,2019-06-30,3,2019,0,0
Bureau,Department of Agriculture,Food and Nutrition Service,null,100.0,100.0,0,0,49443,7,30,06,2,2019,2019-06-30,3,2019,49443,7
Bureau,Funds Appropriated to the President,Defense Security Assistance Agency,null,0.0,0.0,0,0,0,0,30,06,2,2019,2019-06-30,3,2019,0,0
Bureau,Other Agencies,National Transportation Safety Board,null,0.0,0.0,0,0,0,0,30,06,2,2019,2019-06-30,3,2019,0,0
Agency,Social Security Administration,null,CFO,52.38288801306666,29.230251867728388,2327856359,1081688,2560840712,446773,30,06,2,2019,2019-06-30,3,2019,4888697071,1528461
Bureau,Other Agencies,Advisory Council on Hist. Preservation,null,0.0,0.0,0,0,0,0,30,06,2,2019,2019-06-30,3,2019,0,0
Bureau,Department of Agriculture,Commodity Credit Corporation,null,100.0,100.0,0,0,108933553,10110,30,06,2,2019,2019-06-30,3,2019,108933553,10110
Agency,Federal Mediation/Conciliation Service,null,Non-CFO,0.0,0.0,0,0,0,0,30,06,2,2019,2019-06-30,3,2019,0,0
Bureau,Department of the Treasury,Office of Financial Research,null,0.0,0.0,0,0,0,0,30,06,2,2019,2019-06-30,3,2019,0,0
Bureau,Department of Agriculture,Agricultural Marketing Service,null,96.11360590498843,54.085155350978134,180229,399,4457206,470,30,06,2,2019,2019-06-30,3,2019,4637435,869
Agency,Legislative Branch-CBO,null,Non-CFO,0.0,0.0,0,0,0,0,30,06,2,2019,2019-06-30,3,2019,0,0
Agency,Small Business Administration,null,CFO,99.87201975839766,99.91744066047471,15204610,96,11865230846,116184,30,06,2,2019,2019-06-30,3,2019,11880435456,116280
Bureau,Department of Veterans Affairs,Medical and Construction,null,83.49041914112634,98.69820626937116,103341797,109931,522608661,8334648,30,06,2,2019,2019-06-30,3,2019,625950458,8444579
Bureau,Funds Appropriated to the President,Executive Branch,null,0.0,0.0,0,0,0,0,30,06,2,2019,2019-06-30,3,2019,0,0
Bureau,Department of Homeland Security,Management Headquarters,null,100.0,100.0,0,0,128,1,30,06,2,2019,2019-06-30,3,2019,128,1
Bureau,Legislative Branch-Office of Tech.,Open World Leadership,null,0.0,0.0,0,0,0,0,30,06,2,2019,2019-06-30,3,2019,0,0
Bureau,Department of the Interior,"Bureau of Ocean Energy Mgmt., Reg & Enf",null,0.0,0.0,0,0,0,0,30,06,2,2019,2019-06-30,3,2019,0,0
Bureau,Merit Systems Protection Board,Merit Systems Protection Board,null,100.0,100.0,0,0,139,1,30,06,2,2019,2019-06-30,3,2019,139,1
Bureau,Neighborhood Reinvestment Corporation,Neighborhood Reinvestment Corporation,null,0.0,0.0,0,0,0,0,30,06,2,2019,2019-06-30,3,2019,0,0
Bureau,Department of the Interior,Geological Survey,null,100.0,100.0,0,0,719160,141,30,06,2,2019,2019-06-30,3,2019,719160,141
Bureau,Environmental Protection Agency,Environmental Protection Agency,null,100.0,100.0,0,0,16557413,213,30,06,2,2019,2019-06-30,3,2019,16557413,213
Bureau,Department of State,Passport NSF,null,100.0,100.0,0,0,2489183,15737,30,06,2,2019,2019-06-30,3,2019,2489183,15737
Agency,Department of Education,null,CFO,84.95307635734362,81.51069061665173,24609739815,5193510,138943557852,22895749,30,06,2,2019,2019-06-30,3,2019,163553297667,28089259
Bureau,Department of Transportation,Federal Railroad Administration,null,100.0,100.0,0,0,277679,19,30,06,2,2019,2019-06-30,3,2019,277679,19
Bureau,Department of Energy,Bonneville Power Administration,null,100.0,100.0,0,0,1092590,34,30,06,2,2019,2019-06-30,3,2019,1092590,34
Bureau,Department of Health & Human Services,Program Support Center,null,100.0,100.0,0,0,5497994,649,30,06,2,2019,2019-06-30,3,2019,5497994,649
Bureau,Department of Homeland Security,Immigration and Customs Enforcement,null,100.0,100.0,0,0,9846131,411,30,06,2,2019,2019-06-30,3,2019,9846131,411
Bureau,Department of the Treasury,Treasury Franchise Fund,null,0.0,0.0,0,0,0,0,30,06,2,2019,2019-06-30,3,2019,0,0
Bureau,Department of Homeland Security,Bureau of Customs & Border Protection,null,100.0,100.0,0,0,10706415,644,30,06,2,2019,2019-06-30,3,2019,10706415,644
Bureau,Department of Health & Human Services,National Institutes of Health,null,34.77632697943845,18.837209302325583,8799901,349,4691981,81,30,06,2,2019,2019-06-30,3,2019,13491882,430
Bureau,Department of the Treasury,Bureau of the Fiscal Service,null,100.0,100.0,0,0,13538760,4573,30,06,2,2019,2019-06-30,3,2019,13538760,4573
Bureau,Other Agencies,Chemical Safety Board,null,0.0,0.0,0,0,0,0,30,06,2,2019,2019-06-30,3,2019,0,0
Bureau,Department of Transportation,St. Lawrence Seaway Development Corp.,null,0.0,0.0,0,0,0,0,30,06,2,2019,2019-06-30,3,2019,0,0
Bureau,Other Agencies,James Madison Memorial Fellowship,null,0.0,0.0,229515,23,0,0,30,06,2,2019,2019-06-30,3,2019,229515,23
Bureau,Securities & Exchange Commission,Securities and Exchange Commission,null,100.0,100.0,0,0,2163390129,897,30,06,2,2019,2019-06-30,3,2019,2163390129,897
Bureau,Department of Education,Federal Student Aid,null,84.88640638310665,81.50955481137107,24609662140,5193489,138221645647,22893931,30,06,2,2019,2019-06-30,3,2019,162831307787,28087420
Bureau,Department of Transportation,Federal Highway Administration,null,100.0,100.0,0,0,5647,5,30,06,2,2019,2019-06-30,3,2019,5647,5
Bureau,Department of Agriculture,Federal Crop Insurance Corporation,null,95.28694363708897,99.74293059125964,4135,1,83600,388,30,06,2,2019,2019-06-30,3,2019,87735,389
Bureau,National Archives & Records Admin,Nat'l Archives & Records Administration,null,98.56083348048737,98.9247311827957,1793,1,122793,92,30,06,2,2019,2019-06-30,3,2019,124586,93
Bureau,Department of State,Department of State,null,99.32264397087243,99.36450295052201,111025,42,16279912,6567,30,06,2,2019,2019-06-30,3,2019,16390937,6609
Bureau,Department of the Interior,Bureau of Land Management,null,100.0,100.0,0,0,17793759,281,30,06,2,2019,2019-06-30,3,2019,17793759,281
Bureau,National Credit Union Administration,National Credit Union Administration,null,0.0,0.0,0,0,0,0,30,06,2,2019,2019-06-30,3,2019,0,0
Bureau,Legis Branch-Library of Congress,Library of Congress,null,0.0,0.0,0,0,0,0,30,06,2,2019,2019-06-30,3,2019,0,0
Bureau,Department of State,Civil Monetary Penalties,null,0.0,0.0,0,0,0,0,30,06,2,2019,2019-06-30,3,2019,0,0
Bureau,Occupational Safety & Health Rev Comm,Occupational Safety & Health Rev Comm,null,100.0,100.0,0,0,211,1,30,06,2,2019,2019-06-30,3,2019,211,1
Bureau,General Services Administration,General Services Administration,null,85.57206482862533,91.84041700080192,2773890,407,16451938,4581,30,06,2,2019,2019-06-30,3,2019,19225828,4988
Bureau,Department of Defense,Consolidated Report,null,49.72643081380418,20.79538202499386,1130305891,1125679,1118004522,295550,30,06,2,2019,2019-06-30,3,2019,2248310413,1421229
Bureau,Department of Health & Human Services,Centers for Disease Control,null,66.60755203495083,22.033898305084747,59312,46,118309,13,30,06,2,2019,2019-06-30,3,2019,177621,59
Bureau,Department of Agriculture,U.S. Department of Agriculture,null,90.96826351463035,78.50117096018735,2200937,459,22167987,1676,30,06,2,2019,2019-06-30,3,2019,24368924,2135
Bureau,Department of the Treasury,Internal Revenue Service,null,100.0,100.0,0,0,240514,110,30,06,2,2019,2019-06-30,3,2019,240514,110
Bureau,Commodity Futures Trading Commission,Commodity Futures Trading Commission,null,100.0,100.0,0,0,637808627,371,30,06,2,2019,2019-06-30,3,2019,637808627,371
Bureau,Department of the Treasury,D.C. Pension Program,null,100.0,100.0,0,0,282505,15,30,06,2,2019,2019-06-30,3,2019,282505,15
Bureau,Legislative Branch-Office of Tech.,Medicaid & CHIP Payment & Access Comm.,null,0.0,0.0,0,0,0,0,30,06,2,2019,2019-06-30,3,2019,0,0
Bureau,Department of Homeland Security,Office of the Inspector General DHS,null,100.0,100.0,0,0,241,2,30,06,2,2019,2019-06-30,3,2019,241,2
Bureau,Department of Veterans Affairs,Life Insurance,null,100.0,100.0,0,0,545442,97,30,06,2,2019,2019-06-30,3,2019,545442,97
Bureau,Legislative Branch-GAO,Government Accountability Office,null,0.0,0.0,0,0,0,0,30,06,2,2019,2019-06-30,3,2019,0,0
Bureau,Department of Agriculture,Forest Service,null,96.76731829629169,28.50049652432969,1783662,720,53392262,287,30,06,2,2019,2019-06-30,3,2019,55175924,1007
Bureau,Smithsonian Institution,Administrative Conference of the US,null,0.0,0.0,2178,1,0,0,30,06,2,2019,2019-06-30,3,2019,2178,1
Bureau,Office of Special Counsel,Office of Special Counsel,null,0.0,0.0,0,0,0,0,30,06,2,2019,2019-06-30,3,2019,0,0
Bureau,Armed Forces Retirement Home,Armed Forces Retirement Home,null,88.25261039124418,85.71428571428571,9338,15,70152,90,30,06,2,2019,2019-06-30,3,2019,79490,105
Bureau,Department of Agriculture,Food Safety and Inspection Service,null,99.95519425864478,99.67637540453075,461,4,1028425,1232,30,06,2,2019,2019-06-30,3,2019,1028886,1236
Bureau,Department of Commerce,Nat'l Institute of Standards& Technology,null,100.0,100.0,0,0,1087068,4,30,06,2,2019,2019-06-30,3,2019,1087068,4
Bureau,Department of Transportation,Federal Motor Carrier Safety Admin,null,99.97267949018581,99.93574297188755,13995,4,51211257,6221,30,06,2,2019,2019-06-30,3,2019,51225252,6225
Bureau,Other Agencies,Morris K. Udall Scholarship,null,0.0,0.0,982,1,0,0,30,06,2,2019,2019-06-30,3,2019,982,1
Bureau,Department of Transportation,Office of the Secretary,null,100.0,100.0,0,0,979650,17,30,06,2,2019,2019-06-30,3,2019,979650,17
Bureau,Office of Personnel Management,Office of Personnel Management,null,84.1124672849228,75.06631299734748,2843444,282,15053885,849,30,06,2,2019,2019-06-30,3,2019,17897329,1131
Bureau,Nuclear Regulatory Commission,Nuclear Regulatory Commission,null,94.29891915325099,95.02262443438914,77590,11,1283380,210,30,06,2,2019,2019-06-30,3,2019,1360970,221
Bureau,Department of Labor,Employment and Training Administration,null,100.0,100.0,0,0,2898431,3,30,06,2,2019,2019-06-30,3,2019,2898431,3
Bureau,Federal Trade Commission,Federal Trade Commission,null,100.0,100.0,0,0,483080046,56,30,06,2,2019,2019-06-30,3,2019,483080046,56
Bureau,Other Agencies,Denali Commission,null,0.0,0.0,0,0,0,0,30,06,2,2019,2019-06-30,3,2019,0,0
Bureau,Department of Labor,Bureau of Labor Statistics,null,100.0,100.0,0,0,11381,1,30,06,2,2019,2019-06-30,3,2019,11381,1
Agency,Overseas Private Investment Corp Accts,null,Non-CFO,0.0,0.0,0,0,0,0,30,06,2,2019,2019-06-30,3,2019,0,0
Bureau,Department of Transportation,Federal Aviation Administration,null,97.80920742772514,94.8051948051948,54097,20,2415192,365,30,06,2,2019,2019-06-30,3,2019,2469289,385
Bureau,Overseas Private Investment Corp Accts,Overseas Private Investment Corp Accts,null,0.0,0.0,0,0,0,0,30,06,2,2019,2019-06-30,3,2019,0,0
Bureau,Department of Health & Human Services,Administration for Children and Families,null,100.0,100.0,0,0,26074124,1628,30,06,2,2019,2019-06-30,3,2019,26074124,1628
Bureau,Department of Justice,Bureau of ATF and Explosives,null,100.0,100.0,0,0,21553,4,30,06,2,2019,2019-06-30,3,2019,21553,4
Bureau,Presidio Trust Corporation,Presidio Trust Corporation,null,94.66025363936015,88.63636363636364,75848,10,1344594,78,30,06,2,2019,2019-06-30,3,2019,1420442,88
Bureau,National Labor Relations Board,National Labor Relations Board,null,0.0,0.0,0,0,0,0,30,06,2,2019,2019-06-30,3,2019,0,0
Bureau,Department of the Interior,Office of Surface Mining,null,99.99155585331532,99.6124031007752,197,1,2332780,257,30,06,2,2019,2019-06-30,3,2019,2332977,258
Bureau,Department of the Interior,Fish and Wildlife Service,null,100.0,100.0,0,0,589849,97,30,06,2,2019,2019-06-30,3,2019,589849,97
Bureau,Department of Justice,Federal Prison Industries,null,100.0,100.0,0,0,1043089,183,30,06,2,2019,2019-06-30,3,2019,1043089,183
Bureau,U.S. Postal Service,U.S. Postal Service,null,65.00400255309431,78.25724335496972,24948908,11992,46341839,43162,30,06,2,2019,2019-06-30,3,2019,71290747,55154
Bureau,Department of Commerce,Nat'l Telecomm & Information Admin.,null,100.0,100.0,0,0,407884,3,30,06,2,2019,2019-06-30,3,2019,407884,3
Bureau,Department of Veterans Affairs,Housing Credit Assistance,null,32.90998184978684,58.333333333333336,874193,20,428822,28,30,06,2,2019,2019-06-30,3,2019,1303015,48
Bureau,Department of Labor,Mine Safety and Health Administration,null,95.95924942034095,97.15930902111324,1833140,444,43533184,15186,30,06,2,2019,2019-06-30,3,2019,45366324,15630
Bureau,Department of Housing and Urban Development,"Policy, Development and Research",null,0.0,0.0,0,0,0,0,30,06,2,2019,2019-06-30,3,2019,0,0
Agency,General Services Administration,null,CFO,85.57206482862533,91.84041700080192,2773890,407,16451938,4581,30,06,2,2019,2019-06-30,3,2019,19225828,4988
Bureau,Department of the Treasury,Spec Insp Gen-Troubled Asset Rel Prog,null,100.0,100.0,0,0,3916,1,30,06,2,2019,2019-06-30,3,2019,3916,1
Bureau,Department of the Interior,Office of Natural Resources Revenue,null,100.0,100.0,0,0,32927463,337,30,06,2,2019,2019-06-30,3,2019,32927463,337
Bureau,Department of the Interior,National Park Service,null,100.0,100.0,0,0,6304894,1969,30,06,2,2019,2019-06-30,3,2019,6304894,1969
Agency,Funds Appropriated to the President,null,Non-CFO,100.0,100.0,0,0,791105,4,30,06,2,2019,2019-06-30,3,2019,791105,4
Bureau,Smithsonian Institution,JFK Center for the Performing Arts,null,0.0,0.0,0,0,0,0,30,06,2,2019,2019-06-30,3,2019,0,0
Bureau,Export - Import  Bank,Export-Import Bank,null,0.0,0.0,0,0,0,0,30,06,2,2019,2019-06-30,3,2019,0,0
Bureau,Department of Labor,Employee Benefit Security Administration,null,100.0,100.0,0,0,16246411,373,30,06,2,2019,2019-06-30,3,2019,16246411,373
Bureau,Pension Benefit Guaranty Corp,Pension Benefit Guaranty Corporation,null,100.0,100.0,0,0,2498111,1583,30,06,2,2019,2019-06-30,3,2019,2498111,1583
Bureau,Other Agencies,U.S. Inst. for Env. Conflict Resolution,null,0.0,0.0,3545,7,0,0,30,06,2,2019,2019-06-30,3,2019,3545,7
Bureau,Other Agencies,Comm. for Purchase from Blind/Handic.,null,0.0,0.0,0,0,0,0,30,06,2,2019,2019-06-30,3,2019,0,0
Bureau,Department of Transportation,Office of the Inspector General,null,100.0,100.0,0,0,204,1,30,06,2,2019,2019-06-30,3,2019,204,1
Bureau,Department of Transportation,Federal Transit Administration,null,100.0,100.0,0,0,784350,2,30,06,2,2019,2019-06-30,3,2019,784350,2
Bureau,Department of Transportation,Research Innovative Technology Admin,null,100.0,100.0,0,0,8186,7,30,06,2,2019,2019-06-30,3,2019,8186,7
Bureau,Department of the Treasury,Comptroller of the Currency,null,100.0,100.0,0,0,1127138,22,30,06,2,2019,2019-06-30,3,2019,1127138,22
Bureau,Farm Credit Administration,Farm Credit Administration,null,100.0,100.0,0,0,630,1,30,06,2,2019,2019-06-30,3,2019,630,1
Bureau,Department of Energy,Energy Consolidated Reports,null,100.0,100.0,0,0,16861945,60,30,06,2,2019,2019-06-30,3,2019,16861945,60
Bureau,Department of the Interior,Bureau of Reclamation,null,100.0,100.0,0,0,111277,89,30,06,2,2019,2019-06-30,3,2019,111277,89
Agency,Department of the Treasury,null,CFO,94.2171864965994,96.5937140036202,3525917,207,57446428,5870,30,06,2,2019,2019-06-30,3,2019,60972345,6077
Bureau,Department of Commerce,Bureau of Industry and Security,null,100.0,100.0,0,0,424797,12,30,06,2,2019,2019-06-30,3,2019,424797,12
Bureau,Social Security Administration,Social Security Administration,null,52.38288801306666,29.230251867728388,2327856359,1081688,2560840712,446773,30,06,2,2019,2019-06-30,3,2019,4888697071,1528461
Bureau,Other Agencies,Federal Housing Finance Agency OIG,null,0.0,0.0,0,0,0,0,30,06,2,2019,2019-06-30,3,2019,0,0
Bureau,Federal Communications Commission,Federal Communications Commission,null,100.0,100.0,0,0,142979316,845,30,06,2,2019,2019-06-30,3,2019,142979316,845
Bureau,Other Agencies,Architect of the Capitol,null,0.0,0.0,0,0,0,0,30,06,2,2019,2019-06-30,3,2019,0,0
Bureau,Department of Labor,Occupational Safety and Health Admin,null,91.55045284914739,92.11908931698774,1328131,90,14390238,1052,30,06,2,2019,2019-06-30,3,2019,15718369,1142
Bureau,Department of the Treasury,Tobacco Tax and Trade,null,100.0,100.0,0,0,1000,1,30,06,2,2019,2019-06-30,3,2019,1000,1
Bureau,Federal Maritime Commission,Salaries and Expenses,null,99.73797373397994,54.54545454545455,1240,5,471995,6,30,06,2,2019,2019-06-30,3,2019,473235,11
Bureau,National Science Foundation,National Science Foundation,null,100.0,100.0,0,0,624940,97,30,06,2,2019,2019-06-30,3,2019,624940,97
Agency,Department of Justice,null,CFO,98.7719406142001,98.95788844281199,1039142,366,83577450,34755,30,06,2,2019,2019-06-30,3,2019,84616592,35121
Agency,National Credit Union Administration,null,Non-CFO,0.0,0.0,0,0,0,0,30,06,2,2019,2019-06-30,3,2019,0,0
Bureau,Department of Commerce,NOAA,null,100.0,100.0,0,0,12327709,633,30,06,2,2019,2019-06-30,3,2019,12327709,633
Bureau,Department of the Treasury,Treasury Forfeiture Fund,null,0.0,0.0,0,0,0,0,30,06,2,2019,2019-06-30,3,2019,0,0
Bureau,Railroad Retirement Board,Railroad Retirement Board,null,100.0,100.0,0,0,22346927,3646,30,06,2,2019,2019-06-30,3,2019,22346927,3646
Bureau,American Battle Monuments Commission,American Battle Monuments Commission,null,0.0,0.0,0,0,0,0,30,06,2,2019,2019-06-30,3,2019,0,0
Bureau,Other Agencies,National Council on Disability,null,0.0,0.0,387,1,0,0,30,06,2,2019,2019-06-30,3,2019,387,1
Bureau,Department of Commerce,Bureau of the Census,null,100.0,100.0,0,0,227554,258,30,06,2,2019,2019-06-30,3,2019,227554,258
Bureau,Smithsonian Institution,National Gallery of Art,null,0.0,0.0,0,0,0,0,30,06,2,2019,2019-06-30,3,2019,0,0
Bureau,Department of the Treasury,Financial Crimes Enforcement Network,null,100.0,100.0,0,0,1564467,4,30,06,2,2019,2019-06-30,3,2019,1564467,4
Bureau,Department of Justice,U.S. Marshals Service,null,0.0,0.0,0,0,0,0,30,06,2,2019,2019-06-30,3,2019,0,0
Bureau,Department of the Treasury,Treasury IG for Tax Admin,null,0.0,0.0,0,0,0,0,30,06,2,2019,2019-06-30,3,2019,0,0
Bureau,Tennessee Valley Authority,Tennessee Valley Authority,null,0.0,0.0,0,0,0,0,30,06,2,2019,2019-06-30,3,2019,0,0
Bureau,Department of Commerce,Patent and Trademark Office,null,100.0,100.0,0,0,345502,499,30,06,2,2019,2019-06-30,3,2019,345502,499
Agency,Office of Special Counsel,null,Non-CFO,0.0,0.0,0,0,0,0,30,06,2,2019,2019-06-30,3,2019,0,0
Bureau,Department of Housing and Urban Development,Management and Administration,null,0.0,0.0,0,0,0,0,30,06,2,2019,2019-06-30,3,2019,0,0
Bureau,Department of the Treasury,Bureau of Engraving and Printing,null,100.0,100.0,0,0,84528,1,30,06,2,2019,2019-06-30,3,2019,84528,1
Bureau,Department of Commerce,Economic Development Administration,null,100.0,100.0,0,0,5088294,5,30,06,2,2019,2019-06-30,3,2019,5088294,5
Agency,Office of Compliance,null,Non-CFO,0.0,0.0,0,0,0,0,30,06,2,2019,2019-06-30,3,2019,0,0
Bureau,Department of Homeland Security,U.S. Coast Guard,null,100.0,100.0,0,0,82017220,10723,30,06,2,2019,2019-06-30,3,2019,82017220,10723
Agency,National Science Foundation,null,CFO,100.0,100.0,0,0,624940,97,30,06,2,2019,2019-06-30,3,2019,624940,97
Bureau,Department of Justice,Legal Activities,null,98.65426656211872,98.94551845342707,1039142,366,76178379,34343,30,06,2,2019,2019-06-30,3,2019,77217521,34709
Agency,Legislative Branch-GAO,null,Non-CFO,0.0,0.0,0,0,0,0,30,06,2,2019,2019-06-30,3,2019,0,0
Agency,Department of the Interior,null,CFO,99.99758106749104,99.92133255805999,1815,23,75031283,29214,30,06,2,2019,2019-06-30,3,2019,75033098,29237
Agency,Department of Veterans Affairs,null,CFO,90.7970947354829,98.68717594281722,107097987,112373,1056643070,8447266,30,06,2,2019,2019-06-30,3,2019,1163741057,8559639
Agency,Department of Health & Human Services,null,CFO,98.64343614435553,98.8769265114932,140965524,16752,10250401120,1474869,30,06,2,2019,2019-06-30,3,2019,10391366644,1491621
Agency,Federal Deposit Insurance Corporation,null,Non-CFO,0.0,0.0,0,0,0,0,30,06,2,2019,2019-06-30,3,2019,0,0
Agency,Neighborhood Reinvestment Corporation,null,Non-CFO,0.0,0.0,0,0,0,0,30,06,2,2019,2019-06-30,3,2019,0,0
Agency,Federal Labor Relations Authority,null,Non-CFO,0.0,0.0,0,0,0,0,30,06,2,2019,2019-06-30,3,2019,0,0
Agency,National Labor Relations Board,null,Non-CFO,0.0,0.0,0,0,0,0,30,06,2,2019,2019-06-30,3,2019,0,0
Agency,National Foundation  Arts & Humanities,null,Non-CFO,0.0,0.0,0,0,0,0,30,06,2,2019,2019-06-30,3,2019,0,0
Agency,Federal Election Commission,null,Non-CFO,97.16246609830246,97.72727272727273,17650,2,604369,86,30,06,2,2019,2019-06-30,3,2019,622019,88
Agency,The Judiciary,null,Non-CFO,98.59907448675834,79.48717948717949,15276,56,1075146,217,30,06,2,2019,2019-06-30,3,2019,1090422,273
Bureau,Other Agencies,National Capital Planning Commission,null,0.0,0.0,0,0,0,0,30,06,2,2019,2019-06-30,3,2019,0,0
Agency,American Battle Monuments Commission,null,Non-CFO,0.0,0.0,0,0,0,0,30,06,2,2019,2019-06-30,3,2019,0,0
Agency,Legis Branch-Library of Congress,null,Non-CFO,0.0,0.0,0,0,0,0,30,06,2,2019,2019-06-30,3,2019,0,0
Agency,Legislative Branch-Office of Tech.,null,Non-CFO,0.0,0.0,0,0,0,0,30,06,2,2019,2019-06-30,3,2019,0,0
Agency,Export - Import  Bank,null,Non-CFO,0.0,0.0,0,0,0,0,30,06,2,2019,2019-06-30,3,2019,0,0
Agency,Merit Systems Protection Board,null,Non-CFO,100.0,100.0,0,0,139,1,30,06,2,2019,2019-06-30,3,2019,139,1
Bureau,Federal Labor Relations Authority,Federal Labor Relations Authority,null,0.0,0.0,0,0,0,0,30,06,2,2019,2019-06-30,3,2019,0,0
Bureau,Department of Homeland Security,U.S. Secret Service,null,0.0,0.0,0,0,0,0,30,06,2,2019,2019-06-30,3,2019,0,0
Bureau,Other Agencies,Federal Housing Finance Agency,null,0.0,0.0,0,0,0,0,30,06,2,2019,2019-06-30,3,2019,0,0
Agency,Pension Benefit Guaranty Corp,null,Non-CFO,100.0,100.0,0,0,2498111,1583,30,06,2,2019,2019-06-30,3,2019,2498111,1583
Bureau,Department of Homeland Security,Science and Technology,null,0.0,0.0,0,0,0,0,30,06,2,2019,2019-06-30,3,2019,0,0
Bureau,Department of Health & Human Services,Administration for Community Living,null,0.0,0.0,0,0,0,0,30,06,2,2019,2019-06-30,3,2019,0,0
Bureau,Department of Housing and Urban Development,Government National Mortgage Association,null,0.0,0.0,0,0,0,0,30,06,2,2019,2019-06-30,3,2019,0,0
Bureau,Selective Service System,Selective Service System,null,0.0,0.0,0,0,0,0,30,06,2,2019,2019-06-30,3,2019,0,0
Bureau,Other Agencies,Federal Mine Safety & Health Review Comm,null,0.0,0.0,0,0,0,0,30,06,2,2019,2019-06-30,3,2019,0,0
Bureau,Other Agencies,U.S. Institute of Peace,null,0.0,0.0,0,0,0,0,30,06,2,2019,2019-06-30,3,2019,0,0
Bureau,Other Agencies,Commission On Fine Arts,null,0.0,0.0,0,0,0,0,30,06,2,2019,2019-06-30,3,2019,0,0
Bureau,Other Agencies/Boards/Commissions,Medicare Payment Advisory Commission,null,0.0,0.0,0,0,0,0,30,06,2,2019,2019-06-30,3,2019,0,0
Bureau,Other Agencies,Gulf Coast Ecosystem Restoration Council,null,0.0,0.0,0,0,0,0,30,06,2,2019,2019-06-30,3,2019,0,0
Bureau,Securities & Exchange Commission,SEC Enforcement,null,0.0,0.0,0,0,0,0,30,06,2,2019,2019-06-30,3,2019,0,0
Bureau,Funds Appropriated to the President,Peace Corps,null,0.0,0.0,0,0,0,0,30,06,2,2019,2019-06-30,3,2019,0,0
Bureau,Department of Commerce,National Technical Information Service,null,0.0,0.0,0,0,0,0,30,06,2,2019,2019-06-30,3,2019,0,0
Bureau,Department of Homeland Security,Info Analysis Infrastructure Prot-NPPD,null,0.0,0.0,0,0,0,0,30,06,2,2019,2019-06-30,3,2019,0,0
Bureau,Department of Housing and Urban Development,Community Planning and Development,null,0.0,0.0,0,0,0,0,30,06,2,2019,2019-06-30,3,2019,0,0
Bureau,Department of Homeland Security,Office of Health Affairs,null,0.0,0.0,0,0,0,0,30,06,2,2019,2019-06-30,3,2019,0,0
Bureau,Department of Homeland Security,Office of Biometric Identity Management,null,0.0,0.0,0,0,0,0,30,06,2,2019,2019-06-30,3,2019,0,0
Agency,Department of State,null,CFO,99.41194759355344,99.81204689877383,111025,42,18769095,22304,30,06,2,2019,2019-06-30,3,2019,18880120,22346
Agency,Agency for International Development,null,CFO,99.99453758659072,98.27586206896552,1643,1,30076637,57,30,06,2,2019,2019-06-30,3,2019,30078280,58
Agency,Department of Transportation,null,CFO,99.89321776622269,99.64152352501867,68092,24,63699070,6671,30,06,2,2019,2019-06-30,3,2019,63767162,6695
Agency,Department of Housing and Urban Development,null,CFO,99.99757357232477,99.98404085541014,3942,1,162457113,6265,30,06,2,2019,2019-06-30,3,2019,162461055,6266
Agency,Department of Homeland Security,null,CFO,100.0,100.0,0,0,368400822,60285,30,06,2,2019,2019-06-30,3,2019,368400822,60285
Agency,Department of Agriculture,null,CFO,99.74860623458281,97.31441343809266,4172216,1586,1655461623,57470,30,06,2,2019,2019-06-30,3,2019,1659633839,59056
Agency,Department of Defense,null,CFO,49.72643081380418,20.79538202499386,1130305891,1125679,1118004522,295550,30,06,2,2019,2019-06-30,3,2019,2248310413,1421229
Agency,Selective Service System,null,Non-CFO,0.0,0.0,0,0,0,0,30,06,2,2019,2019-06-30,3,2019,0,0
Agency,Office of Government Ethics,null,Non-CFO,0.0,0.0,0,0,0,0,30,06,2,2019,2019-06-30,3,2019,0,0
Agency,U.S. Court of Appeals / Veterans Claims,null,Non-CFO,100.0,100.0,0,0,167,1,30,06,2,2019,2019-06-30,3,2019,167,1
Agency,Occupational Safety & Health Rev Comm,null,Non-CFO,100.0,100.0,0,0,211,1,30,06,2,2019,2019-06-30,3,2019,211,1
Agency,Other Agencies/Boards/Commissions,null,Non-CFO,0.0,0.0,393,1,0,0,30,06,2,2019,2019-06-30,3,2019,393,1
Agency,Consumer Product Safety Commission,null,Non-CFO,100.0,100.0,0,0,479,1,30,06,2,2019,2019-06-30,3,2019,479,1
Agency,Farm Credit Administration,null,Non-CFO,100.0,100.0,0,0,630,1,30,06,2,2019,2019-06-30,3,2019,630,1
Agency,Smithsonian Institution,null,Non-CFO,0.0,0.0,2178,1,0,0,30,06,2,2019,2019-06-30,3,2019,2178,1
Agency,Corp. for National and Community Service,null,Non-CFO,98.28745284519573,97.70642201834862,61472,5,3528035,213,30,06,2,2019,2019-06-30,3,2019,3589507,218
Agency,Railroad Retirement Board,null,Non-CFO,100.0,100.0,0,0,22346927,3646,30,06,2,2019,2019-06-30,3,2019,22346927,3646
Agency,U.S. Postal Service,null,Non-CFO,65.00400255309431,78.25724335496972,24948908,11992,46341839,43162,30,06,2,2019,2019-06-30,3,2019,71290747,55154
Agency,Federal Communications Commission,null,Non-CFO,100.0,100.0,0,0,142979316,845,30,06,2,2019,2019-06-30,3,2019,142979316,845
Agency,Federal Trade Commission,null,Non-CFO,100.0,100.0,0,0,483080046,56,30,06,2,2019,2019-06-30,3,2019,483080046,56
Agency,Securities & Exchange Commission,null,Non-CFO,100.0,100.0,0,0,2163390129,897,30,06,2,2019,2019-06-30,3,2019,2163390129,897
Bureau,Legislative Branch-CBO,Congressional Budget Office,null,0.0,0.0,0,0,0,0,30,06,2,2019,2019-06-30,3,2019,0,0
Bureau,Department of Commerce,Office of the Inspector General,null,0.0,0.0,0,0,0,0,30,06,2,2019,2019-06-30,3,2019,0,0
Bureau,Department of State,International Commissions,null,0.0,0.0,0,0,0,0,30,06,2,2019,2019-06-30,3,2019,0,0
Bureau,Smithsonian Institution,Smithsonian Institution,null,0.0,0.0,0,0,0,0,30,06,2,2019,2019-06-30,3,2019,0,0
Bureau,Other Agencies/Boards/Commissions,U.S.-China Security Review Commission,null,0.0,0.0,0,0,0,0,30,06,2,2019,2019-06-30,3,2019,0,0
Bureau,Department of Transportation,Surface Transportation Board,null,0.0,0.0,0,0,0,0,30,06,2,2019,2019-06-30,3,2019,0,0
Bureau,Other Agencies,Election Assistance Commission,null,0.0,0.0,0,0,0,0,30,06,2,2019,2019-06-30,3,2019,0,0
Bureau,Department of the Treasury,International Monetary Funds,null,0.0,0.0,0,0,0,0,30,06,2,2019,2019-06-30,3,2019,0,0
Agency,National Aeronautics and Space Administration,null,CFO,98.51540989761072,93.12977099236642,25941,9,1721410,122,30,06,2,2019,2019-06-30,3,2019,1747351,131
Agency,Environmental Protection Agency,null,CFO,100.0,100.0,0,0,16557413,213,30,06,2,2019,2019-06-30,3,2019,16557413,213
Agency,Office of Personnel Management,null,CFO,84.1124672849228,75.06631299734748,2843444,282,15053885,849,30,06,2,2019,2019-06-30,3,2019,17897329,1131
Agency,Department of Energy,null,CFO,100.0,100.0,0,0,17954535,94,30,06,2,2019,2019-06-30,3,2019,17954535,94
Agency,Nuclear Regulatory Commission,null,CFO,94.29891915325099,95.02262443438914,77590,11,1283380,210,30,06,2,2019,2019-06-30,3,2019,1360970,221
Agency,Equal Employment Opportunity Commission,null,Non-CFO,100.0,100.0,0,0,31573,23,30,06,2,2019,2019-06-30,3,2019,31573,23
Agency,Armed Forces Retirement Home,null,Non-CFO,88.25261039124418,85.71428571428571,9338,15,70152,90,30,06,2,2019,2019-06-30,3,2019,79490,105
Agency,Legislative Branch-GPO,null,Non-CFO,0.0,0.0,91020,49,0,0,30,06,2,2019,2019-06-30,3,2019,91020,49
Agency,National Archives & Records Admin,null,Non-CFO,98.56083348048737,98.9247311827957,1793,1,122793,92,30,06,2,2019,2019-06-30,3,2019,124586,93
Agency,Legislative Branch - U.S. House/Senate,null,Non-CFO,0.0,0.0,301227,411,0,0,30,06,2,2019,2019-06-30,3,2019,301227,411
Agency,Federal Maritime Commission,null,Non-CFO,99.73797373397994,54.54545454545455,1240,5,471995,6,30,06,2,2019,2019-06-30,3,2019,473235,11
Agency,Other Agencies,null,Non-CFO,0.6806694031509609,2.0,719357,98,4930,2,30,06,2,2019,2019-06-30,3,2019,724287,100
Agency,Presidio Trust Corporation,null,Non-CFO,94.66025363936015,88.63636363636364,75848,10,1344594,78,30,06,2,2019,2019-06-30,3,2019,1420442,88
Bureau,National Foundation  Arts & Humanities,National Endowment for the Humanities,null,0.0,0.0,0,0,0,0,30,06,2,2019,2019-06-30,3,2019,0,0
Agency,Commodity Futures Trading Commission,null,Non-CFO,100.0,100.0,0,0,637808627,371,30,06,2,2019,2019-06-30,3,2019,637808627,371
Agency,Federal Communications Commission,null,Non-CFO,100.0,100.0,0,0,202593636,10908,30,09,3,2019,2019-09-30,4,2019,202593636,10908
Bureau,Department of State,Civil Monetary Penalties,null,0.0,0.0,0,0,0,0,30,09,3,2019,2019-09-30,4,2019,0,0
Agency,Federal Trade Commission,null,Non-CFO,100.0,100.0,0,0,483084528,66,30,09,3,2019,2019-09-30,4,2019,483084528,66
Agency,Securities & Exchange Commission,null,Non-CFO,100.0,100.0,0,0,2017561197,857,30,09,3,2019,2019-09-30,4,2019,2017561197,857
Bureau,Funds Appropriated to the President,Inter-American Foundation,null,0.0,0.0,0,0,0,0,30,09,3,2019,2019-09-30,4,2019,0,0
Bureau,Department of State,International Commissions,null,0.0,0.0,0,0,0,0,30,09,3,2019,2019-09-30,4,2019,0,0
Bureau,Department of the Treasury,Treasury IG for Tax Admin,null,0.0,0.0,0,0,0,0,30,09,3,2019,2019-09-30,4,2019,0,0
Bureau,Smithsonian Institution,National Gallery of Art,null,0.0,0.0,0,0,0,0,30,09,3,2019,2019-09-30,4,2019,0,0
Bureau,Department of Homeland Security,Federal Law Enforcement Training Ctr.,null,0.0,0.0,0,0,0,0,30,09,3,2019,2019-09-30,4,2019,0,0
Bureau,Other Agencies,U.S. Holocaust Memorial Council,null,0.0,0.0,0,0,0,0,30,09,3,2019,2019-09-30,4,2019,0,0
Bureau,Other Agencies,Commission On Fine Arts,null,0.0,0.0,0,0,0,0,30,09,3,2019,2019-09-30,4,2019,0,0
Bureau,Other Agencies,National Mediation Board,null,0.0,0.0,0,0,0,0,30,09,3,2019,2019-09-30,4,2019,0,0
Bureau,Funds Appropriated to the President,Peace Corps,null,0.0,0.0,0,0,0,0,30,09,3,2019,2019-09-30,4,2019,0,0
Bureau,Department of Commerce,National Technical Information Service,null,0.0,0.0,0,0,0,0,30,09,3,2019,2019-09-30,4,2019,0,0
Bureau,Department of Justice,General Administration,null,0.0,0.0,0,0,0,0,30,09,3,2019,2019-09-30,4,2019,0,0
Bureau,National Foundation  Arts & Humanities,National Endowment for the Humanities,null,0.0,0.0,0,0,0,0,30,09,3,2019,2019-09-30,4,2019,0,0
Bureau,Department of Transportation,Surface Transportation Board,null,0.0,0.0,0,0,0,0,30,09,3,2019,2019-09-30,4,2019,0,0
Bureau,Farm Credit Administration,Farm Credit System Insurance Corporation,null,0.0,0.0,0,0,0,0,30,09,3,2019,2019-09-30,4,2019,0,0
Bureau,Department of Housing and Urban Development,Management and Administration,null,0.0,0.0,0,0,0,0,30,09,3,2019,2019-09-30,4,2019,0,0
Bureau,Legislative Branch-Office of Tech.,Medicaid & CHIP Payment & Access Comm.,null,0.0,0.0,0,0,0,0,30,09,3,2019,2019-09-30,4,2019,0,0
Bureau,Other Agencies,Surface Transportation Board,null,0.0,0.0,0,0,0,0,30,09,3,2019,2019-09-30,4,2019,0,0
Bureau,Department of Transportation,Office of the Inspector General,null,100.0,100.0,0,0,205,1,30,09,3,2019,2019-09-30,4,2019,205,1
Bureau,Consumer Product Safety Commission,Consumer Product Safety Commission,null,100.0,100.0,0,0,479,1,30,09,3,2019,2019-09-30,4,2019,479,1
Bureau,Department of the Treasury,Spec Insp Gen-Troubled Asset Rel Prog,null,100.0,100.0,0,0,3916,1,30,09,3,2019,2019-09-30,4,2019,3916,1
Bureau,Department of Justice,Bureau of ATF and Explosives,null,100.0,100.0,0,0,21553,4,30,09,3,2019,2019-09-30,4,2019,21553,4
Bureau,Legislative Branch-GAO,Government Accountability Office,null,93.31405084487746,73.6842105263158,2196,5,30649,14,30,09,3,2019,2019-09-30,4,2019,32845,19
Bureau,Department of the Interior,Bureau of Reclamation,null,100.0,100.0,0,0,113731,91,30,09,3,2019,2019-09-30,4,2019,113731,91
Bureau,Department of Veterans Affairs,Life Insurance,null,100.0,100.0,0,0,574539,104,30,09,3,2019,2019-09-30,4,2019,574539,104
Bureau,Agency for International Development,Agency for International Development,null,99.9857161175467,96.42857142857143,3979,2,27852593,54,30,09,3,2019,2019-09-30,4,2019,27856572,56
Bureau,Department of the Treasury,Departmental Offices,null,82.98592382778187,73.18278052223006,5851412,380,28540182,1037,30,09,3,2019,2019-09-30,4,2019,34391594,1417
Bureau,Department of Agriculture,Food Safety and Inspection Service,null,99.9934260608099,99.93243243243244,69,1,1049530,1479,30,09,3,2019,2019-09-30,4,2019,1049599,1480
Bureau,Department of Defense,Consolidated Report,null,49.344183812859846,20.901253046546827,1150422079,1130382,1120634170,298695,30,09,3,2019,2019-09-30,4,2019,2271056249,1429077
Bureau,Department of the Treasury,Bureau of the Fiscal Service,null,100.0,100.0,0,0,13413599,4526,30,09,3,2019,2019-09-30,4,2019,13413599,4526
Bureau,Department of Housing and Urban Development,"Policy, Development and Research",null,0.0,0.0,0,0,0,0,30,09,3,2019,2019-09-30,4,2019,0,0
Bureau,Department of State,Passport NSF,null,100.0,100.0,0,0,2701688,17420,30,09,3,2019,2019-09-30,4,2019,2701688,17420
Bureau,Department of Labor,Employment and Training Administration,null,100.0,100.0,0,0,3167034,4,30,09,3,2019,2019-09-30,4,2019,3167034,4
Bureau,Department of the Treasury,Bureau of Engraving and Printing,null,100.0,100.0,0,0,84528,1,30,09,3,2019,2019-09-30,4,2019,84528,1
Bureau,Department of the Interior,National Park Service,null,100.0,100.0,0,0,6739443,1973,30,09,3,2019,2019-09-30,4,2019,6739443,1973
Bureau,Department of Labor,Occupational Safety and Health Admin,null,93.9292139202841,91.20750293083236,676434,75,10466011,778,30,09,3,2019,2019-09-30,4,2019,11142445,853
Bureau,U.S. Postal Service,U.S. Postal Service,null,54.57329171033226,80.97652270735117,30491689,8030,36631134,34181,30,09,3,2019,2019-09-30,4,2019,67122823,42211
Agency,American Battle Monuments Commission,null,Non-CFO,0.0,0.0,0,0,0,0,30,09,3,2019,2019-09-30,4,2019,0,0
Bureau,Department of Labor,Departmental Management,null,0.0,0.0,0,0,0,0,30,09,3,2019,2019-09-30,4,2019,0,0
Bureau,Department of Transportation,Pipeline Hazardous Material Safety Admin,null,100.0,100.0,0,0,334298,22,30,09,3,2019,2019-09-30,4,2019,334298,22
Bureau,Department of Commerce,Patent and Trademark Office,null,100.0,100.0,0,0,391502,525,30,09,3,2019,2019-09-30,4,2019,391502,525
Bureau,Department of Veterans Affairs,Housing Credit Assistance,null,4.323518255576368,21.96969696969697,9562341,103,432112,29,30,09,3,2019,2019-09-30,4,2019,9994453,132
Bureau,Department of Housing and Urban Development,Community Planning and Development,null,0.0,0.0,0,0,0,0,30,09,3,2019,2019-09-30,4,2019,0,0
Bureau,Selective Service System,Selective Service System,null,0.0,0.0,0,0,0,0,30,09,3,2019,2019-09-30,4,2019,0,0
Agency,U.S. Court of Appeals / Veterans Claims,null,Non-CFO,100.0,100.0,0,0,4018,5,30,09,3,2019,2019-09-30,4,2019,4018,5
Bureau,Department of Homeland Security,Office of Biometric Identity Management,null,0.0,0.0,0,0,0,0,30,09,3,2019,2019-09-30,4,2019,0,0
Bureau,Department of Homeland Security,Domestic Nuclear Detection Office,null,0.0,0.0,0,0,0,0,30,09,3,2019,2019-09-30,4,2019,0,0
Bureau,Other Agencies,Denali Commission,null,0.0,0.0,0,0,0,0,30,09,3,2019,2019-09-30,4,2019,0,0
Agency,National Science Foundation,null,CFO,100.0,100.0,0,0,614909,94,30,09,3,2019,2019-09-30,4,2019,614909,94
Agency,Department of Veterans Affairs,null,CFO,91.11616832227652,98.7435679119135,104416158,111206,1070934319,8739730,30,09,3,2019,2019-09-30,4,2019,1175350477,8850936
Agency,Small Business Administration,null,CFO,99.89094612062316,99.92239486154914,13523760,94,12387465620,121032,30,09,3,2019,2019-09-30,4,2019,12400989380,121126
Agency,Smithsonian Institution,null,Non-CFO,0.0,0.0,0,0,0,0,30,09,3,2019,2019-09-30,4,2019,0,0
Agency,Office of Special Counsel,null,Non-CFO,0.0,0.0,0,0,0,0,30,09,3,2019,2019-09-30,4,2019,0,0
Agency,Occupational Safety & Health Rev Comm,null,Non-CFO,0.0,0.0,0,0,0,0,30,09,3,2019,2019-09-30,4,2019,0,0
Bureau,Funds Appropriated to the President,Executive Branch,null,0.0,0.0,0,0,0,0,30,09,3,2019,2019-09-30,4,2019,0,0
Agency,Legislative Branch-Office of Tech.,null,Non-CFO,0.0,0.0,0,0,0,0,30,09,3,2019,2019-09-30,4,2019,0,0
Agency,Funds Appropriated to the President,null,Non-CFO,0.0,0.0,0,0,0,0,30,09,3,2019,2019-09-30,4,2019,0,0
Agency,Neighborhood Reinvestment Corporation,null,Non-CFO,0.0,0.0,0,0,0,0,30,09,3,2019,2019-09-30,4,2019,0,0
Bureau,Smithsonian Institution,Smithsonian Institution,null,0.0,0.0,0,0,0,0,30,09,3,2019,2019-09-30,4,2019,0,0
Bureau,Federal Labor Relations Authority,Federal Labor Relations Authority,null,0.0,0.0,0,0,0,0,30,09,3,2019,2019-09-30,4,2019,0,0
Bureau,Other Agencies,Federal Mine Safety & Health Review Comm,null,0.0,0.0,0,0,0,0,30,09,3,2019,2019-09-30,4,2019,0,0
Bureau,Other Agencies,Archit.&Trans. Barriers Compliance Bd,null,0.0,0.0,0,0,0,0,30,09,3,2019,2019-09-30,4,2019,0,0
Bureau,Other Agencies,Delta Regional Authority,null,0.0,0.0,0,0,0,0,30,09,3,2019,2019-09-30,4,2019,0,0
Bureau,Department of Homeland Security,Science and Technology,null,0.0,0.0,0,0,0,0,30,09,3,2019,2019-09-30,4,2019,0,0
Agency,Legislative Branch-CBO,null,Non-CFO,0.0,0.0,0,0,0,0,30,09,3,2019,2019-09-30,4,2019,0,0
Bureau,National Aeronautics and Space Administration,National Aeronautics and Space Admin,null,99.96176544953347,97.58064516129032,372,3,972570,121,30,09,3,2019,2019-09-30,4,2019,972942,124
Bureau,Department of Homeland Security,Citizenship and Immigration Services,null,100.0,100.0,0,0,993992,1226,30,09,3,2019,2019-09-30,4,2019,993992,1226
Bureau,Department of the Interior,Office of Surface Mining,null,100.0,100.0,0,0,2164202,240,30,09,3,2019,2019-09-30,4,2019,2164202,240
Bureau,Department of the Treasury,Treasury Forfeiture Fund,null,0.0,0.0,0,0,0,0,30,09,3,2019,2019-09-30,4,2019,0,0
Bureau,National Foundation  Arts & Humanities,National Endowment for the Arts,null,0.0,0.0,0,0,0,0,30,09,3,2019,2019-09-30,4,2019,0,0
Bureau,Other Agencies/Boards/Commissions,Medicare Payment Advisory Commission,null,0.0,0.0,0,0,0,0,30,09,3,2019,2019-09-30,4,2019,0,0
Bureau,Other Agencies,National Transportation Safety Board,null,0.0,0.0,0,0,0,0,30,09,3,2019,2019-09-30,4,2019,0,0
Bureau,Federal Election Commission,Federal Election Commission,null,94.75547546485245,90.0,30442,9,550011,81,30,09,3,2019,2019-09-30,4,2019,580453,90
Bureau,Department of Justice,U.S. Marshals Service,null,0.0,0.0,0,0,0,0,30,09,3,2019,2019-09-30,4,2019,0,0
Bureau,Federal Mediation/Conciliation Service,Federal Mediation/Conciliation Service,null,0.0,0.0,0,0,0,0,30,09,3,2019,2019-09-30,4,2019,0,0
Agency,National Aeronautics and Space Administration,null,CFO,99.96176544953347,97.58064516129032,372,3,972570,121,30,09,3,2019,2019-09-30,4,2019,972942,124
Agency,Department of Energy,null,CFO,100.0,100.0,0,0,14460549,94,30,09,3,2019,2019-09-30,4,2019,14460549,94
Agency,Environmental Protection Agency,null,CFO,100.0,100.0,0,0,16581414,207,30,09,3,2019,2019-09-30,4,2019,16581414,207
Agency,Department of State,null,CFO,97.72840563389204,99.81389578163771,401613,45,17278172,24135,30,09,3,2019,2019-09-30,4,2019,17679785,24180
Agency,Department of Commerce,null,CFO,100.0,100.0,0,0,19305387,1419,30,09,3,2019,2019-09-30,4,2019,19305387,1419
Agency,Department of Justice,null,CFO,99.07576002888514,99.20626079206818,765165,285,82023399,35621,30,09,3,2019,2019-09-30,4,2019,82788564,35906
Agency,Department of Homeland Security,null,CFO,100.0,100.0,0,0,364952489,61838,30,09,3,2019,2019-09-30,4,2019,364952489,61838
Agency,Department of Agriculture,null,CFO,98.98294690851482,97.41082495524033,17599616,1692,1712852427,63657,30,09,3,2019,2019-09-30,4,2019,1730452043,65349
Agency,Department of Defense,null,CFO,49.344183812859846,20.901253046546827,1150422079,1130382,1120634170,298695,30,09,3,2019,2019-09-30,4,2019,2271056249,1429077
Agency,Social Security Administration,null,CFO,53.46243679722398,30.723101138947275,2362883692,1097229,2714485060,486602,30,09,3,2019,2019-09-30,4,2019,5077368752,1583831
Bureau,Export - Import  Bank,Export-Import Bank,null,0.0,0.0,0,0,0,0,30,09,3,2019,2019-09-30,4,2019,0,0
Bureau,Department of Agriculture,Food and Nutrition Service,null,0.6924975642469866,25.925925925925927,6903509,20,48140,7,30,09,3,2019,2019-09-30,4,2019,6951649,27
Agency,Selective Service System,null,Non-CFO,0.0,0.0,0,0,0,0,30,09,3,2019,2019-09-30,4,2019,0,0
Agency,Legis Branch-Library of Congress,null,Non-CFO,0.0,0.0,51186,10,0,0,30,09,3,2019,2019-09-30,4,2019,51186,10
Agency,Other Agencies,null,Non-CFO,0.731881841907584,1.2422360248447204,668676,159,4930,2,30,09,3,2019,2019-09-30,4,2019,673606,161
Agency,Pension Benefit Guaranty Corp,null,Non-CFO,100.0,100.0,0,0,2659827,1558,30,09,3,2019,2019-09-30,4,2019,2659827,1558
Agency,Corp. for National and Community Service,null,Non-CFO,99.71420375643334,94.27312775330397,10282,13,3587386,214,30,09,3,2019,2019-09-30,4,2019,3597668,227
Bureau,National Credit Union Administration,National Credit Union Administration,null,0.0,0.0,0,0,0,0,30,09,3,2019,2019-09-30,4,2019,0,0
Bureau,Other Agencies,Federal Housing Finance Agency,null,0.0,0.0,0,0,0,0,30,09,3,2019,2019-09-30,4,2019,0,0
Bureau,The Judiciary,Administrative Office of the U.S. Courts,null,98.66116727770988,64.92307692307692,14461,114,1065659,211,30,09,3,2019,2019-09-30,4,2019,1080120,325
Bureau,Federal Trade Commission,Federal Trade Commission,null,100.0,100.0,0,0,483084528,66,30,09,3,2019,2019-09-30,4,2019,483084528,66
Agency,Office of Compliance,null,Non-CFO,0.0,0.0,0,0,0,0,30,09,3,2019,2019-09-30,4,2019,0,0
Agency,Tennessee Valley Authority,null,Non-CFO,0.0,0.0,0,0,0,0,30,09,3,2019,2019-09-30,4,2019,0,0
Agency,Federal Mediation/Conciliation Service,null,Non-CFO,0.0,0.0,0,0,0,0,30,09,3,2019,2019-09-30,4,2019,0,0
Agency,Export - Import  Bank,null,Non-CFO,0.0,0.0,0,0,0,0,30,09,3,2019,2019-09-30,4,2019,0,0
Agency,Railroad Retirement Board,null,Non-CFO,100.0,100.0,0,0,20115604,4273,30,09,3,2019,2019-09-30,4,2019,20115604,4273
Agency,U.S. Postal Service,null,Non-CFO,54.57329171033226,80.97652270735117,30491689,8030,36631134,34181,30,09,3,2019,2019-09-30,4,2019,67122823,42211
Bureau,Department of Agriculture,Federal Crop Insurance Corporation,null,92.8261841697912,99.75550122249389,4171,1,53971,408,30,09,3,2019,2019-09-30,4,2019,58142,409
Bureau,Other Agencies,James Madison Memorial Fellowship,null,0.0,0.0,228745,23,0,0,30,09,3,2019,2019-09-30,4,2019,228745,23
Bureau,Department of the Interior,Geological Survey,null,100.0,100.0,0,0,287271,145,30,09,3,2019,2019-09-30,4,2019,287271,145
Bureau,Department of Agriculture,Farm Service Agency,null,100.0,100.0,0,0,794796670,15787,30,09,3,2019,2019-09-30,4,2019,794796670,15787
Agency,Commodity Futures Trading Commission,null,Non-CFO,100.0,100.0,0,0,640368451,371,30,09,3,2019,2019-09-30,4,2019,640368451,371
Bureau,Department of Commerce,Office of the Inspector General,null,0.0,0.0,0,0,0,0,30,09,3,2019,2019-09-30,4,2019,0,0
Bureau,Other Agencies,Federal Housing Finance Agency OIG,null,0.0,0.0,0,0,0,0,30,09,3,2019,2019-09-30,4,2019,0,0
Bureau,Department of the Treasury,Treasury Franchise Fund,null,0.0,0.0,0,0,0,0,30,09,3,2019,2019-09-30,4,2019,0,0
Bureau,Department of Health & Human Services,Administration for Community Living,null,0.0,0.0,0,0,0,0,30,09,3,2019,2019-09-30,4,2019,0,0
Bureau,Department of Health & Human Services,Office of the Inspector General,null,0.0,0.0,0,0,0,0,30,09,3,2019,2019-09-30,4,2019,0,0
Bureau,Other Agencies,Morris K. Udall Scholarship,null,0.0,0.0,982,1,0,0,30,09,3,2019,2019-09-30,4,2019,982,1
Bureau,Securities & Exchange Commission,Securities and Exchange Commission,null,100.0,100.0,0,0,2017561197,857,30,09,3,2019,2019-09-30,4,2019,2017561197,857
Bureau,Department of Health & Human Services,Administration for Children and Families,null,100.0,100.0,0,0,27975600,1670,30,09,3,2019,2019-09-30,4,2019,27975600,1670
Bureau,National Labor Relations Board,National Labor Relations Board,null,0.0,0.0,0,0,0,0,30,09,3,2019,2019-09-30,4,2019,0,0
Bureau,American Battle Monuments Commission,American Battle Monuments Commission,null,0.0,0.0,0,0,0,0,30,09,3,2019,2019-09-30,4,2019,0,0
Bureau,U.S. Court of Appeals / Veterans Claims,U.S. Court of Appeals / Veterans Claims,null,100.0,100.0,0,0,4018,5,30,09,3,2019,2019-09-30,4,2019,4018,5
Bureau,Department of Transportation,Federal Highway Administration,null,100.0,100.0,0,0,8119,7,30,09,3,2019,2019-09-30,4,2019,8119,7
Agency,Merit Systems Protection Board,null,Non-CFO,100.0,100.0,0,0,141,1,30,09,3,2019,2019-09-30,4,2019,141,1
Bureau,Department of Commerce,Economic Development Administration,null,100.0,100.0,0,0,5113460,9,30,09,3,2019,2019-09-30,4,2019,5113460,9
Bureau,Other Agencies,Council of Insps. Gen. of Intg. & Effy.,null,0.0,0.0,3050,4,0,0,30,09,3,2019,2019-09-30,4,2019,3050,4
Bureau,Department of the Interior,Office of the Secretary,null,100.0,100.0,0,0,28737,17,30,09,3,2019,2019-09-30,4,2019,28737,17
Bureau,Other Agencies,Architect of the Capitol,null,0.0,0.0,124433,60,0,0,30,09,3,2019,2019-09-30,4,2019,124433,60
Bureau,Department of Transportation,Federal Railroad Administration,null,100.0,100.0,0,0,168424,17,30,09,3,2019,2019-09-30,4,2019,168424,17
Agency,Agency for International Development,null,CFO,99.9857161175467,96.42857142857143,3979,2,27852593,54,30,09,3,2019,2019-09-30,4,2019,27856572,56
Agency,Department of Health & Human Services,null,CFO,98.83463839297373,98.43946158294895,111238137,17701,9434136992,1116587,30,09,3,2019,2019-09-30,4,2019,9545375129,1134288
Bureau,Department of Homeland Security,Office of the Inspector General DHS,null,100.0,100.0,0,0,97,1,30,09,3,2019,2019-09-30,4,2019,97,1
Bureau,Securities & Exchange Commission,SEC Enforcement,null,0.0,0.0,0,0,0,0,30,09,3,2019,2019-09-30,4,2019,0,0
Bureau,Merit Systems Protection Board,Merit Systems Protection Board,null,100.0,100.0,0,0,141,1,30,09,3,2019,2019-09-30,4,2019,141,1
Bureau,Department of Health & Human Services,Substance Abuse & Mental Health Admin.,null,100.0,100.0,0,0,953784,14,30,09,3,2019,2019-09-30,4,2019,953784,14
Bureau,Department of Justice,Federal Prison Industries,null,100.0,100.0,0,0,1043089,183,30,09,3,2019,2019-09-30,4,2019,1043089,183
Agency,Office of Government Ethics,null,Non-CFO,0.0,0.0,0,0,0,0,30,09,3,2019,2019-09-30,4,2019,0,0
Bureau,Department of Homeland Security,Management Headquarters,null,100.0,100.0,0,0,159,1,30,09,3,2019,2019-09-30,4,2019,159,1
Agency,Department of Labor,null,CFO,87.70440861447176,54.34782608695652,18379969,16233,131104252,19325,30,09,3,2019,2019-09-30,4,2019,149484221,35558
Agency,Other Agencies/Boards/Commissions,null,Non-CFO,0.0,0.0,393,1,0,0,30,09,3,2019,2019-09-30,4,2019,393,1
Agency,Department of Education,null,CFO,85.85255375730898,82.35331878222564,23823457122,5047173,144570588795,23554086,30,09,3,2019,2019-09-30,4,2019,168394045917,28601259
Bureau,Legislative Branch-CBO,Congressional Budget Office,null,0.0,0.0,0,0,0,0,30,09,3,2019,2019-09-30,4,2019,0,0
Bureau,Department of Commerce,International Trade Administration,null,0.0,0.0,0,0,0,0,30,09,3,2019,2019-09-30,4,2019,0,0
Bureau,Department of Housing and Urban Development,Government National Mortgage Association,null,0.0,0.0,0,0,0,0,30,09,3,2019,2019-09-30,4,2019,0,0
Bureau,Other Agencies,Advisory Council on Hist. Preservation,null,0.0,0.0,0,0,0,0,30,09,3,2019,2019-09-30,4,2019,0,0
Bureau,Other Agencies,Defense Nuclear Facilities Safety Board,null,0.0,0.0,0,0,0,0,30,09,3,2019,2019-09-30,4,2019,0,0
Bureau,Smithsonian Institution,Administrative Conference of the US,null,0.0,0.0,0,0,0,0,30,09,3,2019,2019-09-30,4,2019,0,0
Bureau,Department of Commerce,Bureau of the Census,null,100.0,100.0,0,0,324374,228,30,09,3,2019,2019-09-30,4,2019,324374,228
Bureau,Department of Health & Human Services,Indian Health Services,null,98.58276145429423,7.527801539777587,361939,2162,25176387,176,30,09,3,2019,2019-09-30,4,2019,25538326,2338
Bureau,Department of Agriculture,U.S. Department of Agriculture,null,82.07291211358806,68.12933025404158,5139479,828,23529310,1770,30,09,3,2019,2019-09-30,4,2019,28668789,2598
Agency,Farm Credit Administration,null,Non-CFO,100.0,100.0,0,0,630,1,30,09,3,2019,2019-09-30,4,2019,630,1
Bureau,Department of Commerce,Economic and Statistical Analysis,null,0.0,0.0,0,0,0,0,30,09,3,2019,2019-09-30,4,2019,0,0
Bureau,Department of Commerce,Bureau of Industry and Security,null,100.0,100.0,0,0,637797,13,30,09,3,2019,2019-09-30,4,2019,637797,13
Bureau,Department of Labor,Mine Safety and Health Administration,null,93.19649460947127,89.37246331564158,2833584,1702,38815299,14313,30,09,3,2019,2019-09-30,4,2019,41648883,16015
Bureau,Federal Deposit Insurance Corporation,Federal Deposit Insurance Corporation,null,0.0,0.0,0,0,0,0,30,09,3,2019,2019-09-30,4,2019,0,0
Bureau,Department of Transportation,National Highway Traffic Safety Admin.,null,100.0,100.0,0,0,25954,4,30,09,3,2019,2019-09-30,4,2019,25954,4
Bureau,Legis Branch-Library of Congress,Library of Congress,null,0.0,0.0,51186,10,0,0,30,09,3,2019,2019-09-30,4,2019,51186,10
Bureau,Department of Agriculture,Agricultural Marketing Service,null,92.0517179285529,46.161321671525755,378496,554,4383489,475,30,09,3,2019,2019-09-30,4,2019,4761985,1029
Bureau,Office of Personnel Management,Office of Personnel Management,null,77.62963768949248,67.97437950360288,4338045,400,15053885,849,30,09,3,2019,2019-09-30,4,2019,19391930,1249
Bureau,General Services Administration,General Services Administration,null,74.47789459502144,93.88899632566235,5224535,316,15246092,4855,30,09,3,2019,2019-09-30,4,2019,20470627,5171
Bureau,Social Security Administration,Social Security Administration,null,53.46243679722398,30.723101138947275,2362883692,1097229,2714485060,486602,30,09,3,2019,2019-09-30,4,2019,5077368752,1583831
Bureau,Other Agencies/Boards/Commissions,U.S. Comm. on Int. Religious Freedom,null,0.0,0.0,393,1,0,0,30,09,3,2019,2019-09-30,4,2019,393,1
Bureau,Department of Health & Human Services,Centers for Medicare & Medicaid Services,null,99.20011344720128,99.08116645095086,74470690,10315,9235685824,1112304,30,09,3,2019,2019-09-30,4,2019,9310156514,1122619
Bureau,Armed Forces Retirement Home,Armed Forces Retirement Home,null,99.21580547112463,96.22641509433963,645,4,81605,102,30,09,3,2019,2019-09-30,4,2019,82250,106
Bureau,Corp. for National and Community Service,Corp. for National and Community Service,null,99.71420375643334,94.27312775330397,10282,13,3587386,214,30,09,3,2019,2019-09-30,4,2019,3597668,227
Bureau,Funds Appropriated to the President,African Development Foundation,null,0.0,0.0,0,0,0,0,30,09,3,2019,2019-09-30,4,2019,0,0
Bureau,Equal Employment Opportunity Commission,Equal Employment Opportunity Commission,null,100.0,100.0,0,0,49948,28,30,09,3,2019,2019-09-30,4,2019,49948,28
Bureau,Legislative Branch-GPO,Government Publishing Office,null,0.0,0.0,84359,27,0,0,30,09,3,2019,2019-09-30,4,2019,84359,27
Bureau,Department of Justice,Drug Enforcement Administration,null,100.0,100.0,0,0,331509,22,30,09,3,2019,2019-09-30,4,2019,331509,22
Bureau,Department of Health & Human Services,Food and Drug Administration,null,62.55012472978165,19.184367034834324,21152476,4756,35329624,1129,30,09,3,2019,2019-09-30,4,2019,56482100,5885
Agency,Legislative Branch-GAO,null,Non-CFO,93.31405084487746,73.6842105263158,2196,5,30649,14,30,09,3,2019,2019-09-30,4,2019,32845,19
Bureau,Department of the Treasury,Community Dev Financial Inst Fund,null,100.0,100.0,0,0,4031760,7,30,09,3,2019,2019-09-30,4,2019,4031760,7
Bureau,Department of Housing and Urban Development,Housing Programs,null,99.97752042201549,99.95300015666615,37460,3,166602679,6380,30,09,3,2019,2019-09-30,4,2019,166640139,6383
Bureau,Small Business Administration,Small Business Administration,null,99.89094612062316,99.92239486154914,13523760,94,12387465620,121032,30,09,3,2019,2019-09-30,4,2019,12400989380,121126
Agency,Equal Employment Opportunity Commission,null,Non-CFO,100.0,100.0,0,0,49948,28,30,09,3,2019,2019-09-30,4,2019,49948,28
Bureau,Department of Energy,Bonneville Power Administration,null,100.0,100.0,0,0,1082579,31,30,09,3,2019,2019-09-30,4,2019,1082579,31
Bureau,Smithsonian Institution,JFK Center for the Performing Arts,null,0.0,0.0,0,0,0,0,30,09,3,2019,2019-09-30,4,2019,0,0
Bureau,Department of Housing and Urban Development,Public and Indian Housing Programs,null,100.0,100.0,0,0,564,1,30,09,3,2019,2019-09-30,4,2019,564,1
Bureau,Department of the Interior,Fish and Wildlife Service,null,100.0,100.0,0,0,605036,95,30,09,3,2019,2019-09-30,4,2019,605036,95
Bureau,Department of the Treasury,Financial Crimes Enforcement Network,null,100.0,100.0,0,0,1544945,3,30,09,3,2019,2019-09-30,4,2019,1544945,3
Bureau,Department of the Interior,Office of Natural Resources Revenue,null,100.0,100.0,0,0,2482484,330,30,09,3,2019,2019-09-30,4,2019,2482484,330
Bureau,Department of Health & Human Services,Centers for Disease Control,null,0.8651004032114369,8.275862068965518,6871142,133,59961,12,30,09,3,2019,2019-09-30,4,2019,6931103,145
Bureau,Department of Agriculture,Commodity Credit Corporation,null,99.92855746383788,99.92345230121519,87676,8,122634731,10443,30,09,3,2019,2019-09-30,4,2019,122722407,10451
Bureau,Department of Health & Human Services,Program Support Center,null,100.0,100.0,0,0,5550136,643,30,09,3,2019,2019-09-30,4,2019,5550136,643
Bureau,Department of Education,Federal Student Aid,null,85.79496754951946,82.3522494726998,23816957769,5047161,143848676590,23552297,30,09,3,2019,2019-09-30,4,2019,167665634359,28599458
Agency,Armed Forces Retirement Home,null,Non-CFO,99.21580547112463,96.22641509433963,645,4,81605,102,30,09,3,2019,2019-09-30,4,2019,82250,106
Agency,Legislative Branch-GPO,null,Non-CFO,0.0,0.0,84359,27,0,0,30,09,3,2019,2019-09-30,4,2019,84359,27
Bureau,Legislative Branch - U.S. House/Senate,U.S. House of Representatives,null,11.801388127685641,27.868852459016395,191503,176,25624,68,30,09,3,2019,2019-09-30,4,2019,217127,244
Bureau,Department of Homeland Security,Transportation Safety Administration,null,100.0,100.0,0,0,8306901,5597,30,09,3,2019,2019-09-30,4,2019,8306901,5597
Agency,National Archives & Records Admin,null,Non-CFO,98.7866360787976,98.9795918367347,1793,1,145978,97,30,09,3,2019,2019-09-30,4,2019,147771,98
Bureau,Funds Appropriated to the President,Defense Security Assistance Agency,null,0.0,0.0,0,0,0,0,30,09,3,2019,2019-09-30,4,2019,0,0
Bureau,Department of Commerce,Nat'l Institute of Standards& Technology,null,100.0,100.0,0,0,667997,3,30,09,3,2019,2019-09-30,4,2019,667997,3
Bureau,Department of Homeland Security,Immigration and Customs Enforcement,null,100.0,100.0,0,0,10008836,421,30,09,3,2019,2019-09-30,4,2019,10008836,421
Agency,Legislative Branch - U.S. House/Senate,null,Non-CFO,11.801388127685641,27.868852459016395,191503,176,25624,68,30,09,3,2019,2019-09-30,4,2019,217127,244
Bureau,Other Agencies,National Capital Planning Commission,null,0.0,0.0,0,0,0,0,30,09,3,2019,2019-09-30,4,2019,0,0
Bureau,Railroad Retirement Board,Railroad Retirement Board,null,100.0,100.0,0,0,20115604,4273,30,09,3,2019,2019-09-30,4,2019,20115604,4273
Bureau,Farm Credit Administration,Farm Credit Administration,null,100.0,100.0,0,0,630,1,30,09,3,2019,2019-09-30,4,2019,630,1
Bureau,Department of Homeland Security,Bureau of Customs & Border Protection,null,100.0,100.0,0,0,11830916,674,30,09,3,2019,2019-09-30,4,2019,11830916,674
Bureau,Department of Labor,Employment Standards Administration,null,80.50786626852596,20.93633778166703,14869951,14456,61416982,3828,30,09,3,2019,2019-09-30,4,2019,76286933,18284
Bureau,Department of Education,Office of Postsecondary Education,null,0.0,0.0,0,0,0,0,30,09,3,2019,2019-09-30,4,2019,0,0
Bureau,Other Agencies,Election Assistance Commission,null,0.0,0.0,0,0,0,0,30,09,3,2019,2019-09-30,4,2019,0,0
Agency,Federal Maritime Commission,null,Non-CFO,99.62716175297456,37.5,1762,10,470829,6,30,09,3,2019,2019-09-30,4,2019,472591,16
Bureau,Department of the Treasury,Tobacco Tax and Trade,null,100.0,100.0,0,0,1000,1,30,09,3,2019,2019-09-30,4,2019,1000,1
Bureau,Department of the Interior,Bureau of Indian Affairs,null,99.98075400277219,99.93036673519464,2946,21,15304133,30137,30,09,3,2019,2019-09-30,4,2019,15307079,30158
Bureau,Department of the Interior,"Bureau of Ocean Energy Mgmt., Reg & Enf",null,0.0,0.0,0,0,0,0,30,09,3,2019,2019-09-30,4,2019,0,0
Bureau,Other Agencies,Comm. for Purchase from Blind/Handic.,null,0.0,0.0,0,0,0,0,30,09,3,2019,2019-09-30,4,2019,0,0
Agency,Federal Election Commission,null,Non-CFO,94.75547546485245,90.0,30442,9,550011,81,30,09,3,2019,2019-09-30,4,2019,580453,90
Bureau,Federal Communications Commission,Federal Communications Commission,null,100.0,100.0,0,0,202593636,10908,30,09,3,2019,2019-09-30,4,2019,202593636,10908
Bureau,Department of the Treasury,Office of Financial Research,null,0.0,0.0,0,0,0,0,30,09,3,2019,2019-09-30,4,2019,0,0
Bureau,Other Agencies,U.S. Inst. for Env. Conflict Resolution,null,0.0,0.0,3545,7,0,0,30,09,3,2019,2019-09-30,4,2019,3545,7
Bureau,Occupational Safety & Health Rev Comm,Occupational Safety & Health Rev Comm,null,0.0,0.0,0,0,0,0,30,09,3,2019,2019-09-30,4,2019,0,0
Bureau,National Archives & Records Admin,Nat'l Archives & Records Administration,null,98.7866360787976,98.9795918367347,1793,1,145978,97,30,09,3,2019,2019-09-30,4,2019,147771,98
Bureau,Department of Health & Human Services,National Institutes of Health,null,36.45856865399865,19.85645933014354,8381890,335,4809330,83,30,09,3,2019,2019-09-30,4,2019,13191220,418
Bureau,Department of Homeland Security,Emergency Preparedness & Resp,null,100.0,100.0,0,0,257655449,42959,30,09,3,2019,2019-09-30,4,2019,257655449,42959
Bureau,Department of the Treasury,International Monetary Funds,null,0.0,0.0,0,0,0,0,30,09,3,2019,2019-09-30,4,2019,0,0
Bureau,Department of Transportation,Research Innovative Technology Admin,null,100.0,100.0,0,0,3564,4,30,09,3,2019,2019-09-30,4,2019,3564,4
Bureau,Other Agencies,Millennium Challenge Corporation,null,0.0,0.0,0,0,0,0,30,09,3,2019,2019-09-30,4,2019,0,0
Bureau,Department of the Treasury,Comptroller of the Currency,null,100.0,100.0,0,0,1123344,22,30,09,3,2019,2019-09-30,4,2019,1123344,22
Bureau,Department of Veterans Affairs,Administration and Cemeteries,null,0.5575596963065315,1.0512483574244416,1227782,753,6884,8,30,09,3,2019,2019-09-30,4,2019,1234666,761
Agency,Department of Housing and Urban Development,null,CFO,99.97752049809823,99.953007518797,37460,3,166603243,6381,30,09,3,2019,2019-09-30,4,2019,166640703,6384
Bureau,Department of Veterans Affairs,Medical and Construction,null,85.36165134161892,98.75566236550003,92337954,108661,538456927,8623776,30,09,3,2019,2019-09-30,4,2019,630794881,8732437
Agency,Presidio Trust Corporation,null,Non-CFO,94.88292192736725,90.47619047619048,72920,8,1352112,76,30,09,3,2019,2019-09-30,4,2019,1425032,84
Bureau,Department of State,Department of State,null,97.3186647142157,99.33431952662721,401613,45,14576484,6715,30,09,3,2019,2019-09-30,4,2019,14978097,6760
Bureau,Department of the Treasury,Office of the Secretary,null,0.0,0.0,0,0,0,0,30,09,3,2019,2019-09-30,4,2019,0,0
Bureau,Nuclear Regulatory Commission,Nuclear Regulatory Commission,null,96.02792752330916,97.0464135021097,60316,7,1458186,230,30,09,3,2019,2019-09-30,4,2019,1518502,237
Bureau,Department of Transportation,Federal Aviation Administration,null,97.76991980954712,95.87912087912088,50472,15,2212765,349,30,09,3,2019,2019-09-30,4,2019,2263237,364
Bureau,Department of the Interior,Bureau of Land Management,null,100.0,100.0,0,0,17794985,282,30,09,3,2019,2019-09-30,4,2019,17794985,282
Bureau,Commodity Futures Trading Commission,Commodity Futures Trading Commission,null,100.0,100.0,0,0,640368451,371,30,09,3,2019,2019-09-30,4,2019,640368451,371
Bureau,Department of Education,Departmental Management,null,99.10773615154525,99.33370349805664,6499353,12,721912205,1789,30,09,3,2019,2019-09-30,4,2019,728411558,1801
Agency,General Services Administration,null,CFO,74.47789459502144,93.88899632566235,5224535,316,15246092,4855,30,09,3,2019,2019-09-30,4,2019,20470627,5171
Bureau,Department of the Treasury,Interest on Tax/Deposit of Earnings,null,0.0,0.0,0,0,0,0,30,09,3,2019,2019-09-30,4,2019,0,0
Agency,Department of the Interior,null,CFO,99.9935306121835,99.93700503959683,2946,21,45534593,33315,30,09,3,2019,2019-09-30,4,2019,45537539,33336
Bureau,Department of Labor,Bureau of Labor Statistics,null,100.0,100.0,0,0,11381,1,30,09,3,2019,2019-09-30,4,2019,11381,1
Bureau,Department of Commerce,NOAA,null,100.0,100.0,0,0,11758017,637,30,09,3,2019,2019-09-30,4,2019,11758017,637
Agency,National Credit Union Administration,null,Non-CFO,0.0,0.0,0,0,0,0,30,09,3,2019,2019-09-30,4,2019,0,0
Bureau,Department of the Treasury,D.C. Pension Program,null,100.0,100.0,0,0,334437,18,30,09,3,2019,2019-09-30,4,2019,334437,18
Bureau,Department of Transportation,Federal Motor Carrier Safety Admin,null,99.99497394203637,99.96824892840134,2622,2,52165499,6297,30,09,3,2019,2019-09-30,4,2019,52168121,6299
Bureau,Department of Commerce,Nat'l Telecomm & Information Admin.,null,100.0,100.0,0,0,407580,3,30,09,3,2019,2019-09-30,4,2019,407580,3
Agency,Nuclear Regulatory Commission,null,CFO,96.02792752330916,97.0464135021097,60316,7,1458186,230,30,09,3,2019,2019-09-30,4,2019,1518502,237
Agency,Consumer Product Safety Commission,null,Non-CFO,100.0,100.0,0,0,479,1,30,09,3,2019,2019-09-30,4,2019,479,1
Bureau,Department of Transportation,St. Lawrence Seaway Development Corp.,null,100.0,100.0,0,0,4343,1,30,09,3,2019,2019-09-30,4,2019,4343,1
Bureau,Presidio Trust Corporation,Presidio Trust Corporation,null,94.88292192736725,90.47619047619048,72920,8,1352112,76,30,09,3,2019,2019-09-30,4,2019,1425032,84
Bureau,Legislative Branch-Office of Tech.,Open World Leadership,null,0.0,0.0,0,0,0,0,30,09,3,2019,2019-09-30,4,2019,0,0
Bureau,Other Agencies,U.S.  Agency of Global Media,null,100.0,100.0,0,0,4930,2,30,09,3,2019,2019-09-30,4,2019,4930,2
Bureau,Department of the Treasury,U.S. Mint,null,100.0,100.0,0,0,46379,19,30,09,3,2019,2019-09-30,4,2019,46379,19
Agency,Overseas Private Investment Corp Accts,null,Non-CFO,0.0,0.0,0,0,0,0,30,09,3,2019,2019-09-30,4,2019,0,0
Bureau,Department of Commerce,Minority Business Development Agency,null,0.0,0.0,0,0,0,0,30,09,3,2019,2019-09-30,4,2019,0,0
Agency,The Judiciary,null,Non-CFO,98.66116727770988,64.92307692307692,14461,114,1065659,211,30,09,3,2019,2019-09-30,4,2019,1080120,325
Bureau,Department of Veterans Affairs,Veterans Benefits,null,99.75822124555087,98.56257765825262,1288081,1689,531463857,115813,30,09,3,2019,2019-09-30,4,2019,532751938,117502
Agency,National Foundation  Arts & Humanities,null,Non-CFO,0.0,0.0,0,0,0,0,30,09,3,2019,2019-09-30,4,2019,0,0
Bureau,Pension Benefit Guaranty Corp,Pension Benefit Guaranty Corporation,null,100.0,100.0,0,0,2659827,1558,30,09,3,2019,2019-09-30,4,2019,2659827,1558
Bureau,Department of Transportation,Federal Transit Administration,null,100.0,100.0,0,0,784404,2,30,09,3,2019,2019-09-30,4,2019,784404,2
Bureau,Department of Transportation,Office of the Secretary,null,100.0,100.0,0,0,998611,18,30,09,3,2019,2019-09-30,4,2019,998611,18
Bureau,Office of Special Counsel,Office of Special Counsel,null,0.0,0.0,0,0,0,0,30,09,3,2019,2019-09-30,4,2019,0,0
Bureau,Department of Labor,Employee Benefit Security Administration,null,100.0,100.0,0,0,17227545,401,30,09,3,2019,2019-09-30,4,2019,17227545,401
Bureau,Department of Justice,Federal Bureau of Investigation,null,100.0,100.0,0,0,203617,59,30,09,3,2019,2019-09-30,4,2019,203617,59
Agency,Department of the Treasury,null,CFO,89.4029216011992,93.79478827361564,5852076,381,49371409,5759,30,09,3,2019,2019-09-30,4,2019,55223485,6140
Agency,National Labor Relations Board,null,Non-CFO,0.0,0.0,0,0,0,0,30,09,3,2019,2019-09-30,4,2019,0,0
Bureau,Other Agencies,National Council on Disability,null,0.0,0.0,387,1,0,0,30,09,3,2019,2019-09-30,4,2019,387,1
Agency,Federal Labor Relations Authority,null,Non-CFO,0.0,0.0,0,0,0,0,30,09,3,2019,2019-09-30,4,2019,0,0
Bureau,Other Agencies,Gulf Coast Ecosystem Restoration Council,null,0.0,0.0,0,0,0,0,30,09,3,2019,2019-09-30,4,2019,0,0
Bureau,Department of Agriculture,Forest Service,null,91.39149205123549,50.445632798573975,5083735,278,53971040,283,30,09,3,2019,2019-09-30,4,2019,59054775,561
Bureau,Department of Commerce,General Administration,null,100.0,100.0,0,0,4660,1,30,09,3,2019,2019-09-30,4,2019,4660,1
Agency,Federal Deposit Insurance Corporation,null,Non-CFO,0.0,0.0,0,0,0,0,30,09,3,2019,2019-09-30,4,2019,0,0
Bureau,Overseas Private Investment Corp Accts,Overseas Private Investment Corp Accts,null,0.0,0.0,0,0,0,0,30,09,3,2019,2019-09-30,4,2019,0,0
Bureau,Department of Justice,Federal Prison System,null,100.0,100.0,0,0,757448,104,30,09,3,2019,2019-09-30,4,2019,757448,104
Bureau,Department of Homeland Security,U.S. Secret Service,null,0.0,0.0,0,0,0,0,30,09,3,2019,2019-09-30,4,2019,0,0
Bureau,Office of Compliance,Office of Compliance,null,0.0,0.0,0,0,0,0,30,09,3,2019,2019-09-30,4,2019,0,0
Bureau,Federal Maritime Commission,Salaries and Expenses,null,99.62716175297456,37.5,1762,10,470829,6,30,09,3,2019,2019-09-30,4,2019,472591,16
Bureau,Office of Government Ethics,Office of Government Ethics,null,0.0,0.0,0,0,0,0,30,09,3,2019,2019-09-30,4,2019,0,0
Agency,Office of Personnel Management,null,CFO,77.62963768949248,67.97437950360288,4338045,400,15053885,849,30,09,3,2019,2019-09-30,4,2019,19391930,1249
Bureau,Department of Homeland Security,Info Analysis Infrastructure Prot-NPPD,null,0.0,0.0,0,0,0,0,30,09,3,2019,2019-09-30,4,2019,0,0
Bureau,Department of Health & Human Services,Office of the Secretary,null,100.0,100.0,0,0,8853,13,30,09,3,2019,2019-09-30,4,2019,8853,13
Bureau,Environmental Protection Agency,Environmental Protection Agency,null,100.0,100.0,0,0,16581414,207,30,09,3,2019,2019-09-30,4,2019,16581414,207
Agency,Department of Transportation,null,CFO,99.90646510831789,99.74792408066429,53094,17,56710750,6727,30,09,3,2019,2019-09-30,4,2019,56763844,6744
Bureau,Department of the Treasury,Internal Revenue Service,null,100.0,100.0,0,0,247319,124,30,09,3,2019,2019-09-30,4,2019,247319,124
Bureau,National Science Foundation,National Science Foundation,null,100.0,100.0,0,0,614909,94,30,09,3,2019,2019-09-30,4,2019,614909,94
Bureau,Other Agencies,Chemical Safety Board,null,0.0,0.0,0,0,0,0,30,09,3,2019,2019-09-30,4,2019,0,0
Bureau,Department of the Treasury,U.S. Treasury IG Office,null,0.0,0.0,664,1,0,0,30,09,3,2019,2019-09-30,4,2019,664,1
Bureau,Department of Justice,Office of Justice Assistance Programs,null,100.0,100.0,0,0,344029,101,30,09,3,2019,2019-09-30,4,2019,344029,101
Bureau,Other Agencies,U.S. Institute of Peace,null,0.0,0.0,0,0,0,0,30,09,3,2019,2019-09-30,4,2019,0,0
Bureau,Other Agencies/Boards/Commissions,U.S.-China Security Review Commission,null,0.0,0.0,0,0,0,0,30,09,3,2019,2019-09-30,4,2019,0,0
Bureau,Department of Homeland Security,U.S. Coast Guard,null,100.0,100.0,0,0,76156139,10959,30,09,3,2019,2019-09-30,4,2019,76156139,10959
Bureau,Department of the Interior,Bureau of Safety and Environmental Enf.,null,100.0,100.0,0,0,14571,5,30,09,3,2019,2019-09-30,4,2019,14571,5
Bureau,Tennessee Valley Authority,Tennessee Valley Authority,null,0.0,0.0,0,0,0,0,30,09,3,2019,2019-09-30,4,2019,0,0
Bureau,Neighborhood Reinvestment Corporation,Neighborhood Reinvestment Corporation,null,0.0,0.0,0,0,0,0,30,09,3,2019,2019-09-30,4,2019,0,0
Bureau,Department of Energy,Energy Consolidated Reports,null,100.0,100.0,0,0,13377970,63,30,09,3,2019,2019-09-30,4,2019,13377970,63
Bureau,Department of the Treasury,Office of Sec International Affairs,null,0.0,0.0,0,0,0,0,30,09,3,2019,2019-09-30,4,2019,0,0
Bureau,Department of Justice,Legal Activities,null,99.0445865718142,99.19566505799678,765165,285,79322154,35148,30,09,3,2019,2019-09-30,4,2019,80087319,35433
Bureau,Other Agencies,District of Columbia Government,null,0.0,0.0,0,0,0,0,30,09,3,2019,2019-09-30,4,2019,0,0
Bureau,Department of Transportation,Maritime Administration,null,100.0,100.0,0,0,4564,5,30,09,3,2019,2019-09-30,4,2019,4564,5
Bureau,Other Agencies,Consumer Financial Protection Bureau,null,0.0,0.0,307534,63,0,0,30,09,3,2019,2019-09-30,4,2019,307534,63
Bureau,Department of Health & Human Services,Health Resources and Services Admin,null,100.0,100.0,0,0,98587493,543,30,09,3,2019,2019-09-30,4,2019,98587493,543
Bureau,Department of Agriculture,Rural Development,null,99.99965173474203,99.99394067924986,2481,2,712385546,33005,30,09,3,2019,2019-09-30,4,2019,712388027,33007
Bureau,Funds Appropriated to the President,Trade and Development Agency,null,0.0,0.0,0,0,0,0,30,09,3,2019,2019-09-30,4,2019,0,0
Bureau,Department of Homeland Security,Office of Health Affairs,null,0.0,0.0,0,0,0,0,30,09,3,2019,2019-09-30,4,2019,0,0
Agency,Smithsonian Institution,null,Non-CFO,0.0,0.0,1065,2,0,0,31,12,4,2019,2019-12-31,1,2020,1065,2
Bureau,National Credit Union Administration,National Credit Union Administration,null,0.0,0.0,0,0,0,0,31,12,4,2019,2019-12-31,1,2020,0,0
Bureau,Other Agencies,U.S. Holocaust Memorial Council,null,0.0,0.0,0,0,0,0,31,12,4,2019,2019-12-31,1,2020,0,0
Bureau,Department of Transportation,Office of the Inspector General,null,100.0,100.0,0,0,205,1,31,12,4,2019,2019-12-31,1,2020,205,1
Bureau,Armed Forces Retirement Home,Armed Forces Retirement Home,null,100.0,100.0,0,0,82575,107,31,12,4,2019,2019-12-31,1,2020,82575,107
Bureau,Department of Agriculture,Commodity Credit Corporation,null,100.0,100.0,0,0,133240124,11125,31,12,4,2019,2019-12-31,1,2020,133240124,11125
Agency,Overseas Private Investment Corp Accts,null,Non-CFO,0.0,0.0,0,0,0,0,31,12,4,2019,2019-12-31,1,2020,0,0
Agency,Office of Personnel Management,null,CFO,96.02672336070195,92.69926322839919,937278,109,22652270,1384,31,12,4,2019,2019-12-31,1,2020,23589548,1493
Agency,National Labor Relations Board,null,Non-CFO,0.0,0.0,0,0,0,0,31,12,4,2019,2019-12-31,1,2020,0,0
Agency,Federal Labor Relations Authority,null,Non-CFO,0.0,0.0,0,0,0,0,31,12,4,2019,2019-12-31,1,2020,0,0
Agency,Other Agencies/Boards/Commissions,null,Non-CFO,0.0,0.0,393,1,0,0,31,12,4,2019,2019-12-31,1,2020,393,1
Agency,Consumer Product Safety Commission,null,Non-CFO,100.0,100.0,0,0,479,1,31,12,4,2019,2019-12-31,1,2020,479,1
Agency,Farm Credit Administration,null,Non-CFO,100.0,100.0,0,0,630,1,31,12,4,2019,2019-12-31,1,2020,630,1
Bureau,Department of the Treasury,Interest on Tax/Deposit of Earnings,null,0.0,0.0,0,0,0,0,31,12,4,2019,2019-12-31,1,2020,0,0
Bureau,Department of Health & Human Services,Office of the Inspector General,null,0.0,0.0,0,0,0,0,31,12,4,2019,2019-12-31,1,2020,0,0
Agency,Tennessee Valley Authority,null,Non-CFO,0.0,0.0,9694,0,0,0,31,12,4,2019,2019-12-31,1,2020,9694,0
Bureau,Legislative Branch-GAO,Government Accountability Office,null,0.0,0.0,0,0,0,0,31,12,4,2019,2019-12-31,1,2020,0,0
Bureau,Department of the Treasury,International Monetary Funds,null,0.0,0.0,0,0,0,0,31,12,4,2019,2019-12-31,1,2020,0,0
Bureau,Department of Commerce,Minority Business Development Agency,null,0.0,0.0,0,0,0,0,31,12,4,2019,2019-12-31,1,2020,0,0
Bureau,National Foundation  Arts & Humanities,National Endowment for the Humanities,null,0.0,0.0,0,0,0,0,31,12,4,2019,2019-12-31,1,2020,0,0
Bureau,Selective Service System,Selective Service System,null,0.0,0.0,0,0,0,0,31,12,4,2019,2019-12-31,1,2020,0,0
Bureau,Department of Homeland Security,Office of Health Affairs,null,0.0,0.0,0,0,0,0,31,12,4,2019,2019-12-31,1,2020,0,0
Bureau,Department of the Treasury,Treasury IG for Tax Admin,null,0.0,0.0,0,0,0,0,31,12,4,2019,2019-12-31,1,2020,0,0
Bureau,Department of Homeland Security,U.S. Secret Service,null,0.0,0.0,0,0,0,0,31,12,4,2019,2019-12-31,1,2020,0,0
Bureau,Other Agencies,National Transportation Safety Board,null,0.0,0.0,0,0,0,0,31,12,4,2019,2019-12-31,1,2020,0,0
Bureau,Other Agencies,Federal Housing Finance Agency OIG,null,0.0,0.0,0,0,0,0,31,12,4,2019,2019-12-31,1,2020,0,0
Bureau,American Battle Monuments Commission,American Battle Monuments Commission,null,0.0,0.0,0,0,0,0,31,12,4,2019,2019-12-31,1,2020,0,0
Bureau,Smithsonian Institution,Administrative Conference of the US,null,0.0,0.0,0,0,0,0,31,12,4,2019,2019-12-31,1,2020,0,0
Bureau,Department of Homeland Security,Office of Biometric Identity Management,null,0.0,0.0,0,0,0,0,31,12,4,2019,2019-12-31,1,2020,0,0
Bureau,Department of Transportation,Surface Transportation Board,null,0.0,0.0,0,0,0,0,31,12,4,2019,2019-12-31,1,2020,0,0
Bureau,Department of Labor,Bureau of Labor Statistics,null,100.0,100.0,0,0,11381,1,31,12,4,2019,2019-12-31,1,2020,11381,1
Agency,Agency for International Development,null,CFO,100.0,100.0,0,0,26725151,51,31,12,4,2019,2019-12-31,1,2020,26725151,51
Agency,Department of Labor,null,CFO,77.821123644437,47.81245740765981,31420939,19145,110249624,17540,31,12,4,2019,2019-12-31,1,2020,141670563,36685
Bureau,Funds Appropriated to the President,Executive Branch,null,0.0,0.0,0,0,0,0,31,12,4,2019,2019-12-31,1,2020,0,0
Bureau,Smithsonian Institution,Smithsonian Institution,null,0.0,0.0,0,0,0,0,31,12,4,2019,2019-12-31,1,2020,0,0
Bureau,Department of Homeland Security,Federal Law Enforcement Training Ctr.,null,0.0,0.0,0,0,0,0,31,12,4,2019,2019-12-31,1,2020,0,0
Bureau,Neighborhood Reinvestment Corporation,Neighborhood Reinvestment Corporation,null,0.0,0.0,0,0,0,0,31,12,4,2019,2019-12-31,1,2020,0,0
Agency,Small Business Administration,null,CFO,99.90830500851253,99.92900775961697,11256117,86,12264351108,121054,31,12,4,2019,2019-12-31,1,2020,12275607225,121140
Bureau,Other Agencies,Election Assistance Commission,null,0.0,0.0,0,0,0,0,31,12,4,2019,2019-12-31,1,2020,0,0
Bureau,Other Agencies/Boards/Commissions,Medicare Payment Advisory Commission,null,0.0,0.0,0,0,0,0,31,12,4,2019,2019-12-31,1,2020,0,0
Bureau,Department of the Interior,Office of Surface Mining,null,100.0,100.0,0,0,2367200,250,31,12,4,2019,2019-12-31,1,2020,2367200,250
Agency,Funds Appropriated to the President,null,Non-CFO,0.0,0.0,0,0,0,0,31,12,4,2019,2019-12-31,1,2020,0,0
Bureau,Other Agencies,Federal Housing Finance Agency,null,0.0,0.0,0,0,0,0,31,12,4,2019,2019-12-31,1,2020,0,0
Bureau,Other Agencies,National Mediation Board,null,0.0,0.0,0,0,0,0,31,12,4,2019,2019-12-31,1,2020,0,0
Bureau,Department of Transportation,St. Lawrence Seaway Development Corp.,null,100.0,100.0,0,0,4343,1,31,12,4,2019,2019-12-31,1,2020,4343,1
Bureau,Department of Transportation,Federal Highway Administration,null,100.0,100.0,0,0,6540,5,31,12,4,2019,2019-12-31,1,2020,6540,5
Bureau,Department of the Interior,Bureau of Reclamation,null,100.0,100.0,0,0,112632,91,31,12,4,2019,2019-12-31,1,2020,112632,91
Bureau,Other Agencies,James Madison Memorial Fellowship,null,0.0,0.0,221290,25,0,0,31,12,4,2019,2019-12-31,1,2020,221290,25
Bureau,National Science Foundation,National Science Foundation,null,100.0,100.0,0,0,510236,93,31,12,4,2019,2019-12-31,1,2020,510236,93
Bureau,Department of the Treasury,Comptroller of the Currency,null,99.9820874882897,91.66666666666667,200,2,1116338,22,31,12,4,2019,2019-12-31,1,2020,1116538,24
Bureau,Department of Veterans Affairs,Administration and Cemeteries,null,0.25631340795669616,0.8902077151335311,1962081,668,5042,6,31,12,4,2019,2019-12-31,1,2020,1967123,674
Bureau,Federal Communications Commission,Federal Communications Commission,null,100.0,100.0,0,0,195037325,11482,31,12,4,2019,2019-12-31,1,2020,195037325,11482
Bureau,Department of Agriculture,Agricultural Marketing Service,null,87.75179382158878,54.97787610619469,626076,407,4485497,497,31,12,4,2019,2019-12-31,1,2020,5111573,904
Bureau,Other Agencies,Consumer Financial Protection Bureau,null,0.0,0.0,5310383,65,0,0,31,12,4,2019,2019-12-31,1,2020,5310383,65
Bureau,Department of the Interior,Bureau of Indian Affairs,null,99.93547571185512,99.46957667488766,9495,157,14705894,29442,31,12,4,2019,2019-12-31,1,2020,14715389,29599
Bureau,Railroad Retirement Board,Railroad Retirement Board,null,100.0,100.0,0,0,20495013,4346,31,12,4,2019,2019-12-31,1,2020,20495013,4346
Bureau,Agency for International Development,Agency for International Development,null,100.0,100.0,0,0,26725151,51,31,12,4,2019,2019-12-31,1,2020,26725151,51
Bureau,Department of Education,Departmental Management,null,1.6945519349100417,12.438016528925619,805357653,2119,13882449,301,31,12,4,2019,2019-12-31,1,2020,819240102,2420
Bureau,Other Agencies,U.S. Institute of Peace,null,0.0,0.0,0,0,0,0,31,12,4,2019,2019-12-31,1,2020,0,0
Bureau,Department of Labor,Mine Safety and Health Administration,null,76.99996338395385,82.89611107697979,9780154,2784,32742187,13493,31,12,4,2019,2019-12-31,1,2020,42522341,16277
Bureau,Department of Health & Human Services,Food and Drug Administration,null,78.63812797018663,0.3435237205884604,9435133,325493,34732967,1122,31,12,4,2019,2019-12-31,1,2020,44168100,326615
Bureau,Department of Health & Human Services,Indian Health Services,null,54.08021608673158,5.448050014885383,22087051,3176,26012154,183,31,12,4,2019,2019-12-31,1,2020,48099205,3359
Bureau,Department of Agriculture,Forest Service,null,97.93240540096143,47.5328947368421,1265625,319,59946810,289,31,12,4,2019,2019-12-31,1,2020,61212435,608
Bureau,Department of Justice,Legal Activities,null,99.37474683242176,99.46562362274129,521960,194,82957825,36110,31,12,4,2019,2019-12-31,1,2020,83479785,36304
Bureau,Department of Health & Human Services,Health Resources and Services Admin,null,100.0,100.0,0,0,99612650,529,31,12,4,2019,2019-12-31,1,2020,99612650,529
Bureau,Commodity Futures Trading Commission,Commodity Futures Trading Commission,null,100.0,100.0,0,0,642771311,370,31,12,4,2019,2019-12-31,1,2020,642771311,370
Bureau,Department of Defense,Consolidated Report,null,48.334305703146,20.525038531217046,1211473457,1175689,1133358009,303631,31,12,4,2019,2019-12-31,1,2020,2344831466,1479320
Bureau,Department of Housing and Urban Development,"Policy, Development and Research",null,0.0,0.0,0,0,0,0,31,12,4,2019,2019-12-31,1,2020,0,0
Bureau,Department of Commerce,Economic and Statistical Analysis,null,0.0,0.0,0,0,0,0,31,12,4,2019,2019-12-31,1,2020,0,0
Bureau,Corp. for National and Community Service,Corp. for National and Community Service,null,76.87566511617541,12.035661218424963,1079092,1184,3587386,162,31,12,4,2019,2019-12-31,1,2020,4666478,1346
Bureau,Securities & Exchange Commission,Securities and Exchange Commission,null,100.0,100.0,0,0,2331996317,1122,31,12,4,2019,2019-12-31,1,2020,2331996317,1122
Bureau,Department of Health & Human Services,Centers for Medicare & Medicaid Services,null,99.25204015006152,99.25707168251972,69274304,8601,9192493424,1149115,31,12,4,2019,2019-12-31,1,2020,9261767728,1157716
Bureau,Department of Education,Federal Student Aid,null,85.33890862085937,82.22007388807948,25486230835,5217650,148349605638,24128085,31,12,4,2019,2019-12-31,1,2020,173835836473,29345735
Agency,American Battle Monuments Commission,null,Non-CFO,0.0,0.0,0,0,0,0,31,12,4,2019,2019-12-31,1,2020,0,0
Bureau,Department of the Treasury,Financial Crimes Enforcement Network,null,100.0,100.0,0,0,1544945,3,31,12,4,2019,2019-12-31,1,2020,1544945,3
Bureau,Department of Transportation,Federal Aviation Administration,null,99.33517482095007,97.92899408284023,14636,7,2186845,331,31,12,4,2019,2019-12-31,1,2020,2201481,338
Agency,Federal Maritime Commission,null,Non-CFO,99.87364080736873,50.0,494,5,390455,5,31,12,4,2019,2019-12-31,1,2020,390949,10
Agency,Federal Election Commission,null,Non-CFO,71.87360720266436,98.93617021276596,195000,1,498299,93,31,12,4,2019,2019-12-31,1,2020,693299,94
Agency,U.S. Postal Service,null,Non-CFO,60.50036288978971,88.95288535804922,26774846,5006,41010197,40309,31,12,4,2019,2019-12-31,1,2020,67785043,45315
Agency,Commodity Futures Trading Commission,null,Non-CFO,100.0,100.0,0,0,642771311,370,31,12,4,2019,2019-12-31,1,2020,642771311,370
Agency,Securities & Exchange Commission,null,Non-CFO,100.0,100.0,0,0,2331996317,1122,31,12,4,2019,2019-12-31,1,2020,2331996317,1122
Bureau,Securities & Exchange Commission,SEC Enforcement,null,0.0,0.0,0,0,0,0,31,12,4,2019,2019-12-31,1,2020,0,0
Bureau,Department of Commerce,Office of the Inspector General,null,0.0,0.0,0,0,0,0,31,12,4,2019,2019-12-31,1,2020,0,0
Bureau,Legislative Branch-Office of Tech.,Open World Leadership,null,0.0,0.0,0,0,0,0,31,12,4,2019,2019-12-31,1,2020,0,0
Bureau,Funds Appropriated to the President,Trade and Development Agency,null,0.0,0.0,0,0,0,0,31,12,4,2019,2019-12-31,1,2020,0,0
Bureau,Funds Appropriated to the President,African Development Foundation,null,0.0,0.0,0,0,0,0,31,12,4,2019,2019-12-31,1,2020,0,0
Bureau,Department of Labor,Departmental Management,null,0.0,0.0,0,0,0,0,31,12,4,2019,2019-12-31,1,2020,0,0
Bureau,Department of the Treasury,Office of Sec International Affairs,null,0.0,0.0,0,0,0,0,31,12,4,2019,2019-12-31,1,2020,0,0
Bureau,Department of the Treasury,Treasury Forfeiture Fund,null,0.0,0.0,0,0,0,0,31,12,4,2019,2019-12-31,1,2020,0,0
Bureau,Overseas Private Investment Corp Accts,Overseas Private Investment Corp Accts,null,0.0,0.0,0,0,0,0,31,12,4,2019,2019-12-31,1,2020,0,0
Bureau,Other Agencies,Comm. for Purchase from Blind/Handic.,null,0.0,0.0,0,0,0,0,31,12,4,2019,2019-12-31,1,2020,0,0
Bureau,Other Agencies,Commission On Fine Arts,null,0.0,0.0,0,0,0,0,31,12,4,2019,2019-12-31,1,2020,0,0
Bureau,Other Agencies,Gulf Coast Ecosystem Restoration Council,null,0.0,0.0,0,0,0,0,31,12,4,2019,2019-12-31,1,2020,0,0
Bureau,Department of the Treasury,Treasury Franchise Fund,null,0.0,0.0,0,0,0,0,31,12,4,2019,2019-12-31,1,2020,0,0
Bureau,National Archives & Records Admin,Nat'l Archives & Records Administration,null,98.44724507547271,96.93877551020408,2044,3,129593,95,31,12,4,2019,2019-12-31,1,2020,131637,98
Bureau,Department of Justice,Federal Prison Industries,null,100.0,100.0,0,0,1043089,183,31,12,4,2019,2019-12-31,1,2020,1043089,183
Agency,National Archives & Records Admin,null,Non-CFO,98.44724507547271,96.93877551020408,2044,3,129593,95,31,12,4,2019,2019-12-31,1,2020,131637,98
Bureau,U.S. Postal Service,U.S. Postal Service,null,60.50036288978971,88.95288535804922,26774846,5006,41010197,40309,31,12,4,2019,2019-12-31,1,2020,67785043,45315
Bureau,Department of Veterans Affairs,Life Insurance,null,100.0,100.0,0,0,581240,110,31,12,4,2019,2019-12-31,1,2020,581240,110
Bureau,Legislative Branch-Office of Tech.,Medicaid & CHIP Payment & Access Comm.,null,0.0,0.0,0,0,0,0,31,12,4,2019,2019-12-31,1,2020,0,0
Bureau,The Judiciary,Administrative Office of the U.S. Courts,null,98.91812827456235,62.42424242424242,11642,124,1064456,206,31,12,4,2019,2019-12-31,1,2020,1076098,330
Bureau,Department of Justice,Federal Bureau of Investigation,null,100.0,100.0,0,0,217857,59,31,12,4,2019,2019-12-31,1,2020,217857,59
Bureau,Merit Systems Protection Board,Merit Systems Protection Board,null,100.0,100.0,0,0,143,1,31,12,4,2019,2019-12-31,1,2020,143,1
Bureau,Department of the Interior,National Park Service,null,100.0,100.0,0,0,6945634,1935,31,12,4,2019,2019-12-31,1,2020,6945634,1935
Agency,Department of Health & Human Services,null,CFO,98.71319935282554,77.34904561376682,122444295,337740,9392960851,1153323,31,12,4,2019,2019-12-31,1,2020,9515405146,1491063
Agency,Neighborhood Reinvestment Corporation,null,Non-CFO,0.0,0.0,0,0,0,0,31,12,4,2019,2019-12-31,1,2020,0,0
Agency,Pension Benefit Guaranty Corp,null,Non-CFO,100.0,100.0,0,0,1328482,1523,31,12,4,2019,2019-12-31,1,2020,1328482,1523
Bureau,Department of the Treasury,Community Dev Financial Inst Fund,null,100.0,100.0,0,0,3140760,7,31,12,4,2019,2019-12-31,1,2020,3140760,7
Agency,Nuclear Regulatory Commission,null,CFO,100.0,100.0,0,0,1769362,257,31,12,4,2019,2019-12-31,1,2020,1769362,257
Agency,Department of Education,null,CFO,84.9465649647407,82.21431977580873,26291588488,5219769,148363488087,24128386,31,12,4,2019,2019-12-31,1,2020,174655076575,29348155
Bureau,Other Agencies/Boards/Commissions,U.S.-China Security Review Commission,null,0.0,0.0,0,0,0,0,31,12,4,2019,2019-12-31,1,2020,0,0
Bureau,Department of the Treasury,U.S. Mint,null,100.0,100.0,0,0,45799,19,31,12,4,2019,2019-12-31,1,2020,45799,19
Agency,Legis Branch-Library of Congress,null,Non-CFO,0.0,0.0,0,0,0,0,31,12,4,2019,2019-12-31,1,2020,0,0
Bureau,Funds Appropriated to the President,Peace Corps,null,0.0,0.0,0,0,0,0,31,12,4,2019,2019-12-31,1,2020,0,0
Bureau,Department of Agriculture,Federal Crop Insurance Corporation,null,100.0,100.0,0,0,57112,410,31,12,4,2019,2019-12-31,1,2020,57112,410
Bureau,Department of the Treasury,Bureau of Engraving and Printing,null,100.0,100.0,0,0,84528,1,31,12,4,2019,2019-12-31,1,2020,84528,1
Bureau,Department of Commerce,Nat'l Telecomm & Information Admin.,null,100.0,100.0,0,0,297608,2,31,12,4,2019,2019-12-31,1,2020,297608,2
Agency,Selective Service System,null,Non-CFO,0.0,0.0,0,0,0,0,31,12,4,2019,2019-12-31,1,2020,0,0
Bureau,Funds Appropriated to the President,Defense Security Assistance Agency,null,0.0,0.0,0,0,0,0,31,12,4,2019,2019-12-31,1,2020,0,0
Bureau,Department of Housing and Urban Development,Management and Administration,null,0.0,0.0,0,0,0,0,31,12,4,2019,2019-12-31,1,2020,0,0
Bureau,Department of Homeland Security,Office of the Inspector General DHS,null,100.0,100.0,0,0,98,1,31,12,4,2019,2019-12-31,1,2020,98,1
Bureau,Other Agencies,Federal Mine Safety & Health Review Comm,null,0.0,0.0,0,0,0,0,31,12,4,2019,2019-12-31,1,2020,0,0
Bureau,Other Agencies,Millennium Challenge Corporation,null,0.0,0.0,0,0,0,0,31,12,4,2019,2019-12-31,1,2020,0,0
Agency,Federal Deposit Insurance Corporation,null,Non-CFO,0.0,0.0,0,0,0,0,31,12,4,2019,2019-12-31,1,2020,0,0
Agency,Occupational Safety & Health Rev Comm,null,Non-CFO,0.0,0.0,0,0,0,0,31,12,4,2019,2019-12-31,1,2020,0,0
Bureau,Federal Labor Relations Authority,Federal Labor Relations Authority,null,0.0,0.0,0,0,0,0,31,12,4,2019,2019-12-31,1,2020,0,0
Bureau,Farm Credit Administration,Farm Credit System Insurance Corporation,null,0.0,0.0,0,0,0,0,31,12,4,2019,2019-12-31,1,2020,0,0
Bureau,Office of Government Ethics,Office of Government Ethics,null,0.0,0.0,0,0,0,0,31,12,4,2019,2019-12-31,1,2020,0,0
Bureau,Department of the Interior,Geological Survey,null,100.0,100.0,0,0,152493,171,31,12,4,2019,2019-12-31,1,2020,152493,171
Agency,Federal Communications Commission,null,Non-CFO,100.0,100.0,0,0,195037325,11482,31,12,4,2019,2019-12-31,1,2020,195037325,11482
Agency,Federal Trade Commission,null,Non-CFO,100.0,100.0,0,0,483076197,62,31,12,4,2019,2019-12-31,1,2020,483076197,62
Bureau,Department of Housing and Urban Development,Housing Programs,null,99.99733313662475,99.98428908091124,4419,1,165695858,6364,31,12,4,2019,2019-12-31,1,2020,165700277,6365
Agency,Merit Systems Protection Board,null,Non-CFO,100.0,100.0,0,0,143,1,31,12,4,2019,2019-12-31,1,2020,143,1
Bureau,Department of Homeland Security,Bureau of Customs & Border Protection,null,100.0,100.0,0,0,9528980,639,31,12,4,2019,2019-12-31,1,2020,9528980,639
Bureau,Department of Health & Human Services,National Institutes of Health,null,28.045637440814527,23.80952380952381,14796816,336,5767352,105,31,12,4,2019,2019-12-31,1,2020,20564168,441
Bureau,Department of Education,Office of Postsecondary Education,null,0.0,0.0,0,0,0,0,31,12,4,2019,2019-12-31,1,2020,0,0
Bureau,Presidio Trust Corporation,Presidio Trust Corporation,null,94.36710080255567,83.52941176470588,80687,14,1351737,71,31,12,4,2019,2019-12-31,1,2020,1432424,85
Bureau,Department of Labor,Employment and Training Administration,null,54.067166166574935,10.81081081081081,2690558,33,3167034,4,31,12,4,2019,2019-12-31,1,2020,5857592,37
Bureau,Department of Agriculture,Rural Development,null,99.99986312018618,99.99414297009986,984,2,718877843,34145,31,12,4,2019,2019-12-31,1,2020,718878827,34147
Bureau,Federal Deposit Insurance Corporation,Federal Deposit Insurance Corporation,null,0.0,0.0,0,0,0,0,31,12,4,2019,2019-12-31,1,2020,0,0
Bureau,General Services Administration,General Services Administration,null,71.18051971026695,93.31505693800085,5468850,317,13507377,4425,31,12,4,2019,2019-12-31,1,2020,18976227,4742
Agency,National Aeronautics and Space Administration,null,CFO,100.0,99.2063492063492,0,1,7433722,125,31,12,4,2019,2019-12-31,1,2020,7433722,126
Bureau,Department of Labor,Occupational Safety and Health Admin,null,80.63822991102326,88.31734960767218,1232318,134,5132379,1013,31,12,4,2019,2019-12-31,1,2020,6364697,1147
Agency,Federal Mediation/Conciliation Service,null,Non-CFO,0.0,0.0,0,0,0,0,31,12,4,2019,2019-12-31,1,2020,0,0
Bureau,Smithsonian Institution,National Gallery of Art,null,0.0,0.0,0,0,0,0,31,12,4,2019,2019-12-31,1,2020,0,0
Agency,Office of Special Counsel,null,Non-CFO,0.0,0.0,0,0,0,0,31,12,4,2019,2019-12-31,1,2020,0,0
Agency,U.S. Court of Appeals / Veterans Claims,null,Non-CFO,100.0,100.0,0,0,4164,4,31,12,4,2019,2019-12-31,1,2020,4164,4
Bureau,Department of Homeland Security,Emergency Preparedness & Resp,null,100.0,100.0,0,0,258351059,43221,31,12,4,2019,2019-12-31,1,2020,258351059,43221
Bureau,Small Business Administration,Small Business Administration,null,99.90830500851253,99.92900775961697,11256117,86,12264351108,121054,31,12,4,2019,2019-12-31,1,2020,12275607225,121140
Agency,Armed Forces Retirement Home,null,Non-CFO,100.0,100.0,0,0,82575,107,31,12,4,2019,2019-12-31,1,2020,82575,107
Bureau,Department of State,Civil Monetary Penalties,null,0.0,0.0,0,0,0,0,31,12,4,2019,2019-12-31,1,2020,0,0
Bureau,National Labor Relations Board,National Labor Relations Board,null,0.0,0.0,0,0,0,0,31,12,4,2019,2019-12-31,1,2020,0,0
Bureau,Other Agencies,Delta Regional Authority,null,0.0,0.0,0,0,0,0,31,12,4,2019,2019-12-31,1,2020,0,0
Bureau,Department of Energy,Energy Consolidated Reports,null,100.0,100.0,0,0,13397203,69,31,12,4,2019,2019-12-31,1,2020,13397203,69
Bureau,Funds Appropriated to the President,Inter-American Foundation,null,0.0,0.0,0,0,0,0,31,12,4,2019,2019-12-31,1,2020,0,0
Bureau,Department of Commerce,National Technical Information Service,null,0.0,0.0,0,0,0,0,31,12,4,2019,2019-12-31,1,2020,0,0
Bureau,Office of Special Counsel,Office of Special Counsel,null,0.0,0.0,0,0,0,0,31,12,4,2019,2019-12-31,1,2020,0,0
Bureau,Department of Homeland Security,Science and Technology,null,0.0,0.0,0,0,0,0,31,12,4,2019,2019-12-31,1,2020,0,0
Bureau,Federal Mediation/Conciliation Service,Federal Mediation/Conciliation Service,null,0.0,0.0,0,0,0,0,31,12,4,2019,2019-12-31,1,2020,0,0
Bureau,Other Agencies,National Council on Disability,null,0.0,0.0,0,0,0,0,31,12,4,2019,2019-12-31,1,2020,0,0
Bureau,Other Agencies,Archit.&Trans. Barriers Compliance Bd,null,0.0,0.0,0,0,0,0,31,12,4,2019,2019-12-31,1,2020,0,0
Bureau,Other Agencies,Surface Transportation Board,null,0.0,0.0,0,0,0,0,31,12,4,2019,2019-12-31,1,2020,0,0
Bureau,Department of Justice,Drug Enforcement Administration,null,100.0,100.0,0,0,330452,21,31,12,4,2019,2019-12-31,1,2020,330452,21
Bureau,Federal Maritime Commission,Salaries and Expenses,null,99.87364080736873,50.0,494,5,390455,5,31,12,4,2019,2019-12-31,1,2020,390949,10
Bureau,Department of Transportation,Office of the Secretary,null,100.0,100.0,0,0,968738,17,31,12,4,2019,2019-12-31,1,2020,968738,17
Bureau,Department of Transportation,Research Innovative Technology Admin,null,100.0,100.0,0,0,3673,4,31,12,4,2019,2019-12-31,1,2020,3673,4
Bureau,Department of Energy,Bonneville Power Administration,null,100.0,100.0,0,0,1097032,40,31,12,4,2019,2019-12-31,1,2020,1097032,40
Bureau,Department of the Treasury,Departmental Offices,null,79.4706729008386,93.6229852838122,5509901,91,21329269,1336,31,12,4,2019,2019-12-31,1,2020,26839170,1427
Agency,Department of the Interior,null,CFO,99.97803859715971,99.52106403099356,9495,157,43225448,32624,31,12,4,2019,2019-12-31,1,2020,43234943,32781
Bureau,Department of State,Department of State,null,96.22024615215089,98.55309855309855,570777,106,14530127,7220,31,12,4,2019,2019-12-31,1,2020,15100904,7326
Bureau,Department of Agriculture,U.S. Department of Agriculture,null,86.70256154112586,64.65712132629993,3890618,938,25367784,1716,31,12,4,2019,2019-12-31,1,2020,29258402,2654
Bureau,Department of Transportation,Federal Motor Carrier Safety Admin,null,100.0,100.0,0,0,56016741,6467,31,12,4,2019,2019-12-31,1,2020,56016741,6467
Bureau,Department of Veterans Affairs,Housing Credit Assistance,null,32.08985045907845,57.69230769230769,992443,22,468963,30,31,12,4,2019,2019-12-31,1,2020,1461406,52
Agency,Department of the Treasury,null,CFO,88.16546940878479,98.49020237712817,5510850,94,41055002,6132,31,12,4,2019,2019-12-31,1,2020,46565852,6226
Agency,Legislative Branch - U.S. House/Senate,null,Non-CFO,12.5098105963897,9.90566037735849,185047,191,26459,21,31,12,4,2019,2019-12-31,1,2020,211506,212
Bureau,Farm Credit Administration,Farm Credit Administration,null,100.0,100.0,0,0,630,1,31,12,4,2019,2019-12-31,1,2020,630,1
Agency,Department of Transportation,null,CFO,99.97583211477004,99.89835922753014,14636,7,60545069,6880,31,12,4,2019,2019-12-31,1,2020,60559705,6887
Bureau,Equal Employment Opportunity Commission,Equal Employment Opportunity Commission,null,100.0,100.0,0,0,43957,30,31,12,4,2019,2019-12-31,1,2020,43957,30
Bureau,Legislative Branch - U.S. House/Senate,U.S. House of Representatives,null,12.5098105963897,9.90566037735849,185047,191,26459,21,31,12,4,2019,2019-12-31,1,2020,211506,212
Bureau,Department of Veterans Affairs,Veterans Benefits,null,99.7610003732911,98.6272662291247,1289233,1690,538139643,121422,31,12,4,2019,2019-12-31,1,2020,539428876,123112
Bureau,Nuclear Regulatory Commission,Nuclear Regulatory Commission,null,100.0,100.0,0,0,1769362,257,31,12,4,2019,2019-12-31,1,2020,1769362,257
Agency,Department of Justice,null,CFO,99.39104204588577,99.46852003270646,523424,195,85430622,36495,31,12,4,2019,2019-12-31,1,2020,85954046,36690
Bureau,Legislative Branch-CBO,Congressional Budget Office,null,0.0,0.0,0,0,0,0,31,12,4,2019,2019-12-31,1,2020,0,0
Bureau,Department of Commerce,International Trade Administration,null,0.0,0.0,0,0,0,0,31,12,4,2019,2019-12-31,1,2020,0,0
Bureau,Federal Election Commission,Federal Election Commission,null,71.87360720266436,98.93617021276596,195000,1,498299,93,31,12,4,2019,2019-12-31,1,2020,693299,94
Bureau,Department of Commerce,Bureau of Industry and Security,null,100.0,100.0,0,0,2021957,15,31,12,4,2019,2019-12-31,1,2020,2021957,15
Bureau,National Aeronautics and Space Administration,National Aeronautics and Space Admin,null,100.0,99.2063492063492,0,1,7433722,125,31,12,4,2019,2019-12-31,1,2020,7433722,126
Bureau,Department of Health & Human Services,Program Support Center,null,100.0,100.0,0,0,5572574,551,31,12,4,2019,2019-12-31,1,2020,5572574,551
Bureau,Office of Personnel Management,Office of Personnel Management,null,96.02672336070195,92.69926322839919,937278,109,22652270,1384,31,12,4,2019,2019-12-31,1,2020,23589548,1493
Agency,Department of Housing and Urban Development,null,CFO,99.99733314570202,99.98429154885328,4419,1,165696422,6365,31,12,4,2019,2019-12-31,1,2020,165700841,6366
Bureau,Occupational Safety & Health Rev Comm,Occupational Safety & Health Rev Comm,null,0.0,0.0,0,0,0,0,31,12,4,2019,2019-12-31,1,2020,0,0
Bureau,Department of the Interior,Office of Natural Resources Revenue,null,100.0,100.0,0,0,2654844,334,31,12,4,2019,2019-12-31,1,2020,2654844,334
Agency,The Judiciary,null,Non-CFO,98.91812827456235,62.42424242424242,11642,124,1064456,206,31,12,4,2019,2019-12-31,1,2020,1076098,330
Bureau,Department of Labor,Employment Standards Administration,null,74.68530311133338,14.030896639592292,17717909,16194,52272694,2643,31,12,4,2019,2019-12-31,1,2020,69990603,18837
Agency,Department of Agriculture,null,CFO,99.54791654662463,97.25223185405615,6434206,1699,1416799923,60133,31,12,4,2019,2019-12-31,1,2020,1423234129,61832
Bureau,Consumer Product Safety Commission,Consumer Product Safety Commission,null,100.0,100.0,0,0,479,1,31,12,4,2019,2019-12-31,1,2020,479,1
Bureau,Department of Homeland Security,Transportation Safety Administration,null,100.0,100.0,0,0,16108915,7022,31,12,4,2019,2019-12-31,1,2020,16108915,7022
Agency,Presidio Trust Corporation,null,Non-CFO,94.36710080255567,83.52941176470588,80687,14,1351737,71,31,12,4,2019,2019-12-31,1,2020,1432424,85
Bureau,Department of Housing and Urban Development,Public and Indian Housing Programs,null,100.0,100.0,0,0,564,1,31,12,4,2019,2019-12-31,1,2020,564,1
Bureau,Department of the Treasury,Office of Financial Research,null,0.0,0.0,0,0,0,0,31,12,4,2019,2019-12-31,1,2020,0,0
Agency,Social Security Administration,null,CFO,53.831293039956506,31.058074436896117,2463382241,1146851,2872227966,516652,31,12,4,2019,2019-12-31,1,2020,5335610207,1663503
Agency,Corp. for National and Community Service,null,Non-CFO,76.87566511617541,12.035661218424963,1079092,1184,3587386,162,31,12,4,2019,2019-12-31,1,2020,4666478,1346
Bureau,Department of Labor,Employee Benefit Security Administration,null,100.0,100.0,0,0,16923949,386,31,12,4,2019,2019-12-31,1,2020,16923949,386
Agency,Department of Defense,null,CFO,48.334305703146,20.525038531217046,1211473457,1175689,1133358009,303631,31,12,4,2019,2019-12-31,1,2020,2344831466,1479320
Agency,Legislative Branch-CBO,null,Non-CFO,0.0,0.0,0,0,0,0,31,12,4,2019,2019-12-31,1,2020,0,0
Bureau,Department of Commerce,Patent and Trademark Office,null,100.0,100.0,0,0,370790,506,31,12,4,2019,2019-12-31,1,2020,370790,506
Bureau,Department of Agriculture,Food and Nutrition Service,null,6.883918074733178,11.428571428571429,646315,31,47781,4,31,12,4,2019,2019-12-31,1,2020,694096,35
Bureau,U.S. Court of Appeals / Veterans Claims,U.S. Court of Appeals / Veterans Claims,null,100.0,100.0,0,0,4164,4,31,12,4,2019,2019-12-31,1,2020,4164,4
Bureau,Department of Justice,Federal Prison System,null,100.0,100.0,0,0,841391,117,31,12,4,2019,2019-12-31,1,2020,841391,117
Agency,Legislative Branch-GAO,null,Non-CFO,0.0,0.0,0,0,0,0,31,12,4,2019,2019-12-31,1,2020,0,0
Bureau,Department of Health & Human Services,Substance Abuse & Mental Health Admin.,null,100.0,100.0,0,0,967987,15,31,12,4,2019,2019-12-31,1,2020,967987,15
Agency,Legislative Branch-Office of Tech.,null,Non-CFO,0.0,0.0,0,0,0,0,31,12,4,2019,2019-12-31,1,2020,0,0
Bureau,Legislative Branch-GPO,Government Publishing Office,null,100.0,100.0,0,0,84359,27,31,12,4,2019,2019-12-31,1,2020,84359,27
Agency,Equal Employment Opportunity Commission,null,Non-CFO,100.0,100.0,0,0,43957,30,31,12,4,2019,2019-12-31,1,2020,43957,30
Agency,Legislative Branch-GPO,null,Non-CFO,100.0,100.0,0,0,84359,27,31,12,4,2019,2019-12-31,1,2020,84359,27
Bureau,Department of Homeland Security,Domestic Nuclear Detection Office,null,0.0,0.0,0,0,0,0,31,12,4,2019,2019-12-31,1,2020,0,0
Agency,Department of State,null,CFO,96.8120940219942,99.5835952231301,570777,106,17333672,25350,31,12,4,2019,2019-12-31,1,2020,17904449,25456
Bureau,Other Agencies,U.S.  Agency of Global Media,null,100.0,100.0,0,0,4930,2,31,12,4,2019,2019-12-31,1,2020,4930,2
Bureau,Department of Homeland Security,Info Analysis Infrastructure Prot-NPPD,null,0.0,0.0,0,0,0,0,31,12,4,2019,2019-12-31,1,2020,0,0
Bureau,Department of Transportation,Federal Railroad Administration,null,100.0,100.0,0,0,207383,18,31,12,4,2019,2019-12-31,1,2020,207383,18
Bureau,Social Security Administration,Social Security Administration,null,53.831293039956506,31.058074436896117,2463382241,1146851,2872227966,516652,31,12,4,2019,2019-12-31,1,2020,5335610207,1663503
Bureau,Other Agencies,U.S. Inst. for Env. Conflict Resolution,null,0.0,0.0,4178,1,0,0,31,12,4,2019,2019-12-31,1,2020,4178,1
Agency,National Foundation  Arts & Humanities,null,Non-CFO,0.0,0.0,0,0,0,0,31,12,4,2019,2019-12-31,1,2020,0,0
Bureau,Department of Homeland Security,Management Headquarters,null,100.0,100.0,0,0,191,1,31,12,4,2019,2019-12-31,1,2020,191,1
Agency,Office of Compliance,null,Non-CFO,0.0,0.0,0,0,0,0,31,12,4,2019,2019-12-31,1,2020,0,0
Bureau,Other Agencies,National Capital Planning Commission,null,0.0,0.0,0,0,0,0,31,12,4,2019,2019-12-31,1,2020,0,0
Bureau,Department of Agriculture,Farm Service Agency,null,100.0,100.0,0,0,473793050,10341,31,12,4,2019,2019-12-31,1,2020,473793050,10341
Bureau,Department of Justice,General Administration,null,0.0,0.0,0,0,0,0,31,12,4,2019,2019-12-31,1,2020,0,0
Bureau,Export - Import  Bank,Export-Import Bank,null,0.0,0.0,0,0,0,0,31,12,4,2019,2019-12-31,1,2020,0,0
Bureau,Tennessee Valley Authority,Tennessee Valley Authority,null,0.0,0.0,9694,0,0,0,31,12,4,2019,2019-12-31,1,2020,9694,0
Agency,Department of Homeland Security,null,CFO,100.0,100.0,0,0,372187403,64065,31,12,4,2019,2019-12-31,1,2020,372187403,64065
Agency,National Credit Union Administration,null,Non-CFO,0.0,0.0,0,0,0,0,31,12,4,2019,2019-12-31,1,2020,0,0
Agency,Railroad Retirement Board,null,Non-CFO,100.0,100.0,0,0,20495013,4346,31,12,4,2019,2019-12-31,1,2020,20495013,4346
Bureau,Department of the Treasury,Office of the Secretary,null,0.0,0.0,0,0,0,0,31,12,4,2019,2019-12-31,1,2020,0,0
Bureau,Other Agencies,District of Columbia Government,null,0.0,0.0,0,0,0,0,31,12,4,2019,2019-12-31,1,2020,0,0
Agency,Department of Veterans Affairs,null,CFO,92.57760470867305,98.85681230306773,88134556,106242,1099279379,9187245,31,12,4,2019,2019-12-31,1,2020,1187413935,9293487
Bureau,Federal Trade Commission,Federal Trade Commission,null,100.0,100.0,0,0,483076197,62,31,12,4,2019,2019-12-31,1,2020,483076197,62
Bureau,Department of the Treasury,Spec Insp Gen-Troubled Asset Rel Prog,null,100.0,100.0,0,0,3916,1,31,12,4,2019,2019-12-31,1,2020,3916,1
Bureau,Office of Compliance,Office of Compliance,null,0.0,0.0,0,0,0,0,31,12,4,2019,2019-12-31,1,2020,0,0
Bureau,Smithsonian Institution,JFK Center for the Performing Arts,null,0.0,0.0,1065,2,0,0,31,12,4,2019,2019-12-31,1,2020,1065,2
Agency,General Services Administration,null,CFO,71.18051971026695,93.31505693800085,5468850,317,13507377,4425,31,12,4,2019,2019-12-31,1,2020,18976227,4742
Bureau,Department of the Treasury,Internal Revenue Service,null,100.0,100.0,0,0,245803,122,31,12,4,2019,2019-12-31,1,2020,245803,122
Agency,Office of Government Ethics,null,Non-CFO,0.0,0.0,0,0,0,0,31,12,4,2019,2019-12-31,1,2020,0,0
Agency,Other Agencies,null,Non-CFO,0.08889589317202004,2.0202020202020203,5540883,97,4930,2,31,12,4,2019,2019-12-31,1,2020,5545813,99
Bureau,Department of the Interior,Bureau of Safety and Environmental Enf.,null,100.0,100.0,0,0,14571,5,31,12,4,2019,2019-12-31,1,2020,14571,5
Bureau,Department of Transportation,National Highway Traffic Safety Admin.,null,100.0,100.0,0,0,18588,5,31,12,4,2019,2019-12-31,1,2020,18588,5
Bureau,Other Agencies,Morris K. Udall Scholarship,null,0.0,0.0,982,1,0,0,31,12,4,2019,2019-12-31,1,2020,982,1
Bureau,Department of Agriculture,Food Safety and Inspection Service,null,99.53586711312987,99.87562189054727,4588,2,983922,1606,31,12,4,2019,2019-12-31,1,2020,988510,1608
Bureau,Department of Homeland Security,U.S. Coast Guard,null,100.0,100.0,0,0,77101186,11517,31,12,4,2019,2019-12-31,1,2020,77101186,11517
Bureau,Department of the Interior,Bureau of Land Management,null,100.0,100.0,0,0,15627509,280,31,12,4,2019,2019-12-31,1,2020,15627509,280
Bureau,Other Agencies,Chemical Safety Board,null,0.0,0.0,0,0,0,0,31,12,4,2019,2019-12-31,1,2020,0,0
Bureau,Department of the Treasury,U.S. Treasury IG Office,null,0.0,0.0,749,1,0,0,31,12,4,2019,2019-12-31,1,2020,749,1
Bureau,Department of Justice,Bureau of ATF and Explosives,null,100.0,100.0,0,0,20885,4,31,12,4,2019,2019-12-31,1,2020,20885,4
Bureau,Department of Health & Human Services,Administration for Community Living,null,0.0,0.0,0,0,0,0,31,12,4,2019,2019-12-31,1,2020,0,0
Bureau,Other Agencies,Advisory Council on Hist. Preservation,null,0.0,0.0,0,0,0,0,31,12,4,2019,2019-12-31,1,2020,0,0
Bureau,Environmental Protection Agency,Environmental Protection Agency,null,100.0,100.0,0,0,16066763,196,31,12,4,2019,2019-12-31,1,2020,16066763,196
Bureau,Department of Commerce,General Administration,null,100.0,100.0,0,0,4660,1,31,12,4,2019,2019-12-31,1,2020,4660,1
Bureau,Department of the Interior,Office of the Secretary,null,100.0,100.0,0,0,37582,25,31,12,4,2019,2019-12-31,1,2020,37582,25
Bureau,Department of Transportation,Federal Transit Administration,null,100.0,100.0,0,0,784441,2,31,12,4,2019,2019-12-31,1,2020,784441,2
Bureau,Department of Homeland Security,Citizenship and Immigration Services,null,100.0,100.0,0,0,999615,1234,31,12,4,2019,2019-12-31,1,2020,999615,1234
Bureau,Department of Commerce,Economic Development Administration,null,100.0,100.0,0,0,5113160,9,31,12,4,2019,2019-12-31,1,2020,5113160,9
Bureau,National Foundation  Arts & Humanities,National Endowment for the Arts,null,0.0,0.0,0,0,0,0,31,12,4,2019,2019-12-31,1,2020,0,0
Bureau,Legis Branch-Library of Congress,Library of Congress,null,0.0,0.0,0,0,0,0,31,12,4,2019,2019-12-31,1,2020,0,0
Bureau,Department of Health & Human Services,Centers for Disease Control,null,1.8438930445181727,8.843537414965986,6850991,134,128698,13,31,12,4,2019,2019-12-31,1,2020,6979689,147
Bureau,Department of the Interior,"Bureau of Ocean Energy Mgmt., Reg & Enf",null,0.0,0.0,0,0,0,0,31,12,4,2019,2019-12-31,1,2020,0,0
Bureau,Other Agencies,Council of Insps. Gen. of Intg. & Effy.,null,0.0,0.0,4050,5,0,0,31,12,4,2019,2019-12-31,1,2020,4050,5
Bureau,Department of Justice,U.S. Marshals Service,null,0.0,0.0,1464,1,0,0,31,12,4,2019,2019-12-31,1,2020,1464,1
Bureau,Department of Homeland Security,Immigration and Customs Enforcement,null,100.0,100.0,0,0,10097359,430,31,12,4,2019,2019-12-31,1,2020,10097359,430
Bureau,Department of Commerce,Bureau of the Census,null,100.0,100.0,0,0,402879,258,31,12,4,2019,2019-12-31,1,2020,402879,258
Bureau,Department of Transportation,Maritime Administration,null,100.0,100.0,0,0,5300,6,31,12,4,2019,2019-12-31,1,2020,5300,6
Bureau,Department of Commerce,NOAA,null,100.0,100.0,0,0,13968693,603,31,12,4,2019,2019-12-31,1,2020,13968693,603
Bureau,Department of the Treasury,D.C. Pension Program,null,100.0,100.0,0,0,350002,19,31,12,4,2019,2019-12-31,1,2020,350002,19
Bureau,Department of the Treasury,Tobacco Tax and Trade,null,100.0,100.0,0,0,1000,1,31,12,4,2019,2019-12-31,1,2020,1000,1
Bureau,Other Agencies,Architect of the Capitol,null,0.0,0.0,0,0,0,0,31,12,4,2019,2019-12-31,1,2020,0,0
Bureau,Department of the Treasury,Bureau of the Fiscal Service,null,100.0,100.0,0,0,13192642,4601,31,12,4,2019,2019-12-31,1,2020,13192642,4601
Bureau,Department of the Interior,Fish and Wildlife Service,null,100.0,100.0,0,0,607089,91,31,12,4,2019,2019-12-31,1,2020,607089,91
Bureau,Department of Commerce,Nat'l Institute of Standards& Technology,null,100.0,100.0,0,0,670005,5,31,12,4,2019,2019-12-31,1,2020,670005,5
Bureau,Department of State,Passport NSF,null,100.0,100.0,0,0,2803545,18130,31,12,4,2019,2019-12-31,1,2020,2803545,18130
Bureau,Department of Justice,Office of Justice Assistance Programs,null,100.0,100.0,0,0,19123,1,31,12,4,2019,2019-12-31,1,2020,19123,1
Bureau,Pension Benefit Guaranty Corp,Pension Benefit Guaranty Corporation,null,100.0,100.0,0,0,1328482,1523,31,12,4,2019,2019-12-31,1,2020,1328482,1523
Bureau,Department of Health & Human Services,Administration for Children and Families,null,100.0,100.0,0,0,27666355,1677,31,12,4,2019,2019-12-31,1,2020,27666355,1677
Bureau,Department of Veterans Affairs,Medical and Construction,null,86.97297857500091,98.8673149217207,83890799,103862,560084491,9065677,31,12,4,2019,2019-12-31,1,2020,643975290,9169539
Agency,National Science Foundation,null,CFO,100.0,100.0,0,0,510236,93,31,12,4,2019,2019-12-31,1,2020,510236,93
Bureau,Department of Housing and Urban Development,Government National Mortgage Association,null,0.0,0.0,0,0,0,0,31,12,4,2019,2019-12-31,1,2020,0,0
Bureau,Other Agencies,Defense Nuclear Facilities Safety Board,null,0.0,0.0,0,0,0,0,31,12,4,2019,2019-12-31,1,2020,0,0
Bureau,Other Agencies,Denali Commission,null,0.0,0.0,0,0,0,0,31,12,4,2019,2019-12-31,1,2020,0,0
Bureau,Other Agencies/Boards/Commissions,U.S. Comm. on Int. Religious Freedom,null,0.0,0.0,393,1,0,0,31,12,4,2019,2019-12-31,1,2020,393,1
Bureau,Department of Health & Human Services,Office of the Secretary,null,100.0,100.0,0,0,6690,13,31,12,4,2019,2019-12-31,1,2020,6690,13
Agency,Department of Energy,null,CFO,100.0,100.0,0,0,14494235,109,31,12,4,2019,2019-12-31,1,2020,14494235,109
Agency,Environmental Protection Agency,null,CFO,100.0,100.0,0,0,16066763,196,31,12,4,2019,2019-12-31,1,2020,16066763,196
Bureau,Department of State,International Commissions,null,0.0,0.0,0,0,0,0,31,12,4,2019,2019-12-31,1,2020,0,0
Bureau,Department of Housing and Urban Development,Community Planning and Development,null,0.0,0.0,0,0,0,0,31,12,4,2019,2019-12-31,1,2020,0,0
Bureau,Department of Transportation,Pipeline Hazardous Material Safety Admin,null,100.0,100.0,0,0,342272,23,31,12,4,2019,2019-12-31,1,2020,342272,23
Agency,Export - Import  Bank,null,Non-CFO,0.0,0.0,0,0,0,0,31,12,4,2019,2019-12-31,1,2020,0,0
Agency,Department of Commerce,null,CFO,100.0,100.0,0,0,22849752,1399,31,12,4,2019,2019-12-31,1,2020,22849752,1399
Agency,Farm Credit Administration,null,Non-CFO,100.0,100.0,0,0,630,1,31,03,1,2020,2020-03-31,2,2020,630,1
Bureau,Funds Appropriated to the President,African Development Foundation,null,0.0,0.0,0,0,0,0,31,03,1,2020,2020-03-31,2,2020,0,0
Bureau,Other Agencies,Architect of the Capitol,null,0.0,0.0,0,0,0,0,31,03,1,2020,2020-03-31,2,2020,0,0
Agency,Department of Education,null,CFO,90.46748940637528,87.29882632038637,14909008032,3482381,141492685788,23935408,31,03,1,2020,2020-03-31,2,2020,156401693820,27417789
Agency,Legislative Branch-GAO,null,Non-CFO,0.0,0.0,0,0,0,0,31,03,1,2020,2020-03-31,2,2020,0,0
Bureau,Department of the Interior,Office of Natural Resources Revenue,null,100.0,100.0,0,0,1861894,355,31,03,1,2020,2020-03-31,2,2020,1861894,355
Bureau,General Services Administration,General Services Administration,null,83.7218712760927,93.13297221736852,3183226,393,16372007,5330,31,03,1,2020,2020-03-31,2,2020,19555233,5723
Bureau,Railroad Retirement Board,Railroad Retirement Board,null,100.0,100.0,0,0,21318788,4450,31,03,1,2020,2020-03-31,2,2020,21318788,4450
Bureau,Department of Health & Human Services,Administration for Children and Families,null,100.0,100.0,0,0,28904080,1700,31,03,1,2020,2020-03-31,2,2020,28904080,1700
Bureau,Department of Transportation,Federal Motor Carrier Safety Admin,null,99.99989566117058,99.98486453761163,59,1,56546483,6606,31,03,1,2020,2020-03-31,2,2020,56546542,6607
Bureau,Smithsonian Institution,Smithsonian Institution,null,0.0,0.0,0,0,0,0,31,03,1,2020,2020-03-31,2,2020,0,0
Bureau,Overseas Private Investment Corp Accts,Overseas Private Investment Corp Accts,null,0.0,0.0,0,0,0,0,31,03,1,2020,2020-03-31,2,2020,0,0
Bureau,Farm Credit Administration,Farm Credit Administration,null,100.0,100.0,0,0,630,1,31,03,1,2020,2020-03-31,2,2020,630,1
Bureau,Funds Appropriated to the President,Trade and Development Agency,null,0.0,0.0,1235225,6,0,0,31,03,1,2020,2020-03-31,2,2020,1235225,6
Bureau,Agency for International Development,Agency for International Development,null,100.0,100.0,0,0,26764493,47,31,03,1,2020,2020-03-31,2,2020,26764493,47
Bureau,Department of Education,Office of Postsecondary Education,null,0.0,0.0,0,0,0,0,31,03,1,2020,2020-03-31,2,2020,0,0
Bureau,Department of Housing and Urban Development,Public and Indian Housing Programs,null,100.0,100.0,0,0,564,1,31,03,1,2020,2020-03-31,2,2020,564,1
Bureau,Smithsonian Institution,Administrative Conference of the US,null,0.0,0.0,0,0,0,0,31,03,1,2020,2020-03-31,2,2020,0,0
Bureau,Office of Special Counsel,Office of Special Counsel,null,0.0,0.0,0,0,0,0,31,03,1,2020,2020-03-31,2,2020,0,0
Bureau,National Foundation  Arts & Humanities,National Endowment for the Arts,null,0.0,0.0,0,0,0,0,31,03,1,2020,2020-03-31,2,2020,0,0
Bureau,Department of Housing and Urban Development,Management and Administration,null,0.0,0.0,0,0,0,0,31,03,1,2020,2020-03-31,2,2020,0,0
Bureau,Department of the Treasury,Treasury IG for Tax Admin,null,0.0,0.0,0,0,0,0,31,03,1,2020,2020-03-31,2,2020,0,0
Agency,Department of State,null,CFO,99.64236435625767,99.88712846452907,58417,27,16275805,23894,31,03,1,2020,2020-03-31,2,2020,16334222,23921
Bureau,Funds Appropriated to the President,Inter-American Foundation,null,0.0,0.0,0,0,0,0,31,03,1,2020,2020-03-31,2,2020,0,0
Bureau,Department of Homeland Security,Domestic Nuclear Detection Office,null,0.0,0.0,0,0,0,0,31,03,1,2020,2020-03-31,2,2020,0,0
Bureau,Department of Homeland Security,Management Headquarters,null,0.0,0.0,0,0,0,0,31,03,1,2020,2020-03-31,2,2020,0,0
Bureau,Department of the Treasury,Office of Sec International Affairs,null,0.0,0.0,0,0,0,0,31,03,1,2020,2020-03-31,2,2020,0,0
Agency,National Credit Union Administration,null,Non-CFO,0.0,0.0,0,0,0,0,31,03,1,2020,2020-03-31,2,2020,0,0
Agency,National Aeronautics and Space Administration,null,CFO,100.0,100.0,0,0,1230567,117,31,03,1,2020,2020-03-31,2,2020,1230567,117
Agency,Nuclear Regulatory Commission,null,CFO,63.70832251231819,78.37837837837837,1021516,72,1793223,261,31,03,1,2020,2020-03-31,2,2020,2814739,333
Agency,Department of Justice,null,CFO,99.53972771240697,99.47063204937221,411846,199,89066928,37393,31,03,1,2020,2020-03-31,2,2020,89478774,37592
Agency,Overseas Private Investment Corp Accts,null,Non-CFO,0.0,0.0,0,0,0,0,31,03,1,2020,2020-03-31,2,2020,0,0
Agency,Office of Special Counsel,null,Non-CFO,0.0,0.0,0,0,0,0,31,03,1,2020,2020-03-31,2,2020,0,0
Agency,Department of Defense,null,CFO,48.27932811963532,23.391921408494603,1206458086,978194,1126183858,298687,31,03,1,2020,2020-03-31,2,2020,2332641944,1276881
Agency,Small Business Administration,null,CFO,100.0,100.0,0,0,12376759974,121590,31,03,1,2020,2020-03-31,2,2020,12376759974,121590
Agency,Legislative Branch-Office of Tech.,null,Non-CFO,0.0,0.0,0,0,0,0,31,03,1,2020,2020-03-31,2,2020,0,0
Agency,Federal Deposit Insurance Corporation,null,Non-CFO,0.0,0.0,0,0,0,0,31,03,1,2020,2020-03-31,2,2020,0,0
Agency,Export - Import  Bank,null,Non-CFO,0.0,0.0,0,0,0,0,31,03,1,2020,2020-03-31,2,2020,0,0
Agency,Other Agencies/Boards/Commissions,null,Non-CFO,0.0,0.0,1024,2,0,0,31,03,1,2020,2020-03-31,2,2020,1024,2
Agency,Equal Employment Opportunity Commission,null,Non-CFO,100.0,100.0,0,0,39643,23,31,03,1,2020,2020-03-31,2,2020,39643,23
Agency,National Labor Relations Board,null,Non-CFO,0.0,0.0,0,0,0,0,31,03,1,2020,2020-03-31,2,2020,0,0
Agency,Selective Service System,null,Non-CFO,0.0,0.0,0,0,0,0,31,03,1,2020,2020-03-31,2,2020,0,0
Bureau,Other Agencies,U.S. Institute of Peace,null,0.0,0.0,0,0,0,0,31,03,1,2020,2020-03-31,2,2020,0,0
Agency,Legislative Branch-GPO,null,Non-CFO,0.0,0.0,128460,34,0,0,31,03,1,2020,2020-03-31,2,2020,128460,34
Agency,Funds Appropriated to the President,null,Non-CFO,0.0,0.0,1235225,6,0,0,31,03,1,2020,2020-03-31,2,2020,1235225,6
Bureau,Department of Commerce,Minority Business Development Agency,null,0.0,0.0,0,0,0,0,31,03,1,2020,2020-03-31,2,2020,0,0
Bureau,Department of the Treasury,Treasury Franchise Fund,null,0.0,0.0,0,0,0,0,31,03,1,2020,2020-03-31,2,2020,0,0
Bureau,Department of Health & Human Services,Office of the Inspector General,null,0.0,0.0,0,0,0,0,31,03,1,2020,2020-03-31,2,2020,0,0
Bureau,Department of the Interior,"Bureau of Ocean Energy Mgmt., Reg & Enf",null,0.0,0.0,0,0,0,0,31,03,1,2020,2020-03-31,2,2020,0,0
Bureau,Selective Service System,Selective Service System,null,0.0,0.0,0,0,0,0,31,03,1,2020,2020-03-31,2,2020,0,0
Bureau,Department of the Treasury,Office of the Secretary,null,0.0,0.0,0,0,0,0,31,03,1,2020,2020-03-31,2,2020,0,0
Bureau,Department of Homeland Security,Office of Health Affairs,null,0.0,0.0,0,0,0,0,31,03,1,2020,2020-03-31,2,2020,0,0
Bureau,Other Agencies,Comm. for Purchase from Blind/Handic.,null,0.0,0.0,0,0,0,0,31,03,1,2020,2020-03-31,2,2020,0,0
Bureau,Department of Homeland Security,Science and Technology,null,0.0,0.0,0,0,0,0,31,03,1,2020,2020-03-31,2,2020,0,0
Bureau,Legislative Branch-CBO,Congressional Budget Office,null,0.0,0.0,0,0,0,0,31,03,1,2020,2020-03-31,2,2020,0,0
Bureau,Department of Commerce,International Trade Administration,null,0.0,0.0,0,0,0,0,31,03,1,2020,2020-03-31,2,2020,0,0
Bureau,Smithsonian Institution,National Gallery of Art,null,0.0,0.0,0,0,0,0,31,03,1,2020,2020-03-31,2,2020,0,0
Bureau,Department of Commerce,Economic and Statistical Analysis,null,0.0,0.0,0,0,0,0,31,03,1,2020,2020-03-31,2,2020,0,0
Bureau,Department of Homeland Security,Federal Law Enforcement Training Ctr.,null,0.0,0.0,0,0,0,0,31,03,1,2020,2020-03-31,2,2020,0,0
Bureau,Department of the Treasury,Treasury Forfeiture Fund,null,0.0,0.0,0,0,0,0,31,03,1,2020,2020-03-31,2,2020,0,0
Agency,Corp. for National and Community Service,null,Non-CFO,76.76271870088492,11.38868479059515,1085956,1206,3587379,155,31,03,1,2020,2020-03-31,2,2020,4673335,1361
Bureau,Other Agencies/Boards/Commissions,Medicare Payment Advisory Commission,null,0.0,0.0,0,0,0,0,31,03,1,2020,2020-03-31,2,2020,0,0
Bureau,Department of the Treasury,Financial Crimes Enforcement Network,null,100.0,100.0,0,0,1544945,3,31,03,1,2020,2020-03-31,2,2020,1544945,3
Bureau,Department of the Treasury,Community Dev Financial Inst Fund,null,100.0,100.0,0,0,3442830,6,31,03,1,2020,2020-03-31,2,2020,3442830,6
Bureau,Corp. for National and Community Service,Corp. for National and Community Service,null,76.76271870088492,11.38868479059515,1085956,1206,3587379,155,31,03,1,2020,2020-03-31,2,2020,4673335,1361
Bureau,Department of Homeland Security,Transportation Safety Administration,null,100.0,100.0,0,0,8132648,6224,31,03,1,2020,2020-03-31,2,2020,8132648,6224
Bureau,Department of Labor,Employee Benefit Security Administration,null,100.0,100.0,0,0,16580156,374,31,03,1,2020,2020-03-31,2,2020,16580156,374
Bureau,Legislative Branch-Office of Tech.,Open World Leadership,null,0.0,0.0,0,0,0,0,31,03,1,2020,2020-03-31,2,2020,0,0
Bureau,Department of the Interior,Office of the Secretary,null,100.0,100.0,0,0,62545,23,31,03,1,2020,2020-03-31,2,2020,62545,23
Bureau,Department of the Treasury,Internal Revenue Service,null,100.0,100.0,0,0,272859,122,31,03,1,2020,2020-03-31,2,2020,272859,122
Bureau,Department of Transportation,Federal Transit Administration,null,100.0,100.0,0,0,784479,2,31,03,1,2020,2020-03-31,2,2020,784479,2
Bureau,Department of Labor,Employment Standards Administration,null,74.32060742895213,13.63504916136495,19780256,17919,57247485,2829,31,03,1,2020,2020-03-31,2,2020,77027741,20748
Bureau,Department of Health & Human Services,Health Resources and Services Admin,null,100.0,100.0,0,0,87441932,541,31,03,1,2020,2020-03-31,2,2020,87441932,541
Bureau,Commodity Futures Trading Commission,Commodity Futures Trading Commission,null,100.0,100.0,0,0,644465590,366,31,03,1,2020,2020-03-31,2,2020,644465590,366
Bureau,Department of Agriculture,Rural Development,null,99.99933269189724,99.98265755610281,4626,5,693228377,28826,31,03,1,2020,2020-03-31,2,2020,693233003,28831
Bureau,Other Agencies,Delta Regional Authority,null,0.0,0.0,0,0,0,0,31,03,1,2020,2020-03-31,2,2020,0,0
Bureau,Department of Veterans Affairs,Veterans Benefits,null,99.75045247182628,98.467815049864,1289360,1690,515389771,108610,31,03,1,2020,2020-03-31,2,2020,516679131,110300
Bureau,Department of Education,Departmental Management,null,81.76248729531373,85.06894912030432,162470572,314,728388695,1789,31,03,1,2020,2020-03-31,2,2020,890859267,2103
Bureau,Department of Education,Federal Student Aid,null,90.51735687588108,87.29899736960805,14746537460,3482067,140764297093,23933619,31,03,1,2020,2020-03-31,2,2020,155510834553,27415686
Agency,General Services Administration,null,CFO,83.7218712760927,93.13297221736852,3183226,393,16372007,5330,31,03,1,2020,2020-03-31,2,2020,19555233,5723
Agency,Social Security Administration,null,CFO,54.10197267268988,30.849447212290855,2455580016,1140359,2894497447,508737,31,03,1,2020,2020-03-31,2,2020,5350077463,1649096
Agency,Environmental Protection Agency,null,CFO,100.0,100.0,0,0,23555120,214,31,03,1,2020,2020-03-31,2,2020,23555120,214
Agency,Department of Commerce,null,CFO,100.0,100.0,0,0,23915349,1419,31,03,1,2020,2020-03-31,2,2020,23915349,1419
Agency,Department of Transportation,null,CFO,99.93025113832635,99.7717220716222,42746,16,61242842,6993,31,03,1,2020,2020-03-31,2,2020,61285588,7009
Agency,Department of Labor,null,CFO,81.69633102026467,46.317839943725986,26272595,19842,117264720,17120,31,03,1,2020,2020-03-31,2,2020,143537315,36962
Bureau,Department of Transportation,Surface Transportation Board,null,0.0,0.0,0,0,0,0,31,03,1,2020,2020-03-31,2,2020,0,0
Agency,The Judiciary,null,Non-CFO,94.89569156937182,61.890243902439025,57009,125,1059871,203,31,03,1,2020,2020-03-31,2,2020,1116880,328
Agency,Pension Benefit Guaranty Corp,null,Non-CFO,100.0,100.0,0,0,4200927,1671,31,03,1,2020,2020-03-31,2,2020,4200927,1671
Agency,Presidio Trust Corporation,null,Non-CFO,94.55432157147024,88.46153846153847,76925,9,1335663,69,31,03,1,2020,2020-03-31,2,2020,1412588,78
Agency,Other Agencies,null,Non-CFO,0.08883912136126762,1.8518518518518519,5544427,106,4930,2,31,03,1,2020,2020-03-31,2,2020,5549357,108
Agency,Railroad Retirement Board,null,Non-CFO,100.0,100.0,0,0,21318788,4450,31,03,1,2020,2020-03-31,2,2020,21318788,4450
Agency,Federal Trade Commission,null,Non-CFO,100.0,100.0,0,0,483074562,59,31,03,1,2020,2020-03-31,2,2020,483074562,59
Bureau,National Foundation  Arts & Humanities,National Endowment for the Humanities,null,0.0,0.0,0,0,0,0,31,03,1,2020,2020-03-31,2,2020,0,0
Bureau,Department of the Treasury,Interest on Tax/Deposit of Earnings,null,0.0,0.0,0,0,0,0,31,03,1,2020,2020-03-31,2,2020,0,0
Bureau,National Credit Union Administration,National Credit Union Administration,null,0.0,0.0,0,0,0,0,31,03,1,2020,2020-03-31,2,2020,0,0
Bureau,Department of Veterans Affairs,Medical and Construction,null,78.46124256101695,98.92416236161071,148612517,98411,541364690,9048973,31,03,1,2020,2020-03-31,2,2020,689977207,9147384
Bureau,Other Agencies,Defense Nuclear Facilities Safety Board,null,0.0,0.0,0,0,0,0,31,03,1,2020,2020-03-31,2,2020,0,0
Bureau,Department of Labor,Departmental Management,null,0.0,0.0,0,0,0,0,31,03,1,2020,2020-03-31,2,2020,0,0
Bureau,Other Agencies,Surface Transportation Board,null,0.0,0.0,0,0,0,0,31,03,1,2020,2020-03-31,2,2020,0,0
Agency,American Battle Monuments Commission,null,Non-CFO,0.0,0.0,0,0,0,0,31,03,1,2020,2020-03-31,2,2020,0,0
Bureau,Department of the Treasury,Tobacco Tax and Trade,null,100.0,100.0,0,0,1000,1,31,03,1,2020,2020-03-31,2,2020,1000,1
Bureau,Other Agencies,U.S.  Agency of Global Media,null,100.0,100.0,0,0,4930,2,31,03,1,2020,2020-03-31,2,2020,4930,2
Bureau,Department of Justice,Bureau of ATF and Explosives,null,100.0,100.0,0,0,20885,4,31,03,1,2020,2020-03-31,2,2020,20885,4
Bureau,Armed Forces Retirement Home,Armed Forces Retirement Home,null,100.0,100.0,0,0,79497,105,31,03,1,2020,2020-03-31,2,2020,79497,105
Bureau,Funds Appropriated to the President,Defense Security Assistance Agency,null,0.0,0.0,0,0,0,0,31,03,1,2020,2020-03-31,2,2020,0,0
Bureau,Department of the Treasury,U.S. Mint,null,100.0,100.0,0,0,46700,22,31,03,1,2020,2020-03-31,2,2020,46700,22
Agency,Department of Energy,null,CFO,100.0,100.0,0,0,15251116,114,31,03,1,2020,2020-03-31,2,2020,15251116,114
Bureau,Federal Trade Commission,Federal Trade Commission,null,100.0,100.0,0,0,483074562,59,31,03,1,2020,2020-03-31,2,2020,483074562,59
Agency,Securities & Exchange Commission,null,Non-CFO,100.0,100.0,0,0,2112865997,1104,31,03,1,2020,2020-03-31,2,2020,2112865997,1104
Bureau,Department of the Treasury,U.S. Treasury IG Office,null,100.0,100.0,0,0,809,1,31,03,1,2020,2020-03-31,2,2020,809,1
Bureau,Other Agencies,John C. Stennis,null,0.0,0.0,909,1,0,0,31,03,1,2020,2020-03-31,2,2020,909,1
Bureau,Pension Benefit Guaranty Corp,Pension Benefit Guaranty Corporation,null,100.0,100.0,0,0,4200927,1671,31,03,1,2020,2020-03-31,2,2020,4200927,1671
Bureau,Department of Labor,Occupational Safety and Health Admin,null,85.76500336771825,38.391376451077946,1342251,743,8086982,463,31,03,1,2020,2020-03-31,2,2020,9429233,1206
Bureau,Department of Commerce,NOAA,null,100.0,100.0,0,0,15432599,704,31,03,1,2020,2020-03-31,2,2020,15432599,704
Agency,Legislative Branch-CBO,null,Non-CFO,0.0,0.0,0,0,0,0,31,03,1,2020,2020-03-31,2,2020,0,0
Agency,Office of Government Ethics,null,Non-CFO,0.0,0.0,0,0,0,0,31,03,1,2020,2020-03-31,2,2020,0,0
Bureau,Department of Agriculture,U.S. Department of Agriculture,null,85.13125862016547,57.924217462932454,4548290,1277,26041320,1758,31,03,1,2020,2020-03-31,2,2020,30589610,3035
Bureau,Department of Agriculture,Commodity Credit Corporation,null,100.0,100.0,0,0,131547623,10741,31,03,1,2020,2020-03-31,2,2020,131547623,10741
Agency,Smithsonian Institution,null,Non-CFO,0.0,0.0,0,0,0,0,31,03,1,2020,2020-03-31,2,2020,0,0
Bureau,Department of the Treasury,Bureau of the Fiscal Service,null,99.9991392044314,99.97618480590617,113,1,13127278,4198,31,03,1,2020,2020-03-31,2,2020,13127391,4199
Bureau,Office of Compliance,Office of Compliance,null,0.0,0.0,0,0,0,0,31,03,1,2020,2020-03-31,2,2020,0,0
Bureau,Office of Government Ethics,Office of Government Ethics,null,0.0,0.0,0,0,0,0,31,03,1,2020,2020-03-31,2,2020,0,0
Bureau,Funds Appropriated to the President,Executive Branch,null,0.0,0.0,0,0,0,0,31,03,1,2020,2020-03-31,2,2020,0,0
Bureau,Other Agencies,Gulf Coast Ecosystem Restoration Council,null,0.0,0.0,0,0,0,0,31,03,1,2020,2020-03-31,2,2020,0,0
Bureau,Federal Deposit Insurance Corporation,Federal Deposit Insurance Corporation,null,0.0,0.0,0,0,0,0,31,03,1,2020,2020-03-31,2,2020,0,0
Bureau,Legislative Branch - U.S. House/Senate,U.S. House of Representatives,null,23.029962889998625,18.095238095238095,201603,172,60321,38,31,03,1,2020,2020-03-31,2,2020,261924,210
Agency,Legislative Branch - U.S. House/Senate,null,Non-CFO,23.029962889998625,18.095238095238095,201603,172,60321,38,31,03,1,2020,2020-03-31,2,2020,261924,210
Agency,Federal Maritime Commission,null,Non-CFO,100.0,100.0,0,0,390759,8,31,03,1,2020,2020-03-31,2,2020,390759,8
Bureau,Department of Transportation,National Highway Traffic Safety Admin.,null,100.0,100.0,0,0,18828,4,31,03,1,2020,2020-03-31,2,2020,18828,4
Bureau,Department of State,Passport NSF,null,100.0,100.0,0,0,2646971,17027,31,03,1,2020,2020-03-31,2,2020,2646971,17027
Agency,Department of Agriculture,null,CFO,99.44826164230447,96.05809128630706,8634277,2242,1556288096,54634,31,03,1,2020,2020-03-31,2,2020,1564922373,56876
Agency,U.S. Postal Service,null,Non-CFO,61.37992959599838,72.21520210504409,26428889,18690,42004153,48577,31,03,1,2020,2020-03-31,2,2020,68433042,67267
Agency,Federal Communications Commission,null,Non-CFO,100.0,100.0,0,0,214160564,12856,31,03,1,2020,2020-03-31,2,2020,214160564,12856
Agency,Commodity Futures Trading Commission,null,Non-CFO,100.0,100.0,0,0,644465590,366,31,03,1,2020,2020-03-31,2,2020,644465590,366
Bureau,Other Agencies,Federal Housing Finance Agency OIG,null,0.0,0.0,0,0,0,0,31,03,1,2020,2020-03-31,2,2020,0,0
Bureau,Department of Justice,U.S. Marshals Service,null,0.0,0.0,0,0,0,0,31,03,1,2020,2020-03-31,2,2020,0,0
Bureau,Department of Health & Human Services,Administration for Community Living,null,0.0,0.0,0,0,0,0,31,03,1,2020,2020-03-31,2,2020,0,0
Bureau,Other Agencies,National Transportation Safety Board,null,0.0,0.0,0,0,0,0,31,03,1,2020,2020-03-31,2,2020,0,0
Bureau,Equal Employment Opportunity Commission,Equal Employment Opportunity Commission,null,100.0,100.0,0,0,39643,23,31,03,1,2020,2020-03-31,2,2020,39643,23
Bureau,Department of Labor,Employment and Training Administration,null,96.84258077524115,95.23809523809524,140000,1,4294001,20,31,03,1,2020,2020-03-31,2,2020,4434001,21
Bureau,Other Agencies,National Capital Planning Commission,null,0.0,0.0,0,0,0,0,31,03,1,2020,2020-03-31,2,2020,0,0
Bureau,Other Agencies,District of Columbia Government,null,0.0,0.0,0,0,0,0,31,03,1,2020,2020-03-31,2,2020,0,0
Bureau,Department of Agriculture,Food Safety and Inspection Service,null,99.78385861311045,99.84313725490196,1833,2,846223,1273,31,03,1,2020,2020-03-31,2,2020,848056,1275
Bureau,Department of Transportation,Federal Aviation Administration,null,98.03996655449289,95.42682926829268,42687,15,2135184,313,31,03,1,2020,2020-03-31,2,2020,2177871,328
Bureau,Department of Agriculture,Agricultural Marketing Service,null,90.5311520685511,54.4,527164,456,5040187,544,31,03,1,2020,2020-03-31,2,2020,5567351,1000
Bureau,Department of the Treasury,Departmental Offices,null,97.51634171338715,97.80380673499268,461260,30,18110538,1336,31,03,1,2020,2020-03-31,2,2020,18571798,1366
Bureau,Occupational Safety & Health Rev Comm,Occupational Safety & Health Rev Comm,null,0.0,0.0,0,0,0,0,31,03,1,2020,2020-03-31,2,2020,0,0
Bureau,U.S. Postal Service,U.S. Postal Service,null,61.37992959599838,72.21520210504409,26428889,18690,42004153,48577,31,03,1,2020,2020-03-31,2,2020,68433042,67267
Bureau,Department of Justice,Legal Activities,null,99.52661054467235,99.46505376344086,411846,199,86587557,37001,31,03,1,2020,2020-03-31,2,2020,86999403,37200
Bureau,National Archives & Records Admin,Nat'l Archives & Records Administration,null,98.40756694346996,98.93617021276596,1793,1,110802,93,31,03,1,2020,2020-03-31,2,2020,112595,94
Bureau,Department of Transportation,Federal Railroad Administration,null,100.0,100.0,0,0,165274,15,31,03,1,2020,2020-03-31,2,2020,165274,15
Agency,Department of Health & Human Services,null,CFO,98.2298984255018,97.99604162611818,174336136,23784,9674597875,1163067,31,03,1,2020,2020-03-31,2,2020,9848934011,1186851
Bureau,Department of the Treasury,Spec Insp Gen-Troubled Asset Rel Prog,null,100.0,100.0,0,0,3916,1,31,03,1,2020,2020-03-31,2,2020,3916,1
Bureau,Department of Health & Human Services,Centers for Disease Control,null,0.9946001212561055,8.235294117647058,7061077,156,70935,14,31,03,1,2020,2020-03-31,2,2020,7132012,170
Bureau,Department of Housing and Urban Development,"Policy, Development and Research",null,0.0,0.0,0,0,0,0,31,03,1,2020,2020-03-31,2,2020,0,0
Bureau,Department of Health & Human Services,Centers for Medicare & Medicaid Services,null,99.2605559038594,99.10531356352504,70675339,10463,9487226248,1158997,31,03,1,2020,2020-03-31,2,2020,9557901587,1169460
Bureau,Department of the Treasury,Office of Financial Research,null,0.0,0.0,0,0,0,0,31,03,1,2020,2020-03-31,2,2020,0,0
Bureau,Department of Homeland Security,Bureau of Customs & Border Protection,null,100.0,100.0,0,0,8668902,605,31,03,1,2020,2020-03-31,2,2020,8668902,605
Agency,Department of Veterans Affairs,null,CFO,87.29967629368358,98.91045223625312,153887922,100877,1057797115,9157735,31,03,1,2020,2020-03-31,2,2020,1211685037,9258612
Bureau,Other Agencies,National Council on Disability,null,0.0,0.0,0,0,0,0,31,03,1,2020,2020-03-31,2,2020,0,0
Bureau,Neighborhood Reinvestment Corporation,Neighborhood Reinvestment Corporation,null,0.0,0.0,0,0,0,0,31,03,1,2020,2020-03-31,2,2020,0,0
Bureau,Department of Veterans Affairs,Housing Credit Assistance,null,20.03374072024401,39.50617283950617,1700728,49,426079,32,31,03,1,2020,2020-03-31,2,2020,2126807,81
Bureau,Department of Health & Human Services,National Institutes of Health,null,44.0892287057023,23.4718826405868,7081315,313,5584071,96,31,03,1,2020,2020-03-31,2,2020,12665386,409
Bureau,Department of Health & Human Services,Food and Drug Administration,null,34.03200028157603,9.752864312091658,61662839,9531,31811026,1030,31,03,1,2020,2020-03-31,2,2020,93473865,10561
Agency,Neighborhood Reinvestment Corporation,null,Non-CFO,0.0,0.0,0,0,0,0,31,03,1,2020,2020-03-31,2,2020,0,0
Bureau,Legislative Branch-Office of Tech.,Medicaid & CHIP Payment & Access Comm.,null,0.0,0.0,0,0,0,0,31,03,1,2020,2020-03-31,2,2020,0,0
Bureau,Department of the Interior,Bureau of Indian Affairs,null,99.90448375002896,99.85486211901306,16821,41,17593795,28208,31,03,1,2020,2020-03-31,2,2020,17610616,28249
Bureau,Federal Communications Commission,Federal Communications Commission,null,100.0,100.0,0,0,214160564,12856,31,03,1,2020,2020-03-31,2,2020,214160564,12856
Bureau,Department of Homeland Security,Info Analysis Infrastructure Prot-NPPD,null,0.0,0.0,0,0,0,0,31,03,1,2020,2020-03-31,2,2020,0,0
Agency,Office of Personnel Management,null,CFO,92.97042663187071,88.65573770491804,1700654,173,22492194,1352,31,03,1,2020,2020-03-31,2,2020,24192848,1525
Agency,Department of the Treasury,null,CFO,98.80364394972345,99.46217904233171,461373,31,38103484,5733,31,03,1,2020,2020-03-31,2,2020,38564857,5764
Agency,Federal Mediation/Conciliation Service,null,Non-CFO,0.0,0.0,0,0,0,0,31,03,1,2020,2020-03-31,2,2020,0,0
Agency,Office of Compliance,null,Non-CFO,0.0,0.0,0,0,0,0,31,03,1,2020,2020-03-31,2,2020,0,0
Bureau,Department of Housing and Urban Development,Community Planning and Development,null,0.0,0.0,0,0,0,0,31,03,1,2020,2020-03-31,2,2020,0,0
Bureau,Department of Housing and Urban Development,Government National Mortgage Association,null,89.47368421052632,25.0,2,3,17,1,31,03,1,2020,2020-03-31,2,2020,19,4
Agency,Agency for International Development,null,CFO,100.0,100.0,0,0,26764493,47,31,03,1,2020,2020-03-31,2,2020,26764493,47
Bureau,Other Agencies,Election Assistance Commission,null,0.0,0.0,0,0,0,0,31,03,1,2020,2020-03-31,2,2020,0,0
Bureau,Department of Homeland Security,Office of the Inspector General DHS,null,100.0,100.0,0,0,99,1,31,03,1,2020,2020-03-31,2,2020,99,1
Agency,Legis Branch-Library of Congress,null,Non-CFO,0.0,0.0,0,0,0,0,31,03,1,2020,2020-03-31,2,2020,0,0
Bureau,Department of the Treasury,International Monetary Funds,null,0.0,0.0,0,0,0,0,31,03,1,2020,2020-03-31,2,2020,0,0
Bureau,Federal Mediation/Conciliation Service,Federal Mediation/Conciliation Service,null,0.0,0.0,0,0,0,0,31,03,1,2020,2020-03-31,2,2020,0,0
Bureau,Other Agencies,U.S. Inst. for Env. Conflict Resolution,null,0.0,0.0,5003,2,0,0,31,03,1,2020,2020-03-31,2,2020,5003,2
Bureau,Department of Agriculture,Federal Crop Insurance Corporation,null,100.0,100.0,0,0,48964,436,31,03,1,2020,2020-03-31,2,2020,48964,436
Bureau,Department of the Interior,Bureau of Reclamation,null,100.0,100.0,0,0,91302,83,31,03,1,2020,2020-03-31,2,2020,91302,83
Bureau,Department of Transportation,Office of the Secretary,null,100.0,100.0,0,0,910849,15,31,03,1,2020,2020-03-31,2,2020,910849,15
Bureau,Department of Homeland Security,Office of Biometric Identity Management,null,0.0,0.0,0,0,0,0,31,03,1,2020,2020-03-31,2,2020,0,0
Bureau,Department of Transportation,Office of the Inspector General,null,100.0,100.0,0,0,207,1,31,03,1,2020,2020-03-31,2,2020,207,1
Bureau,Department of Justice,Federal Bureau of Investigation,null,100.0,100.0,0,0,234612,65,31,03,1,2020,2020-03-31,2,2020,234612,65
Agency,Merit Systems Protection Board,null,Non-CFO,100.0,100.0,0,0,144,1,31,03,1,2020,2020-03-31,2,2020,144,1
Bureau,Department of Commerce,Nat'l Telecomm & Information Admin.,null,100.0,100.0,0,0,296093,1,31,03,1,2020,2020-03-31,2,2020,296093,1
Bureau,U.S. Court of Appeals / Veterans Claims,U.S. Court of Appeals / Veterans Claims,null,100.0,100.0,0,0,295,1,31,03,1,2020,2020-03-31,2,2020,295,1
Bureau,Consumer Product Safety Commission,Consumer Product Safety Commission,null,100.0,100.0,0,0,479,1,31,03,1,2020,2020-03-31,2,2020,479,1
Bureau,Department of Transportation,Research Innovative Technology Admin,null,100.0,100.0,0,0,3753,3,31,03,1,2020,2020-03-31,2,2020,3753,3
Bureau,Department of Justice,Drug Enforcement Administration,null,100.0,100.0,0,0,322469,20,31,03,1,2020,2020-03-31,2,2020,322469,20
Bureau,Securities & Exchange Commission,Securities and Exchange Commission,null,100.0,100.0,0,0,329138,61,31,03,1,2020,2020-03-31,2,2020,329138,61
Bureau,Department of Veterans Affairs,Administration and Cemeteries,null,0.0,0.0,2285317,727,0,0,31,03,1,2020,2020-03-31,2,2020,2285317,727
Bureau,Nuclear Regulatory Commission,Nuclear Regulatory Commission,null,63.70832251231819,78.37837837837837,1021516,72,1793223,261,31,03,1,2020,2020-03-31,2,2020,2814739,333
Bureau,Department of the Interior,Fish and Wildlife Service,null,100.0,100.0,0,0,606056,87,31,03,1,2020,2020-03-31,2,2020,606056,87
Agency,Consumer Product Safety Commission,null,Non-CFO,100.0,100.0,0,0,479,1,31,03,1,2020,2020-03-31,2,2020,479,1
Bureau,Other Agencies,Morris K. Udall Scholarship,null,0.0,0.0,982,1,0,0,31,03,1,2020,2020-03-31,2,2020,982,1
Bureau,Department of Transportation,Pipeline Hazardous Material Safety Admin,null,100.0,100.0,0,0,345573,23,31,03,1,2020,2020-03-31,2,2020,345573,23
Bureau,Federal Maritime Commission,Salaries and Expenses,null,100.0,100.0,0,0,390759,8,31,03,1,2020,2020-03-31,2,2020,390759,8
Bureau,Department of Commerce,Patent and Trademark Office,null,100.0,100.0,0,0,441042,500,31,03,1,2020,2020-03-31,2,2020,441042,500
Bureau,Department of Commerce,Nat'l Institute of Standards& Technology,null,100.0,100.0,0,0,670558,5,31,03,1,2020,2020-03-31,2,2020,670558,5
Bureau,Department of Health & Human Services,Substance Abuse & Mental Health Admin.,null,100.0,100.0,0,0,981716,14,31,03,1,2020,2020-03-31,2,2020,981716,14
Agency,Department of Housing and Urban Development,null,CFO,99.99999882178209,99.95294855708909,2,3,169747883,6373,31,03,1,2020,2020-03-31,2,2020,169747885,6376
Bureau,Department of Justice,General Administration,null,0.0,0.0,0,0,0,0,31,03,1,2020,2020-03-31,2,2020,0,0
Agency,Department of Homeland Security,null,CFO,99.99439935634476,99.96023287627652,20823,25,371775729,62841,31,03,1,2020,2020-03-31,2,2020,371796552,62866
Agency,Armed Forces Retirement Home,null,Non-CFO,100.0,100.0,0,0,79497,105,31,03,1,2020,2020-03-31,2,2020,79497,105
Bureau,Other Agencies,Federal Housing Finance Agency,null,0.0,0.0,221,1,0,0,31,03,1,2020,2020-03-31,2,2020,221,1
Bureau,Department of Transportation,St. Lawrence Seaway Development Corp.,null,100.0,100.0,0,0,4343,1,31,03,1,2020,2020-03-31,2,2020,4343,1
Bureau,Department of Labor,Bureau of Labor Statistics,null,100.0,100.0,0,0,11381,1,31,03,1,2020,2020-03-31,2,2020,11381,1
Agency,National Archives & Records Admin,null,Non-CFO,98.40756694346996,98.93617021276596,1793,1,110802,93,31,03,1,2020,2020-03-31,2,2020,112595,94
Bureau,Department of Commerce,General Administration,null,100.0,100.0,0,0,4660,1,31,03,1,2020,2020-03-31,2,2020,4660,1
Bureau,Other Agencies,Council of Insps. Gen. of Intg. & Effy.,null,0.0,0.0,5400,7,0,0,31,03,1,2020,2020-03-31,2,2020,5400,7
Bureau,Department of Homeland Security,Citizenship and Immigration Services,null,100.0,100.0,0,0,1013415,1232,31,03,1,2020,2020-03-31,2,2020,1013415,1232
Bureau,Department of Justice,Office of Justice Assistance Programs,null,100.0,100.0,0,0,18504,1,31,03,1,2020,2020-03-31,2,2020,18504,1
Bureau,Department of Justice,Federal Prison Industries,null,100.0,100.0,0,0,1043089,183,31,03,1,2020,2020-03-31,2,2020,1043089,183
Bureau,Other Agencies,Federal Mine Safety & Health Review Comm,null,0.0,0.0,0,0,0,0,31,03,1,2020,2020-03-31,2,2020,0,0
Bureau,Presidio Trust Corporation,Presidio Trust Corporation,null,94.55432157147024,88.46153846153847,76925,9,1335663,69,31,03,1,2020,2020-03-31,2,2020,1412588,78
Bureau,Department of Homeland Security,Immigration and Customs Enforcement,null,100.0,100.0,0,0,10369911,448,31,03,1,2020,2020-03-31,2,2020,10369911,448
Bureau,Environmental Protection Agency,Environmental Protection Agency,null,100.0,100.0,0,0,23555120,214,31,03,1,2020,2020-03-31,2,2020,23555120,214
Bureau,Department of Commerce,Economic Development Administration,null,100.0,100.0,0,0,5093108,9,31,03,1,2020,2020-03-31,2,2020,5093108,9
Bureau,Office of Personnel Management,Office of Personnel Management,null,92.97042663187071,88.65573770491804,1700654,173,22492194,1352,31,03,1,2020,2020-03-31,2,2020,24192848,1525
Agency,Department of the Interior,null,CFO,99.96307850183048,99.86928104575163,16821,41,45542002,31324,31,03,1,2020,2020-03-31,2,2020,45558823,31365
Bureau,Small Business Administration,Small Business Administration,null,100.0,100.0,0,0,12376759974,121590,31,03,1,2020,2020-03-31,2,2020,12376759974,121590
Bureau,Other Agencies,Consumer Financial Protection Bureau,null,0.0,0.0,5310622,68,0,0,31,03,1,2020,2020-03-31,2,2020,5310622,68
Bureau,Department of Housing and Urban Development,Housing Programs,null,100.0,100.0,0,0,169747302,6371,31,03,1,2020,2020-03-31,2,2020,169747302,6371
Agency,Federal Election Commission,null,Non-CFO,100.0,100.0,0,0,738048,104,31,03,1,2020,2020-03-31,2,2020,738048,104
Bureau,Department of the Treasury,Comptroller of the Currency,null,100.0,100.0,0,0,1111501,21,31,03,1,2020,2020-03-31,2,2020,1111501,21
Bureau,Department of Commerce,Office of the Inspector General,null,0.0,0.0,0,0,0,0,31,03,1,2020,2020-03-31,2,2020,0,0
Bureau,National Aeronautics and Space Administration,National Aeronautics and Space Admin,null,100.0,100.0,0,0,1230567,117,31,03,1,2020,2020-03-31,2,2020,1230567,117
Agency,Federal Labor Relations Authority,null,Non-CFO,0.0,0.0,0,0,0,0,31,03,1,2020,2020-03-31,2,2020,0,0
Agency,National Foundation  Arts & Humanities,null,Non-CFO,0.0,0.0,0,0,0,0,31,03,1,2020,2020-03-31,2,2020,0,0
Bureau,Department of Health & Human Services,Program Support Center,null,100.0,100.0,0,0,5584227,489,31,03,1,2020,2020-03-31,2,2020,5584227,489
Bureau,Department of Transportation,Maritime Administration,null,100.0,100.0,0,0,2816,4,31,03,1,2020,2020-03-31,2,2020,2816,4
Bureau,Department of the Interior,National Park Service,null,100.0,100.0,0,0,6992416,1835,31,03,1,2020,2020-03-31,2,2020,6992416,1835
Bureau,Department of Labor,Mine Safety and Health Administration,null,86.10424247776365,91.93128935121818,5010088,1179,31044715,13433,31,03,1,2020,2020-03-31,2,2020,36054803,14612
Bureau,Department of State,Department of State,null,99.57320136819293,99.60835509138381,58417,27,13628834,6867,31,03,1,2020,2020-03-31,2,2020,13687251,6894
Agency,Occupational Safety & Health Rev Comm,null,Non-CFO,0.0,0.0,0,0,0,0,31,03,1,2020,2020-03-31,2,2020,0,0
Bureau,Other Agencies,National Mediation Board,null,0.0,0.0,0,0,0,0,31,03,1,2020,2020-03-31,2,2020,0,0
Bureau,Department of the Interior,Bureau of Land Management,null,100.0,100.0,0,0,15651489,295,31,03,1,2020,2020-03-31,2,2020,15651489,295
Bureau,Department of Homeland Security,Emergency Preparedness & Resp,null,100.0,100.0,0,0,258464040,42918,31,03,1,2020,2020-03-31,2,2020,258464040,42918
Agency,Tennessee Valley Authority,null,Non-CFO,0.0,0.0,0,0,0,0,31,03,1,2020,2020-03-31,2,2020,0,0
Bureau,Federal Labor Relations Authority,Federal Labor Relations Authority,null,0.0,0.0,0,0,0,0,31,03,1,2020,2020-03-31,2,2020,0,0
Bureau,Department of the Treasury,Bureau of Engraving and Printing,null,100.0,100.0,0,0,84528,1,31,03,1,2020,2020-03-31,2,2020,84528,1
Bureau,Merit Systems Protection Board,Merit Systems Protection Board,null,100.0,100.0,0,0,144,1,31,03,1,2020,2020-03-31,2,2020,144,1
Bureau,Legislative Branch-GPO,Government Publishing Office,null,0.0,0.0,128460,34,0,0,31,03,1,2020,2020-03-31,2,2020,128460,34
Bureau,Department of Commerce,Bureau of the Census,null,100.0,100.0,0,0,185976,183,31,03,1,2020,2020-03-31,2,2020,185976,183
Bureau,Social Security Administration,Social Security Administration,null,54.10197267268988,30.849447212290855,2455580016,1140359,2894497447,508737,31,03,1,2020,2020-03-31,2,2020,5350077463,1649096
Bureau,Other Agencies,Denali Commission,null,0.0,0.0,0,0,0,0,31,03,1,2020,2020-03-31,2,2020,0,0
Agency,U.S. Court of Appeals / Veterans Claims,null,Non-CFO,100.0,100.0,0,0,295,1,31,03,1,2020,2020-03-31,2,2020,295,1
Bureau,Department of Agriculture,Forest Service,null,95.85640037055515,38.932291666666664,2636525,469,60992330,299,31,03,1,2020,2020-03-31,2,2020,63628855,768
Bureau,Other Agencies,Millennium Challenge Corporation,null,0.0,0.0,0,0,0,0,31,03,1,2020,2020-03-31,2,2020,0,0
Bureau,Farm Credit Administration,Farm Credit System Insurance Corporation,null,0.0,0.0,0,0,0,0,31,03,1,2020,2020-03-31,2,2020,0,0
Bureau,Department of Veterans Affairs,Life Insurance,null,100.0,100.0,0,0,616575,120,31,03,1,2020,2020-03-31,2,2020,616575,120
Bureau,Department of the Interior,Office of Surface Mining,null,100.0,100.0,0,0,2523888,265,31,03,1,2020,2020-03-31,2,2020,2523888,265
Bureau,Securities & Exchange Commission,SEC Enforcement,null,100.0,100.0,0,0,2112536859,1043,31,03,1,2020,2020-03-31,2,2020,2112536859,1043
Bureau,National Labor Relations Board,National Labor Relations Board,null,0.0,0.0,0,0,0,0,31,03,1,2020,2020-03-31,2,2020,0,0
Bureau,Other Agencies,Archit.&Trans. Barriers Compliance Bd,null,0.0,0.0,0,0,0,0,31,03,1,2020,2020-03-31,2,2020,0,0
Bureau,Smithsonian Institution,JFK Center for the Performing Arts,null,0.0,0.0,0,0,0,0,31,03,1,2020,2020-03-31,2,2020,0,0
Bureau,Other Agencies/Boards/Commissions,U.S. Comm. on Int. Religious Freedom,null,0.0,0.0,1024,2,0,0,31,03,1,2020,2020-03-31,2,2020,1024,2
Bureau,Other Agencies/Boards/Commissions,U.S.-China Security Review Commission,null,0.0,0.0,0,0,0,0,31,03,1,2020,2020-03-31,2,2020,0,0
Bureau,Department of State,International Commissions,null,0.0,0.0,0,0,0,0,31,03,1,2020,2020-03-31,2,2020,0,0
Bureau,Department of State,Civil Monetary Penalties,null,0.0,0.0,0,0,0,0,31,03,1,2020,2020-03-31,2,2020,0,0
Bureau,The Judiciary,Administrative Office of the U.S. Courts,null,94.89569156937182,61.890243902439025,57009,125,1059871,203,31,03,1,2020,2020-03-31,2,2020,1116880,328
Bureau,Export - Import  Bank,Export-Import Bank,null,0.0,0.0,0,0,0,0,31,03,1,2020,2020-03-31,2,2020,0,0
Bureau,Department of Defense,Consolidated Report,null,48.27932811963532,23.391921408494603,1206458086,978194,1126183858,298687,31,03,1,2020,2020-03-31,2,2020,2332641944,1276881
Bureau,Tennessee Valley Authority,Tennessee Valley Authority,null,0.0,0.0,0,0,0,0,31,03,1,2020,2020-03-31,2,2020,0,0
Bureau,Other Agencies,U.S. Holocaust Memorial Council,null,0.0,0.0,0,0,0,0,31,03,1,2020,2020-03-31,2,2020,0,0
Bureau,Department of Commerce,National Technical Information Service,null,0.0,0.0,0,0,0,0,31,03,1,2020,2020-03-31,2,2020,0,0
Bureau,Other Agencies,Commission On Fine Arts,null,0.0,0.0,0,0,0,0,31,03,1,2020,2020-03-31,2,2020,0,0
Agency,National Science Foundation,null,CFO,100.0,100.0,0,0,509535,94,31,03,1,2020,2020-03-31,2,2020,509535,94
Bureau,Legislative Branch-GAO,Government Accountability Office,null,0.0,0.0,0,0,0,0,31,03,1,2020,2020-03-31,2,2020,0,0
Bureau,Department of the Interior,Bureau of Safety and Environmental Enf.,null,0.0,0.0,0,0,0,0,31,03,1,2020,2020-03-31,2,2020,0,0
Bureau,Legis Branch-Library of Congress,Library of Congress,null,0.0,0.0,0,0,0,0,31,03,1,2020,2020-03-31,2,2020,0,0
Bureau,Department of Homeland Security,U.S. Secret Service,null,0.0,0.0,0,0,0,0,31,03,1,2020,2020-03-31,2,2020,0,0
Bureau,Department of Health & Human Services,Office of the Secretary,null,100.0,100.0,0,0,3290,7,31,03,1,2020,2020-03-31,2,2020,3290,7
Bureau,Department of the Treasury,D.C. Pension Program,null,100.0,100.0,0,0,356580,21,31,03,1,2020,2020-03-31,2,2020,356580,21
Bureau,National Science Foundation,National Science Foundation,null,100.0,100.0,0,0,509535,94,31,03,1,2020,2020-03-31,2,2020,509535,94
Bureau,Federal Election Commission,Federal Election Commission,null,100.0,100.0,0,0,738048,104,31,03,1,2020,2020-03-31,2,2020,738048,104
Bureau,Department of Justice,Federal Prison System,null,100.0,100.0,0,0,839812,119,31,03,1,2020,2020-03-31,2,2020,839812,119
Bureau,Funds Appropriated to the President,Peace Corps,null,0.0,0.0,0,0,0,0,31,03,1,2020,2020-03-31,2,2020,0,0
Bureau,Department of Agriculture,Food and Nutrition Service,null,4.978408876327786,15.384615384615385,915839,33,47983,6,31,03,1,2020,2020-03-31,2,2020,963822,39
Bureau,Department of Health & Human Services,Indian Health Services,null,49.21123024000547,5.114285714285714,27855566,3321,26990350,179,31,03,1,2020,2020-03-31,2,2020,54845916,3500
Bureau,Other Agencies,Advisory Council on Hist. Preservation,null,0.0,0.0,0,0,0,0,31,03,1,2020,2020-03-31,2,2020,0,0
Bureau,Other Agencies,Chemical Safety Board,null,0.0,0.0,0,0,0,0,31,03,1,2020,2020-03-31,2,2020,0,0
Bureau,Other Agencies,James Madison Memorial Fellowship,null,0.0,0.0,221290,26,0,0,31,03,1,2020,2020-03-31,2,2020,221290,26
Bureau,Department of Energy,Bonneville Power Administration,null,100.0,100.0,0,0,1100045,39,31,03,1,2020,2020-03-31,2,2020,1100045,39
Bureau,Department of Commerce,Bureau of Industry and Security,null,100.0,100.0,0,0,1791313,16,31,03,1,2020,2020-03-31,2,2020,1791313,16
Bureau,Department of Agriculture,Farm Service Agency,null,100.0,100.0,0,0,638495089,10751,31,03,1,2020,2020-03-31,2,2020,638495089,10751
Bureau,Department of the Interior,Geological Survey,null,100.0,100.0,0,0,158617,173,31,03,1,2020,2020-03-31,2,2020,158617,173
Bureau,Department of Transportation,Federal Highway Administration,null,100.0,100.0,0,0,325053,6,31,03,1,2020,2020-03-31,2,2020,325053,6
Bureau,Department of Energy,Energy Consolidated Reports,null,100.0,100.0,0,0,14151071,75,31,03,1,2020,2020-03-31,2,2020,14151071,75
Bureau,Department of Homeland Security,U.S. Coast Guard,null,99.97554480055014,99.78143031998601,20823,25,85126714,11413,31,03,1,2020,2020-03-31,2,2020,85147537,11438
Bureau,American Battle Monuments Commission,American Battle Monuments Commission,null,0.0,0.0,0,0,0,0,31,03,1,2020,2020-03-31,2,2020,0,0
Agency,Neighborhood Reinvestment Corporation,null,Non-CFO,0.0,0.0,0,0,0,0,30,06,2,2020,2020-06-30,3,2020,0,0
Bureau,Other Agencies,National Mediation Board,null,0.0,0.0,0,0,0,0,30,06,2,2020,2020-06-30,3,2020,0,0
Bureau,U.S. Postal Service,U.S. Postal Service,null,57.387025259756165,81.52200459141308,32414498,11349,43652705,50070,30,06,2,2020,2020-06-30,3,2020,76067203,61419
Bureau,Department of the Treasury,Treasury Forfeiture Fund,null,0.0,0.0,0,0,0,0,30,06,2,2020,2020-06-30,3,2020,0,0
Bureau,Federal Deposit Insurance Corporation,Federal Deposit Insurance Corporation,null,0.0,0.0,0,0,0,0,30,06,2,2020,2020-06-30,3,2020,0,0
Bureau,Department of Homeland Security,Management Headquarters,null,0.0,0.0,0,0,0,0,30,06,2,2020,2020-06-30,3,2020,0,0
Bureau,Farm Credit Administration,Farm Credit System Insurance Corporation,null,0.0,0.0,0,0,0,0,30,06,2,2020,2020-06-30,3,2020,0,0
Bureau,Other Agencies,U.S. Holocaust Memorial Council,null,0.0,0.0,0,0,0,0,30,06,2,2020,2020-06-30,3,2020,0,0
Bureau,Smithsonian Institution,Administrative Conference of the US,null,0.0,0.0,0,0,0,0,30,06,2,2020,2020-06-30,3,2020,0,0
Bureau,Department of Health & Human Services,Office of the Inspector General,null,0.0,0.0,0,0,0,0,30,06,2,2020,2020-06-30,3,2020,0,0
Bureau,Legislative Branch-Office of Tech.,Open World Leadership,null,0.0,0.0,0,0,0,0,30,06,2,2020,2020-06-30,3,2020,0,0
Bureau,Funds Appropriated to the President,Executive Branch,null,0.0,0.0,0,0,0,0,30,06,2,2020,2020-06-30,3,2020,0,0
Bureau,Department of Commerce,National Technical Information Service,null,0.0,0.0,0,0,0,0,30,06,2,2020,2020-06-30,3,2020,0,0
Bureau,National Foundation  Arts & Humanities,National Endowment for the Arts,null,0.0,0.0,0,0,0,0,30,06,2,2020,2020-06-30,3,2020,0,0
Bureau,National Labor Relations Board,National Labor Relations Board,null,0.0,0.0,0,0,0,0,30,06,2,2020,2020-06-30,3,2020,0,0
Bureau,Department of Homeland Security,Science and Technology,null,0.0,0.0,0,0,0,0,30,06,2,2020,2020-06-30,3,2020,0,0
Agency,National Credit Union Administration,null,Non-CFO,0.0,0.0,0,0,0,0,30,06,2,2020,2020-06-30,3,2020,0,0
Bureau,Pension Benefit Guaranty Corp,Pension Benefit Guaranty Corporation,null,100.0,100.0,0,0,3920900,1620,30,06,2,2020,2020-06-30,3,2020,3920900,1620
Agency,Legis Branch-Library of Congress,null,Non-CFO,0.0,0.0,0,0,0,0,30,06,2,2020,2020-06-30,3,2020,0,0
Bureau,Overseas Private Investment Corp Accts,Overseas Private Investment Corp Accts,null,0.0,0.0,0,0,0,0,30,06,2,2020,2020-06-30,3,2020,0,0
Bureau,Legis Branch-Library of Congress,Library of Congress,null,0.0,0.0,0,0,0,0,30,06,2,2020,2020-06-30,3,2020,0,0
Agency,Other Agencies,null,Non-CFO,0.09520745661322297,2.727272727272727,5745125,107,5475,3,30,06,2,2020,2020-06-30,3,2020,5750600,110
Bureau,Office of Special Counsel,Office of Special Counsel,null,0.0,0.0,0,0,0,0,30,06,2,2020,2020-06-30,3,2020,0,0
Bureau,Export - Import  Bank,Export-Import Bank,null,0.0,0.0,0,0,0,0,30,06,2,2020,2020-06-30,3,2020,0,0
Agency,National Labor Relations Board,null,Non-CFO,0.0,0.0,0,0,0,0,30,06,2,2020,2020-06-30,3,2020,0,0
Agency,US International Development Fin. Corp.,null,Non-CFO,0.0,0.0,0,0,0,0,30,06,2,2020,2020-06-30,3,2020,0,0
Agency,Railroad Retirement Board,null,Non-CFO,100.0,100.0,0,0,21736838,4387,30,06,2,2020,2020-06-30,3,2020,21736838,4387
Bureau,Other Agencies,Federal Mine Safety & Health Review Comm,null,0.0,0.0,0,0,0,0,30,06,2,2020,2020-06-30,3,2020,0,0
Bureau,Department of Labor,Occupational Safety and Health Admin,null,89.04046705829904,95.50924567067801,5108429,153,41503311,3254,30,06,2,2020,2020-06-30,3,2020,46611740,3407
Bureau,Department of Homeland Security,Citizenship and Immigration Services,null,100.0,100.0,0,0,1010952,1232,30,06,2,2020,2020-06-30,3,2020,1010952,1232
Agency,National Science Foundation,null,CFO,100.0,100.0,0,0,489553,86,30,06,2,2020,2020-06-30,3,2020,489553,86
Agency,Department of Energy,null,CFO,100.0,100.0,0,0,15081450,99,30,06,2,2020,2020-06-30,3,2020,15081450,99
Agency,Department of Commerce,null,CFO,100.0,100.0,0,0,22907214,1682,30,06,2,2020,2020-06-30,3,2020,22907214,1682
Agency,Small Business Administration,null,CFO,100.0,100.0,0,0,12345902479,120727,30,06,2,2020,2020-06-30,3,2020,12345902479,120727
Agency,Department of Education,null,CFO,94.80444694140935,91.5730560629105,7838276635,2280816,143026829478,24784939,30,06,2,2020,2020-06-30,3,2020,150865106113,27065755
Agency,Federal Labor Relations Authority,null,Non-CFO,0.0,0.0,0,0,0,0,30,06,2,2020,2020-06-30,3,2020,0,0
Agency,Office of Government Ethics,null,Non-CFO,0.0,0.0,0,0,0,0,30,06,2,2020,2020-06-30,3,2020,0,0
Agency,Legislative Branch-Office of Tech.,null,Non-CFO,0.0,0.0,0,0,0,0,30,06,2,2020,2020-06-30,3,2020,0,0
Agency,Legislative Branch - U.S. House/Senate,null,Non-CFO,0.0,0.0,249325,187,0,0,30,06,2,2020,2020-06-30,3,2020,249325,187
Agency,Department of Housing and Urban Development,null,CFO,100.0,100.0,0,0,176955627,6663,30,06,2,2020,2020-06-30,3,2020,176955627,6663
Agency,Merit Systems Protection Board,null,Non-CFO,100.0,100.0,0,0,144,1,30,06,2,2020,2020-06-30,3,2020,144,1
Agency,Equal Employment Opportunity Commission,null,Non-CFO,100.0,100.0,0,0,38394,20,30,06,2,2020,2020-06-30,3,2020,38394,20
Agency,Federal Communications Commission,null,Non-CFO,100.0,100.0,0,0,186638852,14571,30,06,2,2020,2020-06-30,3,2020,186638852,14571
Agency,Commodity Futures Trading Commission,null,Non-CFO,100.0,100.0,0,0,646950459,366,30,06,2,2020,2020-06-30,3,2020,646950459,366
Agency,Federal Maritime Commission,null,Non-CFO,100.0,100.0,0,0,390457,5,30,06,2,2020,2020-06-30,3,2020,390457,5
Agency,Presidio Trust Corporation,null,Non-CFO,95.69329905512336,91.76470588235294,64495,7,1433055,78,30,06,2,2020,2020-06-30,3,2020,1497550,85
Agency,Pension Benefit Guaranty Corp,null,Non-CFO,100.0,100.0,0,0,3920900,1620,30,06,2,2020,2020-06-30,3,2020,3920900,1620
Agency,Export - Import  Bank,null,Non-CFO,0.0,0.0,0,0,0,0,30,06,2,2020,2020-06-30,3,2020,0,0
Agency,Federal Deposit Insurance Corporation,null,Non-CFO,0.0,0.0,0,0,0,0,30,06,2,2020,2020-06-30,3,2020,0,0
Bureau,Occupational Safety & Health Rev Comm,Occupational Safety & Health Rev Comm,null,0.0,0.0,0,0,0,0,30,06,2,2020,2020-06-30,3,2020,0,0
Bureau,Department of Housing and Urban Development,Community Planning and Development,null,0.0,0.0,0,0,0,0,30,06,2,2020,2020-06-30,3,2020,0,0
Bureau,Department of Housing and Urban Development,"Policy, Development and Research",null,0.0,0.0,0,0,0,0,30,06,2,2020,2020-06-30,3,2020,0,0
Bureau,Other Agencies,Advisory Council on Hist. Preservation,null,0.0,0.0,0,0,0,0,30,06,2,2020,2020-06-30,3,2020,0,0
Bureau,Department of the Treasury,International Monetary Funds,null,0.0,0.0,0,0,0,0,30,06,2,2020,2020-06-30,3,2020,0,0
Bureau,Department of the Treasury,Treasury Franchise Fund,null,0.0,0.0,0,0,0,0,30,06,2,2020,2020-06-30,3,2020,0,0
Agency,Tennessee Valley Authority,null,Non-CFO,0.0,0.0,0,0,0,0,30,06,2,2020,2020-06-30,3,2020,0,0
Bureau,Legislative Branch-CBO,Congressional Budget Office,null,0.0,0.0,0,0,0,0,30,06,2,2020,2020-06-30,3,2020,0,0
Agency,National Foundation  Arts & Humanities,null,Non-CFO,0.0,0.0,0,0,0,0,30,06,2,2020,2020-06-30,3,2020,0,0
Bureau,Other Agencies,Privacy & Civil Liberties Oversight Bd,null,0.0,0.0,0,0,0,0,30,06,2,2020,2020-06-30,3,2020,0,0
Bureau,Other Agencies,Federal Housing Finance Agency,null,0.0,0.0,0,0,0,0,30,06,2,2020,2020-06-30,3,2020,0,0
Bureau,Department of the Treasury,Office of Financial Research,null,0.0,0.0,0,0,0,0,30,06,2,2020,2020-06-30,3,2020,0,0
Bureau,Other Agencies/Boards/Commissions,Medicare Payment Advisory Commission,null,0.0,0.0,0,0,0,0,30,06,2,2020,2020-06-30,3,2020,0,0
Agency,General Services Administration,null,CFO,76.40319872242955,56.70906852687731,1397223,1055,4524016,1382,30,06,2,2020,2020-06-30,3,2020,5921239,2437
Bureau,Other Agencies,Delta Regional Authority,null,0.0,0.0,0,0,0,0,30,06,2,2020,2020-06-30,3,2020,0,0
Bureau,Funds Appropriated to the President,Peace Corps,null,0.0,0.0,0,0,0,0,30,06,2,2020,2020-06-30,3,2020,0,0
Bureau,Other Agencies,Chemical Safety Board,null,0.0,0.0,0,0,0,0,30,06,2,2020,2020-06-30,3,2020,0,0
Bureau,Federal Labor Relations Authority,Federal Labor Relations Authority,null,0.0,0.0,0,0,0,0,30,06,2,2020,2020-06-30,3,2020,0,0
Bureau,Department of Homeland Security,Info Analysis Infrastructure Prot-NPPD,null,0.0,0.0,0,0,0,0,30,06,2,2020,2020-06-30,3,2020,0,0
Bureau,Department of Housing and Urban Development,Government National Mortgage Association,null,0.0,0.0,0,0,0,0,30,06,2,2020,2020-06-30,3,2020,0,0
Bureau,Other Agencies,Comm. for Purchase from Blind/Handic.,null,0.0,0.0,0,0,0,0,30,06,2,2020,2020-06-30,3,2020,0,0
Bureau,Other Agencies,Gulf Coast Ecosystem Restoration Council,null,0.0,0.0,0,0,0,0,30,06,2,2020,2020-06-30,3,2020,0,0
Agency,Occupational Safety & Health Rev Comm,null,Non-CFO,0.0,0.0,0,0,0,0,30,06,2,2020,2020-06-30,3,2020,0,0
Bureau,Department of the Interior,Bureau of Safety and Environmental Enf.,null,0.0,0.0,0,0,0,0,30,06,2,2020,2020-06-30,3,2020,0,0
Agency,Environmental Protection Agency,null,CFO,100.0,100.0,0,0,24014850,219,30,06,2,2020,2020-06-30,3,2020,24014850,219
Agency,Department of Labor,null,CFO,76.9609837401743,36.74197165493281,44656610,34413,149173758,19988,30,06,2,2020,2020-06-30,3,2020,193830368,54401
Bureau,Department of Transportation,Surface Transportation Board,null,0.0,0.0,0,0,0,0,30,06,2,2020,2020-06-30,3,2020,0,0
Agency,Department of Justice,null,CFO,89.15792436650644,98.3030142079405,9755032,639,80218810,37016,30,06,2,2020,2020-06-30,3,2020,89973842,37655
Agency,Federal Mediation/Conciliation Service,null,Non-CFO,0.0,0.0,0,0,0,0,30,06,2,2020,2020-06-30,3,2020,0,0
Agency,Office of Special Counsel,null,Non-CFO,0.0,0.0,0,0,0,0,30,06,2,2020,2020-06-30,3,2020,0,0
Agency,Agency for International Development,null,CFO,99.9997827503933,98.30508474576271,72,1,33141530,58,30,06,2,2020,2020-06-30,3,2020,33141602,59
Agency,Department of the Treasury,null,CFO,98.6217852261996,99.4582698493313,604103,32,43228180,5875,30,06,2,2020,2020-06-30,3,2020,43832283,5907
Agency,Overseas Private Investment Corp Accts,null,Non-CFO,0.0,0.0,0,0,0,0,30,06,2,2020,2020-06-30,3,2020,0,0
Agency,Office of Compliance,null,Non-CFO,0.0,0.0,0,0,0,0,30,06,2,2020,2020-06-30,3,2020,0,0
Bureau,National Foundation  Arts & Humanities,National Endowment for the Humanities,null,0.0,0.0,0,0,0,0,30,06,2,2020,2020-06-30,3,2020,0,0
Agency,Legislative Branch-GPO,null,Non-CFO,0.0,0.0,132867,50,0,0,30,06,2,2020,2020-06-30,3,2020,132867,50
Agency,Corp. for National and Community Service,null,Non-CFO,76.520371299345,11.305616338439096,1100389,1216,3586180,155,30,06,2,2020,2020-06-30,3,2020,4686569,1371
Agency,Federal Trade Commission,null,Non-CFO,100.0,100.0,0,0,483073914,57,30,06,2,2020,2020-06-30,3,2020,483073914,57
Bureau,Department of Commerce,Economic and Statistical Analysis,null,0.0,0.0,0,0,0,0,30,06,2,2020,2020-06-30,3,2020,0,0
Bureau,Department of the Treasury,Office of Sec International Affairs,null,0.0,0.0,0,0,0,0,30,06,2,2020,2020-06-30,3,2020,0,0
Bureau,Other Agencies/Boards/Commissions,U.S.-China Security Review Commission,null,0.0,0.0,0,0,0,0,30,06,2,2020,2020-06-30,3,2020,0,0
Bureau,Other Agencies,Defense Nuclear Facilities Safety Board,null,0.0,0.0,0,0,0,0,30,06,2,2020,2020-06-30,3,2020,0,0
Bureau,Other Agencies,Surface Transportation Board,null,0.0,0.0,0,0,0,0,30,06,2,2020,2020-06-30,3,2020,0,0
Bureau,Department of the Treasury,Bureau of Engraving and Printing,null,0.0,0.0,84528,1,0,0,30,06,2,2020,2020-06-30,3,2020,84528,1
Bureau,Department of the Interior,Bureau of Reclamation,null,100.0,100.0,0,0,92509,88,30,06,2,2020,2020-06-30,3,2020,92509,88
Bureau,Department of Homeland Security,Office of the Inspector General DHS,null,100.0,100.0,0,0,99,1,30,06,2,2020,2020-06-30,3,2020,99,1
Bureau,Department of Homeland Security,Domestic Nuclear Detection Office,null,0.0,0.0,536,7,0,0,30,06,2,2020,2020-06-30,3,2020,536,7
Bureau,Department of Labor,Bureau of Labor Statistics,null,100.0,100.0,0,0,11281,1,30,06,2,2020,2020-06-30,3,2020,11281,1
Bureau,Department of Transportation,St. Lawrence Seaway Development Corp.,null,24.956901505574073,50.0,13059,1,4343,1,30,06,2,2020,2020-06-30,3,2020,17402,2
Bureau,Equal Employment Opportunity Commission,Equal Employment Opportunity Commission,null,100.0,100.0,0,0,38394,20,30,06,2,2020,2020-06-30,3,2020,38394,20
Bureau,Department of Justice,Federal Bureau of Investigation,null,89.0981602789046,98.48484848484848,28675,1,234354,65,30,06,2,2020,2020-06-30,3,2020,263029,66
Bureau,Securities & Exchange Commission,Securities and Exchange Commission,null,100.0,100.0,0,0,309291,57,30,06,2,2020,2020-06-30,3,2020,309291,57
Bureau,Department of Commerce,Patent and Trademark Office,null,100.0,100.0,0,0,413077,506,30,06,2,2020,2020-06-30,3,2020,413077,506
Bureau,Department of Veterans Affairs,Housing Credit Assistance,null,24.857321086623624,41.935483870967744,760096,18,251441,13,30,06,2,2020,2020-06-30,3,2020,1011537,31
Agency,Department of Transportation,null,CFO,99.87859276927749,99.80980844993887,77743,14,63957158,7347,30,06,2,2020,2020-06-30,3,2020,64034901,7361
Bureau,Department of the Treasury,Internal Revenue Service,null,100.0,100.0,0,0,263359,131,30,06,2,2020,2020-06-30,3,2020,263359,131
Bureau,Department of Commerce,Nat'l Telecomm & Information Admin.,null,100.0,100.0,0,0,296093,1,30,06,2,2020,2020-06-30,3,2020,296093,1
Agency,Farm Credit Administration,null,Non-CFO,100.0,100.0,0,0,630,1,30,06,2,2020,2020-06-30,3,2020,630,1
Agency,Other Agencies/Boards/Commissions,null,Non-CFO,0.0,0.0,1083,2,0,0,30,06,2,2020,2020-06-30,3,2020,1083,2
Agency,Smithsonian Institution,null,Non-CFO,0.0,0.0,9780,2,0,0,30,06,2,2020,2020-06-30,3,2020,9780,2
Bureau,Merit Systems Protection Board,Merit Systems Protection Board,null,100.0,100.0,0,0,144,1,30,06,2,2020,2020-06-30,3,2020,144,1
Bureau,Department of the Treasury,D.C. Pension Program,null,100.0,100.0,0,0,398640,22,30,06,2,2020,2020-06-30,3,2020,398640,22
Bureau,Other Agencies,Millennium Challenge Corporation,null,100.0,100.0,0,0,545,1,30,06,2,2020,2020-06-30,3,2020,545,1
Bureau,Other Agencies,Archit.&Trans. Barriers Compliance Bd,null,0.0,0.0,809,1,0,0,30,06,2,2020,2020-06-30,3,2020,809,1
Bureau,Department of the Treasury,Tobacco Tax and Trade,null,100.0,100.0,0,0,1000,1,30,06,2,2020,2020-06-30,3,2020,1000,1
Bureau,Other Agencies,John C. Stennis,null,0.0,0.0,1467,2,0,0,30,06,2,2020,2020-06-30,3,2020,1467,2
Bureau,Other Agencies,National Council on Disability,null,0.0,0.0,1579,2,0,0,30,06,2,2020,2020-06-30,3,2020,1579,2
Agency,Armed Forces Retirement Home,null,Non-CFO,100.0,100.0,0,0,78519,104,30,06,2,2020,2020-06-30,3,2020,78519,104
Agency,National Archives & Records Admin,null,Non-CFO,98.62298411543591,98.11320754716981,1817,2,130135,104,30,06,2,2020,2020-06-30,3,2020,131952,106
Bureau,Department of Homeland Security,Office of Health Affairs,null,0.0,0.0,0,0,0,0,30,06,2,2020,2020-06-30,3,2020,0,0
Agency,Federal Election Commission,null,Non-CFO,100.0,100.0,0,0,604297,105,30,06,2,2020,2020-06-30,3,2020,604297,105
Agency,Funds Appropriated to the President,null,Non-CFO,0.0,0.0,791105,4,0,0,30,06,2,2020,2020-06-30,3,2020,791105,4
Bureau,National Science Foundation,National Science Foundation,null,100.0,100.0,0,0,489553,86,30,06,2,2020,2020-06-30,3,2020,489553,86
Bureau,Department of the Interior,Fish and Wildlife Service,null,100.0,100.0,0,0,606963,82,30,06,2,2020,2020-06-30,3,2020,606963,82
Bureau,Department of Commerce,Nat'l Institute of Standards& Technology,null,100.0,100.0,0,0,670559,5,30,06,2,2020,2020-06-30,3,2020,670559,5
Bureau,Department of Health & Human Services,Substance Abuse & Mental Health Admin.,null,100.0,100.0,0,0,987293,13,30,06,2,2020,2020-06-30,3,2020,987293,13
Bureau,Department of Homeland Security,Office of Biometric Identity Management,null,0.0,0.0,0,0,0,0,30,06,2,2020,2020-06-30,3,2020,0,0
Agency,National Aeronautics and Space Administration,null,CFO,100.0,100.0,0,0,1242361,128,30,06,2,2020,2020-06-30,3,2020,1242361,128
Agency,Nuclear Regulatory Commission,null,CFO,98.23804248150407,97.95918367346938,42463,6,2367527,288,30,06,2,2020,2020-06-30,3,2020,2409990,294
Agency,The Judiciary,null,Non-CFO,90.5029815487949,59.44272445820433,108506,131,1034021,192,30,06,2,2020,2020-06-30,3,2020,1142527,323
Bureau,Federal Election Commission,Federal Election Commission,null,100.0,100.0,0,0,604297,105,30,06,2,2020,2020-06-30,3,2020,604297,105
Bureau,Department of the Treasury,Comptroller of the Currency,null,99.77174152925969,75.0,2534,7,1107611,21,30,06,2,2020,2020-06-30,3,2020,1110145,28
Bureau,Nuclear Regulatory Commission,Nuclear Regulatory Commission,null,98.23804248150407,97.95918367346938,42463,6,2367527,288,30,06,2,2020,2020-06-30,3,2020,2409990,294
Bureau,Department of Health & Human Services,Food and Drug Administration,null,70.27495672281503,17.1585557299843,13734818,5277,32471399,1093,30,06,2,2020,2020-06-30,3,2020,46206217,6370
Bureau,Department of State,Civil Monetary Penalties,null,0.0,0.0,0,0,0,0,30,06,2,2020,2020-06-30,3,2020,0,0
Bureau,The Judiciary,Administrative Office of the U.S. Courts,null,90.5029815487949,59.44272445820433,108506,131,1034021,192,30,06,2,2020,2020-06-30,3,2020,1142527,323
Bureau,Department of Commerce,Bureau of Industry and Security,null,100.0,100.0,0,0,1725097,23,30,06,2,2020,2020-06-30,3,2020,1725097,23
Bureau,Department of Transportation,Federal Aviation Administration,null,97.02391167619143,95.92476489028213,64684,13,2108773,306,30,06,2,2020,2020-06-30,3,2020,2173457,319
Bureau,Funds Appropriated to the President,Inter-American Foundation,null,0.0,0.0,0,0,0,0,30,06,2,2020,2020-06-30,3,2020,0,0
Bureau,Tennessee Valley Authority,Tennessee Valley Authority,null,0.0,0.0,0,0,0,0,30,06,2,2020,2020-06-30,3,2020,0,0
Bureau,Department of Veterans Affairs,Administration and Cemeteries,null,0.11623879066008058,0.6830601092896175,2975749,727,3463,5,30,06,2,2020,2020-06-30,3,2020,2979212,732
Bureau,Department of the Interior,Office of Natural Resources Revenue,null,100.0,100.0,0,0,3868467,408,30,06,2,2020,2020-06-30,3,2020,3868467,408
Agency,Department of Homeland Security,null,CFO,99.79549890043077,99.59445172081867,758536,257,370161719,63114,30,06,2,2020,2020-06-30,3,2020,370920255,63371
Bureau,Department of Housing and Urban Development,Public and Indian Housing Programs,null,100.0,100.0,0,0,564,1,30,06,2,2020,2020-06-30,3,2020,564,1
Bureau,Department of Transportation,Research Innovative Technology Admin,null,100.0,100.0,0,0,1581,2,30,06,2,2020,2020-06-30,3,2020,1581,2
Bureau,Department of Transportation,Maritime Administration,null,100.0,100.0,0,0,2969,4,30,06,2,2020,2020-06-30,3,2020,2969,4
Bureau,Department of Transportation,National Highway Traffic Safety Admin.,null,100.0,100.0,0,0,19109,4,30,06,2,2020,2020-06-30,3,2020,19109,4
Bureau,Presidio Trust Corporation,Presidio Trust Corporation,null,95.69329905512336,91.76470588235294,64495,7,1433055,78,30,06,2,2020,2020-06-30,3,2020,1497550,85
Bureau,Department of Labor,Employee Benefit Security Administration,null,100.0,100.0,0,0,16677336,361,30,06,2,2020,2020-06-30,3,2020,16677336,361
Bureau,Department of the Interior,Bureau of Indian Affairs,null,99.93143428188303,99.93597495909512,13769,18,20067695,28096,30,06,2,2020,2020-06-30,3,2020,20081464,28114
Bureau,Environmental Protection Agency,Environmental Protection Agency,null,100.0,100.0,0,0,24014850,219,30,06,2,2020,2020-06-30,3,2020,24014850,219
Bureau,Office of Personnel Management,Office of Personnel Management,null,91.45907540922003,85.4153455928979,2112857,230,22625179,1347,30,06,2,2020,2020-06-30,3,2020,24738036,1577
Bureau,Department of Health & Human Services,Administration for Children and Families,null,100.0,100.0,0,0,29819544,1686,30,06,2,2020,2020-06-30,3,2020,29819544,1686
Bureau,Department of Agriculture,U.S. Department of Agriculture,null,88.11659474987617,63.90339425587467,3748843,1106,27798032,1958,30,06,2,2020,2020-06-30,3,2020,31546875,3064
Bureau,Department of Transportation,Federal Motor Carrier Safety Admin,null,100.0,100.0,0,0,59385795,6966,30,06,2,2020,2020-06-30,3,2020,59385795,6966
Bureau,Other Agencies,National Capital Planning Commission,null,0.0,0.0,0,0,0,0,30,06,2,2020,2020-06-30,3,2020,0,0
Bureau,Office of Government Ethics,Office of Government Ethics,null,0.0,0.0,0,0,0,0,30,06,2,2020,2020-06-30,3,2020,0,0
Agency,Department of Defense,null,CFO,48.32806036372531,23.979698979206795,1190267981,926727,1113241408,292325,30,06,2,2020,2020-06-30,3,2020,2303509389,1219052
Bureau,Agency for International Development,Agency for International Development,null,99.9997827503933,98.30508474576271,72,1,33141530,58,30,06,2,2020,2020-06-30,3,2020,33141602,59
Bureau,Department of Agriculture,Forest Service,null,93.62885266982232,19.607843137254903,4163415,1189,61184548,290,30,06,2,2020,2020-06-30,3,2020,65347963,1479
Bureau,Department of Homeland Security,U.S. Secret Service,null,0.0,0.0,0,0,0,0,30,06,2,2020,2020-06-30,3,2020,0,0
Bureau,Department of Health & Human Services,Administration for Community Living,null,0.0,0.0,0,0,0,0,30,06,2,2020,2020-06-30,3,2020,0,0
Bureau,Neighborhood Reinvestment Corporation,Neighborhood Reinvestment Corporation,null,0.0,0.0,0,0,0,0,30,06,2,2020,2020-06-30,3,2020,0,0
Bureau,Federal Mediation/Conciliation Service,Federal Mediation/Conciliation Service,null,0.0,0.0,0,0,0,0,30,06,2,2020,2020-06-30,3,2020,0,0
Bureau,Department of Transportation,Office of the Inspector General,null,100.0,100.0,0,0,209,1,30,06,2,2020,2020-06-30,3,2020,209,1
Bureau,Department of the Treasury,U.S. Mint,null,99.34289127837515,95.83333333333333,308,1,46564,23,30,06,2,2020,2020-06-30,3,2020,46872,24
Bureau,Department of the Interior,Office of Surface Mining,null,100.0,100.0,0,0,2770270,298,30,06,2,2020,2020-06-30,3,2020,2770270,298
Bureau,Department of State,Passport NSF,null,100.0,100.0,0,0,2518916,16181,30,06,2,2020,2020-06-30,3,2020,2518916,16181
Bureau,Smithsonian Institution,National Gallery of Art,null,0.0,0.0,0,0,0,0,30,06,2,2020,2020-06-30,3,2020,0,0
Agency,Department of Health & Human Services,null,CFO,98.70798156259934,98.45287407820112,129361105,18716,9882965442,1191011,30,06,2,2020,2020-06-30,3,2020,10012326547,1209727
Bureau,Other Agencies,Federal Housing Finance Agency OIG,null,0.0,0.0,0,0,0,0,30,06,2,2020,2020-06-30,3,2020,0,0
Bureau,Department of Transportation,Federal Highway Administration,null,100.0,100.0,0,0,110600,6,30,06,2,2020,2020-06-30,3,2020,110600,6
Bureau,Department of Homeland Security,U.S. Coast Guard,null,99.0626080613184,97.88045782111064,758000,250,80104654,11545,30,06,2,2020,2020-06-30,3,2020,80862654,11795
Bureau,Department of Labor,Employment Standards Administration,null,67.35613903686914,8.662888835302628,28189360,30302,58164886,2874,30,06,2,2020,2020-06-30,3,2020,86354246,33176
Bureau,Department of Health & Human Services,Health Resources and Services Admin,null,100.0,100.0,0,0,86555722,547,30,06,2,2020,2020-06-30,3,2020,86555722,547
Bureau,Department of Veterans Affairs,Veterans Benefits,null,94.12871010403937,82.46132792453753,8638710,7177,138496079,33744,30,06,2,2020,2020-06-30,3,2020,147134789,40921
Agency,U.S. Postal Service,null,Non-CFO,57.387025259756165,81.52200459141308,32414498,11349,43652705,50070,30,06,2,2020,2020-06-30,3,2020,76067203,61419
Bureau,Department of the Treasury,Departmental Offices,null,97.83460180044693,98.32727272727273,516733,23,23346453,1352,30,06,2,2020,2020-06-30,3,2020,23863186,1375
Bureau,Other Agencies,District of Columbia Government,null,0.0,0.0,0,0,0,0,30,06,2,2020,2020-06-30,3,2020,0,0
Bureau,Department of Housing and Urban Development,Housing Programs,null,100.0,100.0,0,0,176951741,6657,30,06,2,2020,2020-06-30,3,2020,176951741,6657
Bureau,Federal Communications Commission,Federal Communications Commission,null,100.0,100.0,0,0,186638852,14571,30,06,2,2020,2020-06-30,3,2020,186638852,14571
Bureau,US International Development Fin. Corp.,US International Development Fin. Corp.,null,0.0,0.0,0,0,0,0,30,06,2,2020,2020-06-30,3,2020,0,0
Bureau,Social Security Administration,Social Security Administration,null,53.380721051731555,30.512212180314485,2582701955,1175363,2957284963,516104,30,06,2,2020,2020-06-30,3,2020,5539986918,1691467
Bureau,Department of the Treasury,Bureau of the Fiscal Service,null,100.0,100.0,0,0,13076243,4315,30,06,2,2020,2020-06-30,3,2020,13076243,4315
Bureau,Office of Compliance,Office of Compliance,null,0.0,0.0,0,0,0,0,30,06,2,2020,2020-06-30,3,2020,0,0
Bureau,U.S. Court of Appeals / Veterans Claims,U.S. Court of Appeals / Veterans Claims,null,100.0,100.0,0,0,170,1,30,06,2,2020,2020-06-30,3,2020,170,1
Bureau,Other Agencies,Commission On Fine Arts,null,0.0,0.0,0,0,0,0,30,06,2,2020,2020-06-30,3,2020,0,0
Agency,Department of Agriculture,null,CFO,99.28425961816444,91.7263546860368,9229696,3269,1280301569,36242,30,06,2,2020,2020-06-30,3,2020,1289531265,39511
Bureau,Department of the Treasury,Interest on Tax/Deposit of Earnings,null,0.0,0.0,0,0,0,0,30,06,2,2020,2020-06-30,3,2020,0,0
Bureau,Small Business Administration,Small Business Administration,null,100.0,100.0,0,0,12345902479,120727,30,06,2,2020,2020-06-30,3,2020,12345902479,120727
Bureau,Department of Commerce,Office of the Inspector General,null,0.0,0.0,0,0,0,0,30,06,2,2020,2020-06-30,3,2020,0,0
Bureau,Department of the Interior,Bureau of Land Management,null,100.0,100.0,0,0,15843183,315,30,06,2,2020,2020-06-30,3,2020,15843183,315
Bureau,Department of Education,Office of Postsecondary Education,null,0.0,0.0,0,0,0,0,30,06,2,2020,2020-06-30,3,2020,0,0
Bureau,Legislative Branch-Office of Tech.,Medicaid & CHIP Payment & Access Comm.,null,0.0,0.0,0,0,0,0,30,06,2,2020,2020-06-30,3,2020,0,0
Bureau,Department of Justice,General Administration,null,0.0,0.0,0,0,0,0,30,06,2,2020,2020-06-30,3,2020,0,0
Bureau,Funds Appropriated to the President,African Development Foundation,null,0.0,0.0,0,0,0,0,30,06,2,2020,2020-06-30,3,2020,0,0
Bureau,Selective Service System,Selective Service System,null,0.0,0.0,0,0,0,0,30,06,2,2020,2020-06-30,3,2020,0,0
Bureau,Department of the Interior,"Bureau of Ocean Energy Mgmt., Reg & Enf",null,0.0,0.0,0,0,0,0,30,06,2,2020,2020-06-30,3,2020,0,0
Bureau,Department of Homeland Security,Federal Law Enforcement Training Ctr.,null,0.0,0.0,0,0,0,0,30,06,2,2020,2020-06-30,3,2020,0,0
Bureau,American Battle Monuments Commission,American Battle Monuments Commission,null,0.0,0.0,0,0,0,0,30,06,2,2020,2020-06-30,3,2020,0,0
Bureau,Department of Commerce,International Trade Administration,null,100.0,100.0,0,0,2740,1,30,06,2,2020,2020-06-30,3,2020,2740,1
Bureau,Other Agencies,Council of Insps. Gen. of Intg. & Effy.,null,0.0,0.0,3600,6,0,0,30,06,2,2020,2020-06-30,3,2020,3600,6
Bureau,Department of Agriculture,Federal Crop Insurance Corporation,null,86.97095182997381,99.7752808988764,4279,1,28563,444,30,06,2,2020,2020-06-30,3,2020,32842,445
Agency,Office of Personnel Management,null,CFO,91.45907540922003,85.4153455928979,2112857,230,22625179,1347,30,06,2,2020,2020-06-30,3,2020,24738036,1577
Agency,Securities & Exchange Commission,null,Non-CFO,100.0,100.0,0,0,2090300273,1072,30,06,2,2020,2020-06-30,3,2020,2090300273,1072
Bureau,Consumer Product Safety Commission,Consumer Product Safety Commission,null,100.0,100.0,0,0,479,1,30,06,2,2020,2020-06-30,3,2020,479,1
Bureau,Other Agencies,National Transportation Safety Board,null,0.0,0.0,0,0,0,0,30,06,2,2020,2020-06-30,3,2020,0,0
Bureau,National Archives & Records Admin,Nat'l Archives & Records Administration,null,98.62298411543591,98.11320754716981,1817,2,130135,104,30,06,2,2020,2020-06-30,3,2020,131952,106
Bureau,Department of Agriculture,Food Safety and Inspection Service,null,99.6670710679001,99.64912280701755,2371,3,709793,852,30,06,2,2020,2020-06-30,3,2020,712164,855
Bureau,Other Agencies,Election Assistance Commission,null,0.0,0.0,0,0,0,0,30,06,2,2020,2020-06-30,3,2020,0,0
Bureau,Department of Transportation,Federal Transit Administration,null,100.0,100.0,0,0,784517,2,30,06,2,2020,2020-06-30,3,2020,784517,2
Bureau,Funds Appropriated to the President,Trade and Development Agency,null,0.0,0.0,791105,4,0,0,30,06,2,2020,2020-06-30,3,2020,791105,4
Bureau,Department of Commerce,Bureau of the Census,null,100.0,100.0,0,0,250622,296,30,06,2,2020,2020-06-30,3,2020,250622,296
Bureau,Department of Veterans Affairs,Medical and Construction,null,76.54104065421541,98.80332087236462,147018390,100535,479686264,8300631,30,06,2,2020,2020-06-30,3,2020,626704654,8401166
Bureau,Department of Education,Federal Student Aid,null,94.96723893076106,91.57382200984163,7541064277,2280425,142298440783,24783150,30,06,2,2020,2020-06-30,3,2020,149839505060,27063575
Bureau,Department of Justice,Federal Prison System,null,100.0,100.0,0,0,877499,125,30,06,2,2020,2020-06-30,3,2020,877499,125
Bureau,Department of Agriculture,Food and Nutrition Service,null,10.085061233297965,17.073170731707318,449991,34,50472,7,30,06,2,2020,2020-06-30,3,2020,500463,41
Bureau,Department of Housing and Urban Development,Management and Administration,null,100.0,100.0,0,0,3322,5,30,06,2,2020,2020-06-30,3,2020,3322,5
Bureau,Department of Health & Human Services,National Institutes of Health,null,39.645707041476264,24.43324937027708,8587481,300,5640970,97,30,06,2,2020,2020-06-30,3,2020,14228451,397
Bureau,Department of Health & Human Services,Centers for Disease Control,null,1.9708638082379923,9.63855421686747,7140307,150,143555,16,30,06,2,2020,2020-06-30,3,2020,7283862,166
Agency,U.S. Court of Appeals / Veterans Claims,null,Non-CFO,100.0,100.0,0,0,170,1,30,06,2,2020,2020-06-30,3,2020,170,1
Bureau,Other Agencies/Boards/Commissions,U.S. Comm. on Int. Religious Freedom,null,0.0,0.0,1083,2,0,0,30,06,2,2020,2020-06-30,3,2020,1083,2
Agency,Department of Veterans Affairs,null,CFO,79.52420929712824,98.71540510670826,159393443,108458,619054849,8334515,30,06,2,2020,2020-06-30,3,2020,778448292,8442973
Bureau,Department of Energy,Bonneville Power Administration,null,100.0,100.0,0,0,1100046,39,30,06,2,2020,2020-06-30,3,2020,1100046,39
Bureau,Department of the Treasury,Community Dev Financial Inst Fund,null,100.0,100.0,0,0,3439449,6,30,06,2,2020,2020-06-30,3,2020,3439449,6
Agency,Department of State,null,CFO,98.8180645625654,99.80168139685277,200995,46,16804587,23149,30,06,2,2020,2020-06-30,3,2020,17005582,23195
Agency,Department of the Interior,null,CFO,99.97313185561856,99.94261485000159,13769,18,51232792,31349,30,06,2,2020,2020-06-30,3,2020,51246561,31367
Agency,Consumer Product Safety Commission,null,Non-CFO,100.0,100.0,0,0,479,1,30,06,2,2020,2020-06-30,3,2020,479,1
Bureau,Department of Labor,Mine Safety and Health Administration,null,72.40471745917849,77.3159825728044,11218821,3957,29436030,13487,30,06,2,2020,2020-06-30,3,2020,40654851,17444
Bureau,Department of Agriculture,Commodity Credit Corporation,null,100.0,100.0,0,0,134440537,10992,30,06,2,2020,2020-06-30,3,2020,134440537,10992
Bureau,Legislative Branch-GAO,Government Accountability Office,null,0.0,0.0,0,0,0,0,30,06,2,2020,2020-06-30,3,2020,0,0
Bureau,Department of the Treasury,Spec Insp Gen-Troubled Asset Rel Prog,null,100.0,100.0,0,0,3916,1,30,06,2,2020,2020-06-30,3,2020,3916,1
Bureau,Legislative Branch - U.S. House/Senate,U.S. House of Representatives,null,0.0,0.0,249325,187,0,0,30,06,2,2020,2020-06-30,3,2020,249325,187
Bureau,Federal Maritime Commission,Salaries and Expenses,null,100.0,100.0,0,0,390457,5,30,06,2,2020,2020-06-30,3,2020,390457,5
Bureau,Corp. for National and Community Service,Corp. for National and Community Service,null,76.520371299345,11.305616338439096,1100389,1216,3586180,155,30,06,2,2020,2020-06-30,3,2020,4686569,1371
Bureau,Other Agencies,U.S.  Agency of Global Media,null,100.0,100.0,0,0,4930,2,30,06,2,2020,2020-06-30,3,2020,4930,2
Bureau,Department of Defense,Consolidated Report,null,48.32806036372531,23.979698979206795,1190267981,926727,1113241408,292325,30,06,2,2020,2020-06-30,3,2020,2303509389,1219052
Bureau,Department of Transportation,Federal Railroad Administration,null,100.0,100.0,0,0,165063,15,30,06,2,2020,2020-06-30,3,2020,165063,15
Bureau,Legislative Branch-GPO,Government Publishing Office,null,0.0,0.0,132867,50,0,0,30,06,2,2020,2020-06-30,3,2020,132867,50
Bureau,Department of Veterans Affairs,Life Insurance,null,99.919430512862,99.1869918699187,498,1,617602,122,30,06,2,2020,2020-06-30,3,2020,618100,123
Bureau,Department of Labor,Departmental Management,null,0.0,0.0,0,0,0,0,30,06,2,2020,2020-06-30,3,2020,0,0
Bureau,Department of the Treasury,Treasury IG for Tax Admin,null,0.0,0.0,0,0,0,0,30,06,2,2020,2020-06-30,3,2020,0,0
Bureau,Smithsonian Institution,JFK Center for the Performing Arts,null,0.0,0.0,0,0,0,0,30,06,2,2020,2020-06-30,3,2020,0,0
Bureau,Department of Commerce,NOAA,null,100.0,100.0,0,0,14451524,840,30,06,2,2020,2020-06-30,3,2020,14451524,840
Bureau,Railroad Retirement Board,Railroad Retirement Board,null,100.0,100.0,0,0,21736838,4387,30,06,2,2020,2020-06-30,3,2020,21736838,4387
Bureau,Department of the Interior,Geological Survey,null,100.0,100.0,0,0,208651,147,30,06,2,2020,2020-06-30,3,2020,208651,147
Bureau,Other Agencies,James Madison Memorial Fellowship,null,0.0,0.0,221291,25,0,0,30,06,2,2020,2020-06-30,3,2020,221291,25
Bureau,Department of the Treasury,Financial Crimes Enforcement Network,null,100.0,100.0,0,0,1544945,3,30,06,2,2020,2020-06-30,3,2020,1544945,3
Bureau,Department of the Treasury,U.S. Treasury IG Office,null,0.0,0.0,0,0,0,0,30,06,2,2020,2020-06-30,3,2020,0,0
Bureau,Department of Justice,U.S. Marshals Service,null,0.0,0.0,2848,2,0,0,30,06,2,2020,2020-06-30,3,2020,2848,2
Agency,Selective Service System,null,Non-CFO,0.0,0.0,0,0,0,0,30,06,2,2020,2020-06-30,3,2020,0,0
Bureau,Department of Agriculture,Agricultural Marketing Service,null,84.15884102836242,34.184397163120565,846581,928,4497605,482,30,06,2,2020,2020-06-30,3,2020,5344186,1410
Bureau,Funds Appropriated to the President,Defense Security Assistance Agency,null,0.0,0.0,0,0,0,0,30,06,2,2020,2020-06-30,3,2020,0,0
Bureau,Department of Transportation,Office of the Secretary,null,100.0,100.0,0,0,1026163,17,30,06,2,2020,2020-06-30,3,2020,1026163,17
Bureau,Other Agencies,U.S. Institute of Peace,null,0.0,0.0,0,0,0,0,30,06,2,2020,2020-06-30,3,2020,0,0
Bureau,Department of Commerce,General Administration,null,100.0,100.0,0,0,4660,1,30,06,2,2020,2020-06-30,3,2020,4660,1
Bureau,Smithsonian Institution,Smithsonian Institution,null,0.0,0.0,9780,2,0,0,30,06,2,2020,2020-06-30,3,2020,9780,2
Agency,Legislative Branch-CBO,null,Non-CFO,0.0,0.0,0,0,0,0,30,06,2,2020,2020-06-30,3,2020,0,0
Bureau,Department of the Interior,National Park Service,null,100.0,100.0,0,0,7698374,1881,30,06,2,2020,2020-06-30,3,2020,7698374,1881
Bureau,Federal Trade Commission,Federal Trade Commission,null,100.0,100.0,0,0,483073914,57,30,06,2,2020,2020-06-30,3,2020,483073914,57
Bureau,Department of Homeland Security,Immigration and Customs Enforcement,null,100.0,100.0,0,0,12611373,460,30,06,2,2020,2020-06-30,3,2020,12611373,460
Bureau,Department of State,Department of State,null,98.6125517078947,99.34416880524665,200995,46,14285671,6968,30,06,2,2020,2020-06-30,3,2020,14486666,7014
Bureau,Department of Homeland Security,Emergency Preparedness & Resp,null,100.0,100.0,0,0,258920557,43080,30,06,2,2020,2020-06-30,3,2020,258920557,43080
Agency,American Battle Monuments Commission,null,Non-CFO,0.0,0.0,0,0,0,0,30,06,2,2020,2020-06-30,3,2020,0,0
Agency,Social Security Administration,null,CFO,53.380721051731555,30.512212180314485,2582701955,1175363,2957284963,516104,30,06,2,2020,2020-06-30,3,2020,5539986918,1691467
Bureau,Department of Agriculture,Farm Service Agency,null,100.0,100.0,0,0,353709270,5149,30,06,2,2020,2020-06-30,3,2020,353709270,5149
Bureau,Department of Education,Departmental Management,null,71.02066567398502,82.06422018348624,297212358,391,728388695,1789,30,06,2,2020,2020-06-30,3,2020,1025601053,2180
Bureau,Other Agencies,U.S. Inst. for Env. Conflict Resolution,null,0.0,0.0,5003,2,0,0,30,06,2,2020,2020-06-30,3,2020,5003,2
Bureau,Department of Health & Human Services,Office of the Secretary,null,100.0,100.0,0,0,8092,8,30,06,2,2020,2020-06-30,3,2020,8092,8
Bureau,Department of Health & Human Services,Program Support Center,null,100.0,100.0,0,0,6371211,452,30,06,2,2020,2020-06-30,3,2020,6371211,452
Agency,Legislative Branch-GAO,null,Non-CFO,0.0,0.0,0,0,0,0,30,06,2,2020,2020-06-30,3,2020,0,0
Bureau,Department of Justice,Office of Justice Assistance Programs,null,0.0,0.0,0,0,0,0,30,06,2,2020,2020-06-30,3,2020,0,0
Bureau,Department of Justice,Legal Activities,null,88.88196968848241,98.29289242001289,9723509,636,77733610,36620,30,06,2,2020,2020-06-30,3,2020,87457119,37256
Bureau,Commodity Futures Trading Commission,Commodity Futures Trading Commission,null,100.0,100.0,0,0,646950459,366,30,06,2,2020,2020-06-30,3,2020,646950459,366
Bureau,Department of Agriculture,Rural Development,null,99.99796302309468,99.95023637720826,14216,8,697882749,16068,30,06,2,2020,2020-06-30,3,2020,697896965,16076
Bureau,Securities & Exchange Commission,SEC Enforcement,null,100.0,100.0,0,0,2089990982,1015,30,06,2,2020,2020-06-30,3,2020,2089990982,1015
Bureau,Armed Forces Retirement Home,Armed Forces Retirement Home,null,100.0,100.0,0,0,78519,104,30,06,2,2020,2020-06-30,3,2020,78519,104
Bureau,Department of Energy,Energy Consolidated Reports,null,100.0,100.0,0,0,13981404,60,30,06,2,2020,2020-06-30,3,2020,13981404,60
Bureau,Other Agencies,Architect of the Capitol,null,0.0,0.0,0,0,0,0,30,06,2,2020,2020-06-30,3,2020,0,0
Bureau,Other Agencies,Consumer Financial Protection Bureau,null,0.0,0.0,5510394,68,0,0,30,06,2,2020,2020-06-30,3,2020,5510394,68
Bureau,Department of Health & Human Services,Centers for Medicare & Medicaid Services,null,99.2622396177326,99.19202994536926,72039612,9668,9692595862,1186911,30,06,2,2020,2020-06-30,3,2020,9764635474,1196579
Bureau,Farm Credit Administration,Farm Credit Administration,null,100.0,100.0,0,0,630,1,30,06,2,2020,2020-06-30,3,2020,630,1
Bureau,Other Agencies,Morris K. Udall Scholarship,null,0.0,0.0,982,1,0,0,30,06,2,2020,2020-06-30,3,2020,982,1
Bureau,Department of Justice,Bureau of ATF and Explosives,null,100.0,100.0,0,0,20885,4,30,06,2,2020,2020-06-30,3,2020,20885,4
Bureau,Department of Justice,Drug Enforcement Administration,null,100.0,100.0,0,0,309373,19,30,06,2,2020,2020-06-30,3,2020,309373,19
Bureau,Department of Transportation,Pipeline Hazardous Material Safety Admin,null,100.0,100.0,0,0,348036,23,30,06,2,2020,2020-06-30,3,2020,348036,23
Bureau,Department of Justice,Federal Prison Industries,null,100.0,100.0,0,0,1043089,183,30,06,2,2020,2020-06-30,3,2020,1043089,183
Bureau,Department of the Treasury,Office of the Secretary,null,0.0,0.0,0,0,0,0,30,06,2,2020,2020-06-30,3,2020,0,0
Bureau,Other Agencies,Denali Commission,null,0.0,0.0,0,0,0,0,30,06,2,2020,2020-06-30,3,2020,0,0
Bureau,National Aeronautics and Space Administration,National Aeronautics and Space Admin,null,100.0,100.0,0,0,1242361,128,30,06,2,2020,2020-06-30,3,2020,1242361,128
Bureau,Department of Commerce,Economic Development Administration,null,100.0,100.0,0,0,5092842,9,30,06,2,2020,2020-06-30,3,2020,5092842,9
Bureau,Department of Homeland Security,Transportation Safety Administration,null,100.0,100.0,0,0,8703416,5769,30,06,2,2020,2020-06-30,3,2020,8703416,5769
Bureau,Department of Homeland Security,Bureau of Customs & Border Protection,null,100.0,100.0,0,0,8810668,1027,30,06,2,2020,2020-06-30,3,2020,8810668,1027
Bureau,Department of Commerce,Minority Business Development Agency,null,0.0,0.0,0,0,0,0,30,06,2,2020,2020-06-30,3,2020,0,0
Bureau,Department of State,International Commissions,null,0.0,0.0,0,0,0,0,30,06,2,2020,2020-06-30,3,2020,0,0
Bureau,National Credit Union Administration,National Credit Union Administration,null,0.0,0.0,0,0,0,0,30,06,2,2020,2020-06-30,3,2020,0,0
Bureau,Department of the Interior,Office of the Secretary,null,100.0,100.0,0,0,76680,34,30,06,2,2020,2020-06-30,3,2020,76680,34
Bureau,Department of Labor,Employment and Training Administration,null,96.02375973965852,91.66666666666667,140000,1,3380914,11,30,06,2,2020,2020-06-30,3,2020,3520914,12
Bureau,Department of Health & Human Services,Indian Health Services,null,50.456073971432076,5.3576517526360785,27858887,3321,28371794,188,30,06,2,2020,2020-06-30,3,2020,56230681,3509
Bureau,General Services Administration,General Services Administration,null,76.40319872242955,56.70906852687731,1397223,1055,4524016,1382,30,06,2,2020,2020-06-30,3,2020,5921239,2437
Agency,Social Security Administration,null,CFO,52.8055163009144,29.575109479820128,2615747396,1197283,2926738062,502802,30,09,3,2020,2020-09-30,4,2020,5542485458,1700085
Agency,National Credit Union Administration,null,Non-CFO,0.0,0.0,0,0,0,0,30,09,3,2020,2020-09-30,4,2020,0,0
Agency,Other Agencies/Boards/Commissions,null,Non-CFO,0.0,0.0,393,1,0,0,30,09,3,2020,2020-09-30,4,2020,393,1
Agency,Farm Credit Administration,null,Non-CFO,100.0,100.0,0,0,630,1,30,09,3,2020,2020-09-30,4,2020,630,1
Agency,Department of Justice,null,CFO,94.836457102076,99.04039868518714,4733700,362,86941727,37362,30,09,3,2020,2020-09-30,4,2020,91675427,37724
Agency,Department of Transportation,null,CFO,98.82312920760576,99.311622981202,775266,52,65099935,7502,30,09,3,2020,2020-09-30,4,2020,65875201,7554
Agency,Department of the Interior,null,CFO,99.99849684920908,99.94561111950446,1094,18,72779362,33077,30,09,3,2020,2020-09-30,4,2020,72780456,33095
Agency,Department of Homeland Security,null,CFO,99.99982784925781,99.9936720875783,646,4,375251875,63208,30,09,3,2020,2020-09-30,4,2020,375252521,63212
Agency,Nuclear Regulatory Commission,null,CFO,99.2648750080251,98.54545454545455,14542,4,1963625,271,30,09,3,2020,2020-09-30,4,2020,1978167,275
Agency,Department of Energy,null,CFO,95.70871708769764,98.9247311827957,622406,1,13881555,92,30,09,3,2020,2020-09-30,4,2020,14503961,93
Agency,Department of Agriculture,null,CFO,99.18552652637234,93.03010199850733,13030468,3362,1586833545,44874,30,09,3,2020,2020-09-30,4,2020,1599864013,48236
Agency,Department of Defense,null,CFO,47.39146900390913,21.828452077118698,1222021180,1026992,1100836267,286775,30,09,3,2020,2020-09-30,4,2020,2322857447,1313767
Agency,General Services Administration,null,CFO,85.7165548642446,71.07386716325264,1046706,466,6281400,1145,30,09,3,2020,2020-09-30,4,2020,7328106,1611
Agency,Department of Veterans Affairs,null,CFO,5.084305487681049,13.125998022964033,121954056,57124,6532657,8631,30,09,3,2020,2020-09-30,4,2020,128486713,65755
Agency,Department of Housing and Urban Development,null,CFO,99.45290881043796,99.89309712889433,1000059,7,181795610,6541,30,09,3,2020,2020-09-30,4,2020,182795669,6548
Agency,Department of Labor,null,CFO,89.17458111112413,83.25275539501713,22498972,9041,185335683,44944,30,09,3,2020,2020-09-30,4,2020,207834655,53985
Agency,Department of Health & Human Services,null,CFO,98.2315931212534,98.4455733148818,177803944,18938,9876666333,1199389,30,09,3,2020,2020-09-30,4,2020,10054470277,1218327
Agency,Small Business Administration,null,CFO,100.0,100.0,0,0,12344834017,120252,30,09,3,2020,2020-09-30,4,2020,12344834017,120252
Agency,Department of Education,null,CFO,86.43863331930935,89.68000583686752,21761443657,2797795,138705006144,24312637,30,09,3,2020,2020-09-30,4,2020,160466449801,27110432
Agency,Selective Service System,null,Non-CFO,0.0,0.0,0,0,0,0,30,09,3,2020,2020-09-30,4,2020,0,0
Agency,National Foundation  Arts & Humanities,null,Non-CFO,0.0,0.0,0,0,0,0,30,09,3,2020,2020-09-30,4,2020,0,0
Agency,Department of Commerce,null,CFO,100.0,100.0,0,0,22926999,1792,30,09,3,2020,2020-09-30,4,2020,22926999,1792
Agency,National Science Foundation,null,CFO,100.0,100.0,0,0,527693,84,30,09,3,2020,2020-09-30,4,2020,527693,84
Agency,Office of Personnel Management,null,CFO,90.29234255890337,82.67716535433071,2425877,286,22563437,1365,30,09,3,2020,2020-09-30,4,2020,24989314,1651
Agency,Agency for International Development,null,CFO,99.99980134665964,98.33333333333333,70,1,35237193,59,30,09,3,2020,2020-09-30,4,2020,35237263,60
Agency,Federal Deposit Insurance Corporation,null,Non-CFO,0.0,0.0,0,0,0,0,30,09,3,2020,2020-09-30,4,2020,0,0
Agency,Neighborhood Reinvestment Corporation,null,Non-CFO,0.0,0.0,0,0,0,0,30,09,3,2020,2020-09-30,4,2020,0,0
Agency,Environmental Protection Agency,null,CFO,100.0,100.0,0,0,24037442,230,30,09,3,2020,2020-09-30,4,2020,24037442,230
Agency,Export - Import  Bank,null,Non-CFO,0.0,0.0,0,0,0,0,30,09,3,2020,2020-09-30,4,2020,0,0
Agency,American Battle Monuments Commission,null,Non-CFO,0.0,0.0,0,0,0,0,30,09,3,2020,2020-09-30,4,2020,0,0
Agency,Department of the Treasury,null,CFO,98.80461433229765,99.38524590163935,544839,36,45033673,5820,30,09,3,2020,2020-09-30,4,2020,45578512,5856
Agency,Office of Government Ethics,null,Non-CFO,0.0,0.0,0,0,0,0,30,09,3,2020,2020-09-30,4,2020,0,0
Agency,Office of Compliance,null,Non-CFO,0.0,0.0,0,0,0,0,30,09,3,2020,2020-09-30,4,2020,0,0
Agency,Federal Labor Relations Authority,null,Non-CFO,0.0,0.0,0,0,0,0,30,09,3,2020,2020-09-30,4,2020,0,0
Agency,Tennessee Valley Authority,null,Non-CFO,0.0,0.0,0,0,0,0,30,09,3,2020,2020-09-30,4,2020,0,0
Agency,Legislative Branch-GAO,null,Non-CFO,100.0,100.0,0,0,28039,13,30,09,3,2020,2020-09-30,4,2020,28039,13
Agency,Equal Employment Opportunity Commission,null,Non-CFO,100.0,100.0,0,0,35245,20,30,09,3,2020,2020-09-30,4,2020,35245,20
Bureau,Other Agencies,Gulf Coast Ecosystem Restoration Council,null,0.0,0.0,0,0,0,0,30,09,3,2020,2020-09-30,4,2020,0,0
Bureau,National Labor Relations Board,National Labor Relations Board,null,0.0,0.0,0,0,0,0,30,09,3,2020,2020-09-30,4,2020,0,0
Bureau,Department of Agriculture,Commodity Credit Corporation,null,100.0,100.0,0,0,130201388,11516,30,09,3,2020,2020-09-30,4,2020,130201388,11516
Agency,Legislative Branch-CBO,null,Non-CFO,0.0,0.0,0,0,0,0,30,09,3,2020,2020-09-30,4,2020,0,0
Agency,Merit Systems Protection Board,null,Non-CFO,100.0,100.0,0,0,144,1,30,09,3,2020,2020-09-30,4,2020,144,1
Agency,U.S. Court of Appeals / Veterans Claims,null,Non-CFO,100.0,100.0,0,0,171,1,30,09,3,2020,2020-09-30,4,2020,171,1
Agency,Consumer Product Safety Commission,null,Non-CFO,100.0,100.0,0,0,2979,2,30,09,3,2020,2020-09-30,4,2020,2979,2
Agency,Smithsonian Institution,null,Non-CFO,0.0,0.0,5670,1,0,0,30,09,3,2020,2020-09-30,4,2020,5670,1
Agency,National Aeronautics and Space Administration,null,CFO,100.0,100.0,0,0,1267015,136,30,09,3,2020,2020-09-30,4,2020,1267015,136
Agency,Overseas Private Investment Corp Accts,null,Non-CFO,0.0,0.0,0,0,0,0,30,09,3,2020,2020-09-30,4,2020,0,0
Agency,Federal Mediation/Conciliation Service,null,Non-CFO,0.0,0.0,0,0,0,0,30,09,3,2020,2020-09-30,4,2020,0,0
Agency,Occupational Safety & Health Rev Comm,null,Non-CFO,0.0,0.0,0,0,0,0,30,09,3,2020,2020-09-30,4,2020,0,0
Agency,National Labor Relations Board,null,Non-CFO,0.0,0.0,0,0,0,0,30,09,3,2020,2020-09-30,4,2020,0,0
Agency,Office of Special Counsel,null,Non-CFO,0.0,0.0,0,0,0,0,30,09,3,2020,2020-09-30,4,2020,0,0
Agency,Legislative Branch-Office of Tech.,null,Non-CFO,0.0,0.0,0,0,0,0,30,09,3,2020,2020-09-30,4,2020,0,0
Bureau,Smithsonian Institution,JFK Center for the Performing Arts,null,0.0,0.0,0,0,0,0,30,09,3,2020,2020-09-30,4,2020,0,0
Agency,Armed Forces Retirement Home,null,Non-CFO,87.87655657823498,95.41284403669725,11196,5,81154,104,30,09,3,2020,2020-09-30,4,2020,92350,109
Agency,Legis Branch-Library of Congress,null,Non-CFO,0.0,0.0,101139,18,0,0,30,09,3,2020,2020-09-30,4,2020,101139,18
Agency,Legislative Branch-GPO,null,Non-CFO,0.0,0.0,132743,16,0,0,30,09,3,2020,2020-09-30,4,2020,132743,16
Agency,National Archives & Records Admin,null,Non-CFO,70.13732833957553,94.44444444444444,50232,6,117978,102,30,09,3,2020,2020-09-30,4,2020,168210,108
Agency,Legislative Branch - U.S. House/Senate,null,Non-CFO,29.1607516768996,25.423728813559322,159683,132,65733,45,30,09,3,2020,2020-09-30,4,2020,225416,177
Agency,Federal Maritime Commission,null,Non-CFO,100.0,100.0,0,0,475933,7,30,09,3,2020,2020-09-30,4,2020,475933,7
Agency,Federal Election Commission,null,Non-CFO,100.0,100.0,0,0,574671,105,30,09,3,2020,2020-09-30,4,2020,574671,105
Agency,Funds Appropriated to the President,null,Non-CFO,0.0,0.0,791105,4,0,0,30,09,3,2020,2020-09-30,4,2020,791105,4
Agency,The Judiciary,null,Non-CFO,98.84869449750062,59.936908517350155,11965,127,1027290,190,30,09,3,2020,2020-09-30,4,2020,1039255,317
Agency,Presidio Trust Corporation,null,Non-CFO,98.3377670165825,95.18072289156626,25044,4,1481604,79,30,09,3,2020,2020-09-30,4,2020,1506648,83
Agency,Pension Benefit Guaranty Corp,null,Non-CFO,100.0,100.0,0,0,3967058,1483,30,09,3,2020,2020-09-30,4,2020,3967058,1483
Agency,Corp. for National and Community Service,null,Non-CFO,76.94611273094215,11.471698113207546,1074458,1173,3586179,152,30,09,3,2020,2020-09-30,4,2020,4660637,1325
Agency,Other Agencies,null,Non-CFO,0.0977320451591092,1.7857142857142858,5874617,165,5747,3,30,09,3,2020,2020-09-30,4,2020,5880364,168
Agency,Railroad Retirement Board,null,Non-CFO,100.0,100.0,0,0,21927392,4411,30,09,3,2020,2020-09-30,4,2020,21927392,4411
Agency,US International Development Fin. Corp.,null,Non-CFO,0.0,0.0,68649283,6,0,0,30,09,3,2020,2020-09-30,4,2020,68649283,6
Agency,U.S. Postal Service,null,Non-CFO,61.66795048425579,85.14774026599265,27657836,7404,44495457,42447,30,09,3,2020,2020-09-30,4,2020,72153293,49851
Agency,Federal Communications Commission,null,Non-CFO,100.0,100.0,0,0,182392877,7629,30,09,3,2020,2020-09-30,4,2020,182392877,7629
Agency,Federal Trade Commission,null,Non-CFO,100.0,100.0,0,0,483063621,56,30,09,3,2020,2020-09-30,4,2020,483063621,56
Agency,Commodity Futures Trading Commission,null,Non-CFO,100.0,100.0,0,0,649461611,366,30,09,3,2020,2020-09-30,4,2020,649461611,366
Agency,Securities & Exchange Commission,null,Non-CFO,100.0,100.0,0,0,1902795132,983,30,09,3,2020,2020-09-30,4,2020,1902795132,983
Bureau,Legislative Branch-Office of Tech.,Medicaid & CHIP Payment & Access Comm.,null,0.0,0.0,0,0,0,0,30,09,3,2020,2020-09-30,4,2020,0,0
Bureau,The Judiciary,Administrative Office of the U.S. Courts,null,98.84869449750062,59.936908517350155,11965,127,1027290,190,30,09,3,2020,2020-09-30,4,2020,1039255,317
Bureau,Funds Appropriated to the President,Peace Corps,null,0.0,0.0,0,0,0,0,30,09,3,2020,2020-09-30,4,2020,0,0
Bureau,Funds Appropriated to the President,African Development Foundation,null,0.0,0.0,0,0,0,0,30,09,3,2020,2020-09-30,4,2020,0,0
Bureau,Department of Commerce,Minority Business Development Agency,null,0.0,0.0,0,0,0,0,30,09,3,2020,2020-09-30,4,2020,0,0
Bureau,Other Agencies,Privacy & Civil Liberties Oversight Bd,null,0.0,0.0,0,0,0,0,30,09,3,2020,2020-09-30,4,2020,0,0
Bureau,Other Agencies,Delta Regional Authority,null,0.0,0.0,0,0,0,0,30,09,3,2020,2020-09-30,4,2020,0,0
Bureau,Other Agencies,Surface Transportation Board,null,0.0,0.0,0,0,0,0,30,09,3,2020,2020-09-30,4,2020,0,0
Bureau,Department of the Treasury,Office of Financial Research,null,0.0,0.0,0,0,0,0,30,09,3,2020,2020-09-30,4,2020,0,0
Bureau,Other Agencies,Archit.&Trans. Barriers Compliance Bd,null,0.0,0.0,0,0,0,0,30,09,3,2020,2020-09-30,4,2020,0,0
Bureau,Other Agencies,Defense Nuclear Facilities Safety Board,null,0.0,0.0,0,0,0,0,30,09,3,2020,2020-09-30,4,2020,0,0
Bureau,Department of Commerce,National Technical Information Service,null,0.0,0.0,0,0,0,0,30,09,3,2020,2020-09-30,4,2020,0,0
Bureau,Other Agencies,National Capital Planning Commission,null,0.0,0.0,0,0,0,0,30,09,3,2020,2020-09-30,4,2020,0,0
Bureau,Other Agencies,Chemical Safety Board,null,0.0,0.0,0,0,0,0,30,09,3,2020,2020-09-30,4,2020,0,0
Bureau,Other Agencies,U.S. Holocaust Memorial Council,null,0.0,0.0,0,0,0,0,30,09,3,2020,2020-09-30,4,2020,0,0
Bureau,Federal Mediation/Conciliation Service,Federal Mediation/Conciliation Service,null,0.0,0.0,0,0,0,0,30,09,3,2020,2020-09-30,4,2020,0,0
Bureau,Department of Housing and Urban Development,Government National Mortgage Association,null,0.0,0.0,0,0,0,0,30,09,3,2020,2020-09-30,4,2020,0,0
Bureau,Export - Import  Bank,Export-Import Bank,null,0.0,0.0,0,0,0,0,30,09,3,2020,2020-09-30,4,2020,0,0
Bureau,Department of Labor,Departmental Management,null,0.0,0.0,0,0,0,0,30,09,3,2020,2020-09-30,4,2020,0,0
Bureau,Overseas Private Investment Corp Accts,Overseas Private Investment Corp Accts,null,0.0,0.0,0,0,0,0,30,09,3,2020,2020-09-30,4,2020,0,0
Bureau,Department of Homeland Security,Science and Technology,null,0.0,0.0,0,0,0,0,30,09,3,2020,2020-09-30,4,2020,0,0
Bureau,Department of Homeland Security,U.S. Secret Service,null,0.0,0.0,0,0,0,0,30,09,3,2020,2020-09-30,4,2020,0,0
Bureau,Department of the Treasury,U.S. Treasury IG Office,null,0.0,0.0,0,0,0,0,30,09,3,2020,2020-09-30,4,2020,0,0
Bureau,National Foundation  Arts & Humanities,National Endowment for the Humanities,null,0.0,0.0,0,0,0,0,30,09,3,2020,2020-09-30,4,2020,0,0
Bureau,Other Agencies,Advisory Council on Hist. Preservation,null,0.0,0.0,0,0,0,0,30,09,3,2020,2020-09-30,4,2020,0,0
Bureau,Legislative Branch-CBO,Congressional Budget Office,null,0.0,0.0,0,0,0,0,30,09,3,2020,2020-09-30,4,2020,0,0
Bureau,Funds Appropriated to the President,Executive Branch,null,0.0,0.0,0,0,0,0,30,09,3,2020,2020-09-30,4,2020,0,0
Bureau,Funds Appropriated to the President,Inter-American Foundation,null,0.0,0.0,0,0,0,0,30,09,3,2020,2020-09-30,4,2020,0,0
Bureau,Funds Appropriated to the President,Defense Security Assistance Agency,null,0.0,0.0,0,0,0,0,30,09,3,2020,2020-09-30,4,2020,0,0
Bureau,Department of Commerce,Office of the Inspector General,null,0.0,0.0,0,0,0,0,30,09,3,2020,2020-09-30,4,2020,0,0
Bureau,Department of Homeland Security,Office of Biometric Identity Management,null,0.0,0.0,0,0,0,0,30,09,3,2020,2020-09-30,4,2020,0,0
Bureau,Other Agencies/Boards/Commissions,Medicare Payment Advisory Commission,null,0.0,0.0,0,0,0,0,30,09,3,2020,2020-09-30,4,2020,0,0
Bureau,Smithsonian Institution,Administrative Conference of the US,null,0.0,0.0,0,0,0,0,30,09,3,2020,2020-09-30,4,2020,0,0
Bureau,Department of the Treasury,International Monetary Funds,null,0.0,0.0,0,0,0,0,30,09,3,2020,2020-09-30,4,2020,0,0
Bureau,Other Agencies,Denali Commission,null,0.0,0.0,0,0,0,0,30,09,3,2020,2020-09-30,4,2020,0,0
Bureau,Department of Commerce,Economic and Statistical Analysis,null,0.0,0.0,0,0,0,0,30,09,3,2020,2020-09-30,4,2020,0,0
Bureau,Department of the Interior,"Bureau of Ocean Energy Mgmt., Reg & Enf",null,0.0,0.0,0,0,0,0,30,09,3,2020,2020-09-30,4,2020,0,0
Bureau,Occupational Safety & Health Rev Comm,Occupational Safety & Health Rev Comm,null,0.0,0.0,0,0,0,0,30,09,3,2020,2020-09-30,4,2020,0,0
Bureau,Department of Housing and Urban Development,"Policy, Development and Research",null,0.0,0.0,0,0,0,0,30,09,3,2020,2020-09-30,4,2020,0,0
Bureau,National Foundation  Arts & Humanities,National Endowment for the Arts,null,0.0,0.0,0,0,0,0,30,09,3,2020,2020-09-30,4,2020,0,0
Bureau,Federal Labor Relations Authority,Federal Labor Relations Authority,null,0.0,0.0,0,0,0,0,30,09,3,2020,2020-09-30,4,2020,0,0
Bureau,Federal Deposit Insurance Corporation,Federal Deposit Insurance Corporation,null,0.0,0.0,0,0,0,0,30,09,3,2020,2020-09-30,4,2020,0,0
Bureau,Department of Homeland Security,Federal Law Enforcement Training Ctr.,null,0.0,0.0,0,0,0,0,30,09,3,2020,2020-09-30,4,2020,0,0
Bureau,Department of State,International Commissions,null,0.0,0.0,0,0,0,0,30,09,3,2020,2020-09-30,4,2020,0,0
Bureau,Department of Homeland Security,Management Headquarters,null,0.0,0.0,0,0,0,0,30,09,3,2020,2020-09-30,4,2020,0,0
Bureau,Department of Transportation,Surface Transportation Board,null,0.0,0.0,0,0,0,0,30,09,3,2020,2020-09-30,4,2020,0,0
Bureau,Department of the Treasury,Interest on Tax/Deposit of Earnings,null,0.0,0.0,0,0,0,0,30,09,3,2020,2020-09-30,4,2020,0,0
Bureau,Office of Compliance,Office of Compliance,null,0.0,0.0,0,0,0,0,30,09,3,2020,2020-09-30,4,2020,0,0
Bureau,Legislative Branch-Office of Tech.,Open World Leadership,null,0.0,0.0,0,0,0,0,30,09,3,2020,2020-09-30,4,2020,0,0
Bureau,Department of the Treasury,Pandemic Receivables,null,0.0,0.0,0,0,0,0,30,09,3,2020,2020-09-30,4,2020,0,0
Bureau,Other Agencies,National Mediation Board,null,0.0,0.0,0,0,0,0,30,09,3,2020,2020-09-30,4,2020,0,0
Bureau,Department of the Interior,Bureau of Safety and Environmental Enf.,null,0.0,0.0,0,0,0,0,30,09,3,2020,2020-09-30,4,2020,0,0
Bureau,Other Agencies,Federal Housing Finance Agency,null,0.0,0.0,0,0,0,0,30,09,3,2020,2020-09-30,4,2020,0,0
Bureau,Other Agencies,Election Assistance Commission,null,0.0,0.0,0,0,0,0,30,09,3,2020,2020-09-30,4,2020,0,0
Bureau,Other Agencies,Commission On Fine Arts,null,0.0,0.0,0,0,0,0,30,09,3,2020,2020-09-30,4,2020,0,0
Bureau,Other Agencies,Comm. for Purchase from Blind/Handic.,null,0.0,0.0,0,0,0,0,30,09,3,2020,2020-09-30,4,2020,0,0
Bureau,Other Agencies,District of Columbia Government,null,0.0,0.0,0,0,0,0,30,09,3,2020,2020-09-30,4,2020,0,0
Bureau,Other Agencies,U.S. Institute of Peace,null,0.0,0.0,0,0,0,0,30,09,3,2020,2020-09-30,4,2020,0,0
Bureau,Other Agencies,National Transportation Safety Board,null,0.0,0.0,0,0,0,0,30,09,3,2020,2020-09-30,4,2020,0,0
Bureau,Other Agencies,Morris K. Udall Scholarship,null,0.0,0.0,0,0,0,0,30,09,3,2020,2020-09-30,4,2020,0,0
Bureau,Other Agencies,Federal Mine Safety & Health Review Comm,null,0.0,0.0,0,0,0,0,30,09,3,2020,2020-09-30,4,2020,0,0
Bureau,Department of Education,Office of Postsecondary Education,null,0.0,0.0,0,0,0,0,30,09,3,2020,2020-09-30,4,2020,0,0
Bureau,Selective Service System,Selective Service System,null,0.0,0.0,0,0,0,0,30,09,3,2020,2020-09-30,4,2020,0,0
Bureau,Department of Housing and Urban Development,Community Planning and Development,null,0.0,0.0,0,0,0,0,30,09,3,2020,2020-09-30,4,2020,0,0
Bureau,Farm Credit Administration,Farm Credit System Insurance Corporation,null,0.0,0.0,0,0,0,0,30,09,3,2020,2020-09-30,4,2020,0,0
Bureau,Department of the Treasury,Office of the Secretary,null,0.0,0.0,0,0,0,0,30,09,3,2020,2020-09-30,4,2020,0,0
Bureau,Department of the Treasury,Office of Sec International Affairs,null,0.0,0.0,0,0,0,0,30,09,3,2020,2020-09-30,4,2020,0,0
Bureau,Department of Homeland Security,Info Analysis Infrastructure Prot-NPPD,null,0.0,0.0,0,0,0,0,30,09,3,2020,2020-09-30,4,2020,0,0
Bureau,Tennessee Valley Authority,Tennessee Valley Authority,null,0.0,0.0,0,0,0,0,30,09,3,2020,2020-09-30,4,2020,0,0
Bureau,Office of Special Counsel,Office of Special Counsel,null,0.0,0.0,0,0,0,0,30,09,3,2020,2020-09-30,4,2020,0,0
Bureau,Department of Health & Human Services,Office of the Inspector General,null,0.0,0.0,0,0,0,0,30,09,3,2020,2020-09-30,4,2020,0,0
Bureau,Department of Homeland Security,Office of Health Affairs,null,0.0,0.0,0,0,0,0,30,09,3,2020,2020-09-30,4,2020,0,0
Bureau,Other Agencies,Federal Housing Finance Agency OIG,null,0.0,0.0,0,0,0,0,30,09,3,2020,2020-09-30,4,2020,0,0
Bureau,Office of Government Ethics,Office of Government Ethics,null,0.0,0.0,0,0,0,0,30,09,3,2020,2020-09-30,4,2020,0,0
Bureau,Department of Justice,General Administration,null,0.0,0.0,0,0,0,0,30,09,3,2020,2020-09-30,4,2020,0,0
Bureau,Neighborhood Reinvestment Corporation,Neighborhood Reinvestment Corporation,null,0.0,0.0,0,0,0,0,30,09,3,2020,2020-09-30,4,2020,0,0
Bureau,Smithsonian Institution,National Gallery of Art,null,0.0,0.0,0,0,0,0,30,09,3,2020,2020-09-30,4,2020,0,0
Bureau,Other Agencies/Boards/Commissions,U.S.-China Security Review Commission,null,0.0,0.0,0,0,0,0,30,09,3,2020,2020-09-30,4,2020,0,0
Bureau,Department of Health & Human Services,Administration for Community Living,null,0.0,0.0,0,0,0,0,30,09,3,2020,2020-09-30,4,2020,0,0
Bureau,Department of State,Civil Monetary Penalties,null,0.0,0.0,0,0,0,0,30,09,3,2020,2020-09-30,4,2020,0,0
Bureau,Department of the Treasury,Treasury IG for Tax Admin,null,0.0,0.0,0,0,0,0,30,09,3,2020,2020-09-30,4,2020,0,0
Bureau,Department of the Treasury,Treasury Forfeiture Fund,null,0.0,0.0,0,0,0,0,30,09,3,2020,2020-09-30,4,2020,0,0
Bureau,National Credit Union Administration,National Credit Union Administration,null,0.0,0.0,0,0,0,0,30,09,3,2020,2020-09-30,4,2020,0,0
Bureau,Department of the Treasury,Treasury Franchise Fund,null,100.0,100.0,0,0,66,1,30,09,3,2020,2020-09-30,4,2020,66,1
Bureau,Department of Homeland Security,Office of the Inspector General DHS,null,100.0,100.0,0,0,100,1,30,09,3,2020,2020-09-30,4,2020,100,1
Bureau,Merit Systems Protection Board,Merit Systems Protection Board,null,100.0,100.0,0,0,144,1,30,09,3,2020,2020-09-30,4,2020,144,1
Bureau,U.S. Court of Appeals / Veterans Claims,U.S. Court of Appeals / Veterans Claims,null,100.0,100.0,0,0,171,1,30,09,3,2020,2020-09-30,4,2020,171,1
Bureau,Department of Transportation,Office of the Inspector General,null,100.0,100.0,0,0,210,1,30,09,3,2020,2020-09-30,4,2020,210,1
Bureau,Other Agencies/Boards/Commissions,U.S. Comm. on Int. Religious Freedom,null,0.0,0.0,393,1,0,0,30,09,3,2020,2020-09-30,4,2020,393,1
Bureau,Farm Credit Administration,Farm Credit Administration,null,100.0,100.0,0,0,630,1,30,09,3,2020,2020-09-30,4,2020,630,1
Bureau,Department of Homeland Security,Domestic Nuclear Detection Office,null,0.0,0.0,646,4,0,0,30,09,3,2020,2020-09-30,4,2020,646,4
Bureau,Other Agencies,Millennium Challenge Corporation,null,100.0,100.0,0,0,817,1,30,09,3,2020,2020-09-30,4,2020,817,1
Bureau,Department of the Treasury,Tobacco Tax and Trade,null,100.0,100.0,0,0,1000,1,30,09,3,2020,2020-09-30,4,2020,1000,1
Bureau,Other Agencies,National Council on Disability,null,0.0,0.0,1579,2,0,0,30,09,3,2020,2020-09-30,4,2020,1579,2
Bureau,Department of Transportation,Research Innovative Technology Admin,null,100.0,100.0,0,0,1590,2,30,09,3,2020,2020-09-30,4,2020,1590,2
Bureau,Department of Commerce,International Trade Administration,null,100.0,100.0,0,0,2738,1,30,09,3,2020,2020-09-30,4,2020,2738,1
Bureau,Consumer Product Safety Commission,Consumer Product Safety Commission,null,100.0,100.0,0,0,2979,2,30,09,3,2020,2020-09-30,4,2020,2979,2
Bureau,Other Agencies,John C. Stennis,null,0.0,0.0,3063,2,0,0,30,09,3,2020,2020-09-30,4,2020,3063,2
Bureau,Department of the Treasury,Spec Insp Gen-Troubled Asset Rel Prog,null,100.0,100.0,0,0,3916,1,30,09,3,2020,2020-09-30,4,2020,3916,1
Bureau,Department of Commerce,General Administration,null,100.0,100.0,0,0,4660,1,30,09,3,2020,2020-09-30,4,2020,4660,1
Bureau,Other Agencies,U.S.  Agency of Global Media,null,100.0,100.0,0,0,4930,2,30,09,3,2020,2020-09-30,4,2020,4930,2
Bureau,Other Agencies,U.S. Inst. for Env. Conflict Resolution,null,0.0,0.0,5003,2,0,0,30,09,3,2020,2020-09-30,4,2020,5003,2
Bureau,Department of Transportation,Maritime Administration,null,100.0,100.0,0,0,5175,6,30,09,3,2020,2020-09-30,4,2020,5175,6
Bureau,Other Agencies,Council of Insps. Gen. of Intg. & Effy.,null,0.0,0.0,5475,9,0,0,30,09,3,2020,2020-09-30,4,2020,5475,9
Bureau,Smithsonian Institution,Smithsonian Institution,null,0.0,0.0,5670,1,0,0,30,09,3,2020,2020-09-30,4,2020,5670,1
Bureau,Department of Justice,U.S. Marshals Service,null,0.0,0.0,5696,4,0,0,30,09,3,2020,2020-09-30,4,2020,5696,4
Bureau,Department of Health & Human Services,Office of the Secretary,null,100.0,100.0,0,0,8136,7,30,09,3,2020,2020-09-30,4,2020,8136,7
Bureau,Department of Transportation,St. Lawrence Seaway Development Corp.,null,48.78130967089745,50.0,4560,1,4343,1,30,09,3,2020,2020-09-30,4,2020,8903,2
Bureau,Department of Labor,Bureau of Labor Statistics,null,100.0,100.0,0,0,10534,1,30,09,3,2020,2020-09-30,4,2020,10534,1
Bureau,Department of Transportation,National Highway Traffic Safety Admin.,null,100.0,100.0,0,0,19498,4,30,09,3,2020,2020-09-30,4,2020,19498,4
Bureau,Department of Justice,Bureau of ATF and Explosives,null,100.0,100.0,0,0,20422,4,30,09,3,2020,2020-09-30,4,2020,20422,4
Bureau,Legislative Branch-GAO,Government Accountability Office,null,100.0,100.0,0,0,28039,13,30,09,3,2020,2020-09-30,4,2020,28039,13
Bureau,Department of Agriculture,Federal Crop Insurance Corporation,null,86.98210567609162,99.77578475336323,4314,1,28825,445,30,09,3,2020,2020-09-30,4,2020,33139,446
Bureau,Equal Employment Opportunity Commission,Equal Employment Opportunity Commission,null,100.0,100.0,0,0,35245,20,30,09,3,2020,2020-09-30,4,2020,35245,20
Bureau,Department of the Treasury,U.S. Mint,null,100.0,100.0,0,0,46521,25,30,09,3,2020,2020-09-30,4,2020,46521,25
Bureau,Department of the Interior,Office of the Secretary,null,100.0,100.0,0,0,46951,20,30,09,3,2020,2020-09-30,4,2020,46951,20
Bureau,Department of Justice,Office of Justice Assistance Programs,null,100.0,100.0,0,0,69628,28,30,09,3,2020,2020-09-30,4,2020,69628,28
Bureau,Department of the Treasury,Bureau of Engraving and Printing,null,100.0,100.0,0,0,84528,1,30,09,3,2020,2020-09-30,4,2020,84528,1
Bureau,Department of the Interior,Bureau of Reclamation,null,100.0,100.0,0,0,86894,73,30,09,3,2020,2020-09-30,4,2020,86894,73
Bureau,Armed Forces Retirement Home,Armed Forces Retirement Home,null,87.87655657823498,95.41284403669725,11196,5,81154,104,30,09,3,2020,2020-09-30,4,2020,92350,109
Bureau,Legis Branch-Library of Congress,Library of Congress,null,0.0,0.0,101139,18,0,0,30,09,3,2020,2020-09-30,4,2020,101139,18
Bureau,Department of Transportation,Federal Highway Administration,null,100.0,100.0,0,0,119035,6,30,09,3,2020,2020-09-30,4,2020,119035,6
Bureau,Department of Transportation,Federal Railroad Administration,null,100.0,100.0,0,0,125997,12,30,09,3,2020,2020-09-30,4,2020,125997,12
Bureau,Other Agencies,Architect of the Capitol,null,0.0,0.0,127812,57,0,0,30,09,3,2020,2020-09-30,4,2020,127812,57
Bureau,Legislative Branch-GPO,Government Publishing Office,null,0.0,0.0,132743,16,0,0,30,09,3,2020,2020-09-30,4,2020,132743,16
Bureau,Department of the Interior,Geological Survey,null,100.0,100.0,0,0,150791,134,30,09,3,2020,2020-09-30,4,2020,150791,134
Bureau,National Archives & Records Admin,Nat'l Archives & Records Administration,null,70.13732833957553,94.44444444444444,50232,6,117978,102,30,09,3,2020,2020-09-30,4,2020,168210,108
Bureau,Other Agencies,James Madison Memorial Fellowship,null,0.0,0.0,221291,25,0,0,30,09,3,2020,2020-09-30,4,2020,221291,25
Bureau,Legislative Branch - U.S. House/Senate,U.S. House of Representatives,null,29.1607516768996,25.423728813559322,159683,132,65733,45,30,09,3,2020,2020-09-30,4,2020,225416,177
Bureau,Department of Commerce,Bureau of the Census,null,100.0,100.0,0,0,254493,396,30,09,3,2020,2020-09-30,4,2020,254493,396
Bureau,Department of Justice,Federal Bureau of Investigation,null,100.0,100.0,0,0,257351,65,30,09,3,2020,2020-09-30,4,2020,257351,65
Bureau,Department of the Treasury,Internal Revenue Service,null,100.0,100.0,0,0,262038,132,30,09,3,2020,2020-09-30,4,2020,262038,132
Bureau,Department of Commerce,Nat'l Telecomm & Information Admin.,null,100.0,100.0,0,0,296093,1,30,09,3,2020,2020-09-30,4,2020,296093,1
Bureau,Department of Justice,Drug Enforcement Administration,null,100.0,100.0,0,0,310341,22,30,09,3,2020,2020-09-30,4,2020,310341,22
Bureau,Securities & Exchange Commission,Securities and Exchange Commission,null,100.0,100.0,0,0,313036,59,30,09,3,2020,2020-09-30,4,2020,313036,59
Bureau,Department of Commerce,Patent and Trademark Office,null,100.0,100.0,0,0,359307,527,30,09,3,2020,2020-09-30,4,2020,359307,527
Bureau,Department of Transportation,Pipeline Hazardous Material Safety Admin,null,100.0,100.0,0,0,382191,24,30,09,3,2020,2020-09-30,4,2020,382191,24
Bureau,Department of Agriculture,Food and Nutrition Service,null,12.34565485392247,14.285714285714286,358352,36,50472,6,30,09,3,2020,2020-09-30,4,2020,408824,42
Bureau,Department of the Treasury,D.C. Pension Program,null,100.0,100.0,0,0,447735,24,30,09,3,2020,2020-09-30,4,2020,447735,24
Bureau,Federal Maritime Commission,Salaries and Expenses,null,100.0,100.0,0,0,475933,7,30,09,3,2020,2020-09-30,4,2020,475933,7
Bureau,National Science Foundation,National Science Foundation,null,100.0,100.0,0,0,527693,84,30,09,3,2020,2020-09-30,4,2020,527693,84
Bureau,Federal Election Commission,Federal Election Commission,null,100.0,100.0,0,0,574671,105,30,09,3,2020,2020-09-30,4,2020,574671,105
Bureau,Department of Commerce,Nat'l Institute of Standards& Technology,null,100.0,100.0,0,0,680558,6,30,09,3,2020,2020-09-30,4,2020,680558,6
Bureau,Department of the Interior,Fish and Wildlife Service,null,100.0,100.0,0,0,699673,79,30,09,3,2020,2020-09-30,4,2020,699673,79
Bureau,Department of Veterans Affairs,Life Insurance,null,100.0,100.0,0,0,711165,132,30,09,3,2020,2020-09-30,4,2020,711165,132
Bureau,Department of Agriculture,Food Safety and Inspection Service,null,99.66845556235037,99.35483870967742,2418,5,726896,770,30,09,3,2020,2020-09-30,4,2020,729314,775
Bureau,Department of Transportation,Federal Transit Administration,null,100.0,100.0,0,0,784555,2,30,09,3,2020,2020-09-30,4,2020,784555,2
Bureau,Funds Appropriated to the President,Trade and Development Agency,null,0.0,0.0,791105,4,0,0,30,09,3,2020,2020-09-30,4,2020,791105,4
Bureau,Department of Justice,Federal Prison System,null,100.0,100.0,0,0,891743,127,30,09,3,2020,2020-09-30,4,2020,891743,127
Bureau,Department of Veterans Affairs,Housing Credit Assistance,null,0.0,0.0,943885,21,0,0,30,09,3,2020,2020-09-30,4,2020,943885,21
Bureau,Department of Health & Human Services,Substance Abuse & Mental Health Admin.,null,100.0,100.0,0,0,947566,13,30,09,3,2020,2020-09-30,4,2020,947566,13
Bureau,Department of Homeland Security,Citizenship and Immigration Services,null,100.0,100.0,0,0,1014493,1241,30,09,3,2020,2020-09-30,4,2020,1014493,1241
Bureau,Department of Transportation,Office of the Secretary,null,100.0,100.0,0,0,1032686,16,30,09,3,2020,2020-09-30,4,2020,1032686,16
Bureau,Department of Justice,Federal Prison Industries,null,100.0,100.0,0,0,1043089,183,30,09,3,2020,2020-09-30,4,2020,1043089,183
Bureau,Department of the Treasury,Comptroller of the Currency,null,99.62299164828664,63.63636363636363,4181,12,1104813,21,30,09,3,2020,2020-09-30,4,2020,1108994,33
Bureau,Department of Housing and Urban Development,Management and Administration,null,82.45416386236316,70.0,215858,3,1014394,7,30,09,3,2020,2020-09-30,4,2020,1230252,10
Bureau,Department of Veterans Affairs,Administration and Cemeteries,null,0.2701628474890012,0.7299270072992701,1237012,680,3351,5,30,09,3,2020,2020-09-30,4,2020,1240363,685
Bureau,National Aeronautics and Space Administration,National Aeronautics and Space Admin,null,100.0,100.0,0,0,1267015,136,30,09,3,2020,2020-09-30,4,2020,1267015,136
Bureau,Presidio Trust Corporation,Presidio Trust Corporation,null,98.3377670165825,95.18072289156626,25044,4,1481604,79,30,09,3,2020,2020-09-30,4,2020,1506648,83
Bureau,Department of the Treasury,Financial Crimes Enforcement Network,null,100.0,100.0,0,0,1544945,3,30,09,3,2020,2020-09-30,4,2020,1544945,3
Bureau,Department of Energy,Bonneville Power Administration,null,63.06610119102368,96.875,622406,1,1062783,31,30,09,3,2020,2020-09-30,4,2020,1685189,32
Bureau,Department of Commerce,Bureau of Industry and Security,null,100.0,100.0,0,0,1729075,23,30,09,3,2020,2020-09-30,4,2020,1729075,23
Bureau,Nuclear Regulatory Commission,Nuclear Regulatory Commission,null,99.2648750080251,98.54545454545455,14542,4,1963625,271,30,09,3,2020,2020-09-30,4,2020,1978167,275
Bureau,Department of State,Passport NSF,null,100.0,100.0,0,0,2439680,15682,30,09,3,2020,2020-09-30,4,2020,2439680,15682
Bureau,Department of Housing and Urban Development,Public and Indian Housing Programs,null,69.03030460998454,33.333333333333336,784201,4,1747955,2,30,09,3,2020,2020-09-30,4,2020,2532156,6
Bureau,Department of Transportation,Federal Aviation Administration,null,72.8373201812523,85.0,770706,51,2066665,289,30,09,3,2020,2020-09-30,4,2020,2837371,340
Bureau,Department of the Interior,Office of Surface Mining,null,100.0,100.0,0,0,3054375,318,30,09,3,2020,2020-09-30,4,2020,3054375,318
Bureau,Department of Labor,Employment and Training Administration,null,100.0,100.0,0,0,3380915,11,30,09,3,2020,2020-09-30,4,2020,3380915,11
Bureau,Pension Benefit Guaranty Corp,Pension Benefit Guaranty Corporation,null,100.0,100.0,0,0,3967058,1483,30,09,3,2020,2020-09-30,4,2020,3967058,1483
Bureau,Department of the Treasury,Community Dev Financial Inst Fund,null,100.0,100.0,0,0,4522449,8,30,09,3,2020,2020-09-30,4,2020,4522449,8
Bureau,Department of Veterans Affairs,Medical and Construction,null,5.530990817437341,20.298236390574964,99373518,33352,5818141,8494,30,09,3,2020,2020-09-30,4,2020,105191659,41846
Bureau,Corp. for National and Community Service,Corp. for National and Community Service,null,76.94611273094215,11.471698113207546,1074458,1173,3586179,152,30,09,3,2020,2020-09-30,4,2020,4660637,1325
Bureau,Department of Commerce,Economic Development Administration,null,100.0,100.0,0,0,5088380,9,30,09,3,2020,2020-09-30,4,2020,5088380,9
Bureau,Department of Agriculture,Agricultural Marketing Service,null,85.38118231822895,35.53984575835476,805102,1003,4702197,553,30,09,3,2020,2020-09-30,4,2020,5507299,1556
Bureau,Other Agencies,Consumer Financial Protection Bureau,null,0.0,0.0,5510394,68,0,0,30,09,3,2020,2020-09-30,4,2020,5510394,68
Bureau,Department of Health & Human Services,Program Support Center,null,100.0,100.0,0,0,6437306,412,30,09,3,2020,2020-09-30,4,2020,6437306,412
Bureau,Department of Health & Human Services,Centers for Disease Control,null,2.0566991308821243,10.738255033557047,6937705,133,145684,16,30,09,3,2020,2020-09-30,4,2020,7083389,149
Bureau,General Services Administration,General Services Administration,null,85.7165548642446,71.07386716325264,1046706,466,6281400,1145,30,09,3,2020,2020-09-30,4,2020,7328106,1611
Bureau,Department of the Interior,National Park Service,null,100.0,100.0,0,0,7734264,1926,30,09,3,2020,2020-09-30,4,2020,7734264,1926
Bureau,Department of Homeland Security,Bureau of Customs & Border Protection,null,100.0,100.0,0,0,8916105,598,30,09,3,2020,2020-09-30,4,2020,8916105,598
Bureau,Department of Homeland Security,Transportation Safety Administration,null,100.0,100.0,0,0,9222684,5366,30,09,3,2020,2020-09-30,4,2020,9222684,5366
Bureau,Department of the Interior,Office of Natural Resources Revenue,null,100.0,100.0,0,0,11371983,483,30,09,3,2020,2020-09-30,4,2020,11371983,483
Bureau,Department of Energy,Energy Consolidated Reports,null,100.0,100.0,0,0,12818772,61,30,09,3,2020,2020-09-30,4,2020,12818772,61
Bureau,Department of Homeland Security,Emergency Preparedness & Resp,null,100.0,100.0,0,0,258752739,43019,30,09,3,2020,2020-09-30,4,2020,258752739,43019
Bureau,Federal Trade Commission,Federal Trade Commission,null,100.0,100.0,0,0,483063621,56,30,09,3,2020,2020-09-30,4,2020,483063621,56
Bureau,Commodity Futures Trading Commission,Commodity Futures Trading Commission,null,100.0,100.0,0,0,649461611,366,30,09,3,2020,2020-09-30,4,2020,649461611,366
Bureau,Department of Agriculture,Farm Service Agency,null,100.0,100.0,0,0,652259180,12290,30,09,3,2020,2020-09-30,4,2020,652259180,12290
Bureau,Department of Agriculture,Rural Development,null,99.99853145769956,99.95373048004627,10425,8,709877196,17282,30,09,3,2020,2020-09-30,4,2020,709887621,17290
Bureau,Department of Education,Departmental Management,null,90.72172874317118,85.50168026884302,81313080,302,795068713,1781,30,09,3,2020,2020-09-30,4,2020,876381793,2083
Bureau,Securities & Exchange Commission,SEC Enforcement,null,100.0,100.0,0,0,1902482096,924,30,09,3,2020,2020-09-30,4,2020,1902482096,924
Bureau,Department of Homeland Security,Immigration and Customs Enforcement,null,100.0,100.0,0,0,12989555,478,30,09,3,2020,2020-09-30,4,2020,12989555,478
Bureau,Department of the Treasury,Bureau of the Fiscal Service,null,100.0,100.0,0,0,13668622,4249,30,09,3,2020,2020-09-30,4,2020,13668622,4249
Bureau,Department of Commerce,NOAA,null,100.0,100.0,0,0,14511695,828,30,09,3,2020,2020-09-30,4,2020,14511695,828
Bureau,Department of Health & Human Services,National Institutes of Health,null,36.491408235305535,19.444444444444443,9685769,377,5565347,91,30,09,3,2020,2020-09-30,4,2020,15251116,468
Bureau,Department of State,Department of State,null,92.6777556237787,90.9684590801723,1126728,650,14261013,6547,30,09,3,2020,2020-09-30,4,2020,15387741,7197
Bureau,Department of the Interior,Bureau of Land Management,null,100.0,100.0,0,0,15893273,334,30,09,3,2020,2020-09-30,4,2020,15893273,334
Bureau,Department of Labor,Employee Benefit Security Administration,null,100.0,100.0,0,0,17405488,389,30,09,3,2020,2020-09-30,4,2020,17405488,389
Bureau,Department of Veterans Affairs,Veterans Benefits,null,0.0,0.0,20399641,23071,0,0,30,09,3,2020,2020-09-30,4,2020,20399641,23071
Bureau,Railroad Retirement Board,Railroad Retirement Board,null,100.0,100.0,0,0,21927392,4411,30,09,3,2020,2020-09-30,4,2020,21927392,4411
Bureau,Department of the Treasury,Departmental Offices,null,97.73666763536612,98.25834542815674,540658,24,23347040,1354,30,09,3,2020,2020-09-30,4,2020,23887698,1378
Bureau,Environmental Protection Agency,Environmental Protection Agency,null,100.0,100.0,0,0,24037442,230,30,09,3,2020,2020-09-30,4,2020,24037442,230
Bureau,Office of Personnel Management,Office of Personnel Management,null,90.29234255890337,82.67716535433071,2425877,286,22563437,1365,30,09,3,2020,2020-09-30,4,2020,24989314,1651
Bureau,Department of Health & Human Services,Administration for Children and Families,null,100.0,100.0,0,0,29299815,1810,30,09,3,2020,2020-09-30,4,2020,29299815,1810
Bureau,Department of Agriculture,U.S. Department of Agriculture,null,85.84110979558407,62.37188872620791,4604370,1028,27914916,1704,30,09,3,2020,2020-09-30,4,2020,32519286,2732
Bureau,Department of Labor,Mine Safety and Health Administration,null,94.89557244502997,92.3521013098268,1719528,1232,31967462,14877,30,09,3,2020,2020-09-30,4,2020,33686990,16109
Bureau,Department of the Interior,Bureau of Indian Affairs,null,99.99675777419954,99.93945102260496,1094,18,33741158,29710,30,09,3,2020,2020-09-30,4,2020,33742252,29728
Bureau,Agency for International Development,Agency for International Development,null,99.99980134665964,98.33333333333333,70,1,35237193,59,30,09,3,2020,2020-09-30,4,2020,35237263,60
Bureau,Department of Labor,Employment Standards Administration,null,84.41007484806501,77.21676370693838,14903958,7513,80695975,25463,30,09,3,2020,2020-09-30,4,2020,95599933,32976
Bureau,Department of Health & Human Services,Indian Health Services,null,78.75280619354108,6.4935064935064934,7672994,2808,28439982,195,30,09,3,2020,2020-09-30,4,2020,36112976,3003
Bureau,Department of Health & Human Services,Food and Drug Administration,null,72.2508371137438,15.920886519848507,13152874,5994,34246300,1135,30,09,3,2020,2020-09-30,4,2020,47399174,7129
Bureau,Department of Labor,Occupational Safety and Health Admin,null,89.8261383241564,93.42076016892644,5875486,296,51875309,4203,30,09,3,2020,2020-09-30,4,2020,57750795,4499
Bureau,Department of Transportation,Federal Motor Carrier Safety Admin,null,100.0,100.0,0,0,60557990,7139,30,09,3,2020,2020-09-30,4,2020,60557990,7139
Bureau,Department of Agriculture,Forest Service,null,89.39446261584911,19.383259911894275,7245487,1281,61072475,308,30,09,3,2020,2020-09-30,4,2020,68317962,1589
Bureau,US International Development Fin. Corp.,US International Development Fin. Corp.,null,0.0,0.0,68649283,6,0,0,30,09,3,2020,2020-09-30,4,2020,68649283,6
Bureau,U.S. Postal Service,U.S. Postal Service,null,61.66795048425579,85.14774026599265,27657836,7404,44495457,42447,30,09,3,2020,2020-09-30,4,2020,72153293,49851
Bureau,Department of Homeland Security,U.S. Coast Guard,null,100.0,100.0,0,0,84356199,12505,30,09,3,2020,2020-09-30,4,2020,84356199,12505
Bureau,Department of Justice,Legal Activities,null,94.69223742737995,99.03998283768202,4728004,358,84349153,36933,30,09,3,2020,2020-09-30,4,2020,89077157,37291
Bureau,Department of Health & Human Services,Health Resources and Services Admin,null,100.0,100.0,0,0,92242393,558,30,09,3,2020,2020-09-30,4,2020,92242393,558
Bureau,Department of Housing and Urban Development,Housing Programs,null,100.0,100.0,0,0,179033261,6532,30,09,3,2020,2020-09-30,4,2020,179033261,6532
Bureau,Federal Communications Commission,Federal Communications Commission,null,100.0,100.0,0,0,182392877,7629,30,09,3,2020,2020-09-30,4,2020,182392877,7629
Bureau,Department of Defense,Consolidated Report,null,47.39146900390913,21.828452077118698,1222021180,1026992,1100836267,286775,30,09,3,2020,2020-09-30,4,2020,2322857447,1313767
Bureau,Social Security Administration,Social Security Administration,null,52.8055163009144,29.575109479820128,2615747396,1197283,2926738062,502802,30,09,3,2020,2020-09-30,4,2020,5542485458,1700085
Bureau,Department of Health & Human Services,Centers for Medicare & Medicaid Services,null,98.57068171415459,99.20101462676111,140354602,9626,9679333804,1195152,30,09,3,2020,2020-09-30,4,2020,9819688406,1204778
Bureau,Small Business Administration,Small Business Administration,null,100.0,100.0,0,0,12344834017,120252,30,09,3,2020,2020-09-30,4,2020,12344834017,120252
Bureau,Department of Education,Federal Student Aid,null,86.41511289041294,89.6803268985507,21680130577,2797493,137909937431,24310856,30,09,3,2020,2020-09-30,4,2020,159590068008,27108349
Agency,Department of State,null,CFO,93.67980371361624,97.15896673805673,1126728,650,16700693,22229,30,09,3,2020,2020-09-30,4,2020,17827421,22879
Bureau,American Battle Monuments Commission,American Battle Monuments Commission,null,0.0,0.0,0,0,0,0,30,09,3,2020,2020-09-30,4,2020,0,0
Agency,Environmental Protection Agency,null,CFO,99.98197721150672,99.13793103448276,4360,2,24187235,230,31,12,4,2020,2020-12-31,1,2021,24191595,232
Bureau,Other Agencies,National Council on Disability,null,0.0,0.0,1579,2,0,0,31,12,4,2020,2020-12-31,1,2021,1579,2
Bureau,Department of the Interior,Bureau of Safety and Environmental Enf.,null,0.0,0.0,86,1,0,0,31,12,4,2020,2020-12-31,1,2021,86,1
Bureau,Nuclear Regulatory Commission,Nuclear Regulatory Commission,null,99.5862666583599,99.6774193548387,10227,1,2461655,309,31,12,4,2020,2020-12-31,1,2021,2471882,310
Bureau,Department of Transportation,Federal Aviation Administration,null,75.8196919596862,83.38557993730407,609735,53,1911883,266,31,12,4,2020,2020-12-31,1,2021,2521618,319
Agency,Export - Import  Bank,null,Non-CFO,0.0,0.0,0,0,0,0,31,12,4,2020,2020-12-31,1,2021,0,0
Bureau,Department of Veterans Affairs,Administration and Cemeteries,null,0.28970947784859374,0.7363770250368189,1153325,674,3351,5,31,12,4,2020,2020-12-31,1,2021,1156676,679
Bureau,Department of the Interior,Office of Surface Mining,null,100.0,100.0,0,0,3248441,325,31,12,4,2020,2020-12-31,1,2021,3248441,325
Bureau,Pension Benefit Guaranty Corp,Pension Benefit Guaranty Corporation,null,100.0,100.0,0,0,3262012,1153,31,12,4,2020,2020-12-31,1,2021,3262012,1153
Bureau,Department of Labor,Employment and Training Administration,null,100.0,100.0,0,0,3363727,10,31,12,4,2020,2020-12-31,1,2021,3363727,10
Bureau,Office of Compliance,Office of Compliance,null,0.0,0.0,0,0,0,0,31,12,4,2020,2020-12-31,1,2021,0,0
Agency,National Credit Union Administration,null,Non-CFO,0.0,0.0,0,0,0,0,31,12,4,2020,2020-12-31,1,2021,0,0
Agency,Selective Service System,null,Non-CFO,0.0,0.0,0,0,0,0,31,12,4,2020,2020-12-31,1,2021,0,0
Bureau,Department of Transportation,Surface Transportation Board,null,0.0,0.0,0,0,0,0,31,12,4,2020,2020-12-31,1,2021,0,0
Bureau,Department of Agriculture,Agricultural Marketing Service,null,86.66738593789572,35.58981233243968,732801,961,4763503,531,31,12,4,2020,2020-12-31,1,2021,5496304,1492
Agency,Railroad Retirement Board,null,Non-CFO,100.0,100.0,0,0,22009163,4400,31,12,4,2020,2020-12-31,1,2021,22009163,4400
Bureau,Corp. for National and Community Service,Corp. for National and Community Service,null,24.11388805374217,0.21645021645021645,3566475,1383,1133298,3,31,12,4,2020,2020-12-31,1,2021,4699773,1386
Bureau,Department of Commerce,Economic Development Administration,null,100.0,100.0,0,0,5105195,11,31,12,4,2020,2020-12-31,1,2021,5105195,11
Bureau,Department of Health & Human Services,Program Support Center,null,100.0,100.0,0,0,6447712,380,31,12,4,2020,2020-12-31,1,2021,6447712,380
Bureau,General Services Administration,General Services Administration,null,75.04968006898503,66.1715380929564,1619157,706,4870367,1381,31,12,4,2020,2020-12-31,1,2021,6489524,2087
Bureau,Department of Homeland Security,Transportation Safety Administration,null,0.0,0.0,0,0,0,0,31,12,4,2020,2020-12-31,1,2021,0,0
Agency,Legis Branch-Library of Congress,null,Non-CFO,0.0,0.0,0,0,0,0,31,12,4,2020,2020-12-31,1,2021,0,0
Agency,Securities & Exchange Commission,null,Non-CFO,100.0,100.0,0,0,1958786528,991,31,12,4,2020,2020-12-31,1,2021,1958786528,991
Agency,Department of Homeland Security,null,CFO,99.99930494404262,99.99143190074714,2803,5,403274080,58351,31,12,4,2020,2020-12-31,1,2021,403276883,58356
Agency,Department of Defense,null,CFO,45.154931137347866,15.868367990246393,1290580009,1453257,1062557722,274104,31,12,4,2020,2020-12-31,1,2021,2353137731,1727361
Agency,Department of Health & Human Services,null,CFO,98.07324948404049,98.27773895395457,188364679,20061,9587923296,1144745,31,12,4,2020,2020-12-31,1,2021,9776287975,1164806
Agency,Small Business Administration,null,CFO,100.0,100.0,0,0,12370402730,119782,31,12,4,2020,2020-12-31,1,2021,12370402730,119782
Agency,Department of Education,null,CFO,99.96207506543595,99.9983053798357,51866318,398,136708601686,23485691,31,12,4,2020,2020-12-31,1,2021,136760468004,23486089
Agency,Legislative Branch-GAO,null,Non-CFO,0.0,0.0,0,0,0,0,31,12,4,2020,2020-12-31,1,2021,0,0
Agency,Funds Appropriated to the President,null,Non-CFO,0.0,0.0,0,0,0,0,31,12,4,2020,2020-12-31,1,2021,0,0
Agency,Federal Deposit Insurance Corporation,null,Non-CFO,0.0,0.0,0,0,0,0,31,12,4,2020,2020-12-31,1,2021,0,0
Agency,Occupational Safety & Health Rev Comm,null,Non-CFO,0.0,0.0,0,0,0,0,31,12,4,2020,2020-12-31,1,2021,0,0
Agency,Office of Compliance,null,Non-CFO,0.0,0.0,0,0,0,0,31,12,4,2020,2020-12-31,1,2021,0,0
Agency,The Judiciary,null,Non-CFO,93.69729131780971,59.177215189873415,66320,129,985926,187,31,12,4,2020,2020-12-31,1,2021,1052246,316
Agency,Pension Benefit Guaranty Corp,null,Non-CFO,100.0,100.0,0,0,3262012,1153,31,12,4,2020,2020-12-31,1,2021,3262012,1153
Agency,Corp. for National and Community Service,null,Non-CFO,24.11388805374217,0.21645021645021645,3566475,1383,1133298,3,31,12,4,2020,2020-12-31,1,2021,4699773,1386
Agency,Other Agencies,null,Non-CFO,0.09692578136397359,2.5210084033613445,5923532,116,5747,3,31,12,4,2020,2020-12-31,1,2021,5929279,119
Agency,U.S. Postal Service,null,Non-CFO,48.94763860618539,83.59068551148745,47376549,10542,45423368,53702,31,12,4,2020,2020-12-31,1,2021,92799917,64244
Agency,Federal Communications Commission,null,Non-CFO,100.0,100.0,0,0,205320179,20509,31,12,4,2020,2020-12-31,1,2021,205320179,20509
Agency,Federal Trade Commission,null,Non-CFO,100.0,100.0,0,0,483060628,55,31,12,4,2020,2020-12-31,1,2021,483060628,55
Agency,Commodity Futures Trading Commission,null,Non-CFO,100.0,100.0,0,0,651938594,366,31,12,4,2020,2020-12-31,1,2021,651938594,366
Agency,Department of Energy,null,CFO,100.0,100.0,0,0,14505094,107,31,12,4,2020,2020-12-31,1,2021,14505094,107
Agency,Department of Agriculture,null,CFO,98.73569543162255,92.32765314045196,20546200,3755,1604552729,45187,31,12,4,2020,2020-12-31,1,2021,1625098929,48942
Agency,US International Development Fin. Corp.,null,Non-CFO,0.0,0.0,0,0,0,0,31,12,4,2020,2020-12-31,1,2021,0,0
Agency,Merit Systems Protection Board,null,Non-CFO,100.0,100.0,0,0,144,1,31,12,4,2020,2020-12-31,1,2021,144,1
Agency,Presidio Trust Corporation,null,Non-CFO,100.0,100.0,0,0,1517237,78,31,12,4,2020,2020-12-31,1,2021,1517237,78
Agency,American Battle Monuments Commission,null,Non-CFO,0.0,0.0,0,0,0,0,31,12,4,2020,2020-12-31,1,2021,0,0
Agency,Office of Government Ethics,null,Non-CFO,0.0,0.0,0,0,0,0,31,12,4,2020,2020-12-31,1,2021,0,0
Agency,Federal Labor Relations Authority,null,Non-CFO,0.0,0.0,0,0,0,0,31,12,4,2020,2020-12-31,1,2021,0,0
Agency,Legislative Branch-Office of Tech.,null,Non-CFO,0.0,0.0,0,0,0,0,31,12,4,2020,2020-12-31,1,2021,0,0
Agency,Legislative Branch-CBO,null,Non-CFO,0.0,0.0,0,0,0,0,31,12,4,2020,2020-12-31,1,2021,0,0
Agency,Office of Special Counsel,null,Non-CFO,0.0,0.0,0,0,0,0,31,12,4,2020,2020-12-31,1,2021,0,0
Agency,Tennessee Valley Authority,null,Non-CFO,0.0,0.0,0,0,0,0,31,12,4,2020,2020-12-31,1,2021,0,0
Agency,U.S. Tax Court,null,Non-CFO,0.0,0.0,0,0,0,0,31,12,4,2020,2020-12-31,1,2021,0,0
Agency,Federal Mediation/Conciliation Service,null,Non-CFO,0.0,0.0,0,0,0,0,31,12,4,2020,2020-12-31,1,2021,0,0
Agency,National Labor Relations Board,null,Non-CFO,0.0,0.0,0,0,0,0,31,12,4,2020,2020-12-31,1,2021,0,0
Agency,Neighborhood Reinvestment Corporation,null,Non-CFO,0.0,0.0,0,0,0,0,31,12,4,2020,2020-12-31,1,2021,0,0
Agency,National Foundation  Arts & Humanities,null,Non-CFO,0.0,0.0,0,0,0,0,31,12,4,2020,2020-12-31,1,2021,0,0
Agency,U.S. Court of Appeals / Veterans Claims,null,Non-CFO,100.0,100.0,0,0,172,1,31,12,4,2020,2020-12-31,1,2021,172,1
Agency,Other Agencies/Boards/Commissions,null,Non-CFO,0.0,0.0,482,1,0,0,31,12,4,2020,2020-12-31,1,2021,482,1
Agency,Farm Credit Administration,null,Non-CFO,100.0,100.0,0,0,630,1,31,12,4,2020,2020-12-31,1,2021,630,1
Agency,Consumer Product Safety Commission,null,Non-CFO,100.0,100.0,0,0,2500,1,31,12,4,2020,2020-12-31,1,2021,2500,1
Agency,Smithsonian Institution,null,Non-CFO,0.0,0.0,5670,1,0,0,31,12,4,2020,2020-12-31,1,2021,5670,1
Agency,Equal Employment Opportunity Commission,null,Non-CFO,100.0,100.0,0,0,24541,11,31,12,4,2020,2020-12-31,1,2021,24541,11
Agency,Legislative Branch-GPO,null,Non-CFO,100.0,100.0,0,0,84359,27,31,12,4,2020,2020-12-31,1,2021,84359,27
Agency,Armed Forces Retirement Home,null,Non-CFO,72.94544866205855,88.88888888888889,30099,13,81154,104,31,12,4,2020,2020-12-31,1,2021,111253,117
Agency,National Archives & Records Admin,null,Non-CFO,100.0,100.0,0,0,118848,101,31,12,4,2020,2020-12-31,1,2021,118848,101
Agency,Legislative Branch - U.S. House/Senate,null,Non-CFO,0.0,0.0,216891,161,0,0,31,12,4,2020,2020-12-31,1,2021,216891,161
Agency,Federal Maritime Commission,null,Non-CFO,100.0,100.0,0,0,397016,6,31,12,4,2020,2020-12-31,1,2021,397016,6
Agency,Federal Election Commission,null,Non-CFO,88.99821543466912,98.21428571428571,72500,2,586484,110,31,12,4,2020,2020-12-31,1,2021,658984,112
Bureau,Department of the Interior,"Bureau of Ocean Energy Mgmt., Reg & Enf",null,0.0,0.0,0,0,0,0,31,12,4,2020,2020-12-31,1,2021,0,0
Bureau,National Labor Relations Board,National Labor Relations Board,null,0.0,0.0,0,0,0,0,31,12,4,2020,2020-12-31,1,2021,0,0
Bureau,Department of Health & Human Services,Administration for Community Living,null,0.0,0.0,0,0,0,0,31,12,4,2020,2020-12-31,1,2021,0,0
Bureau,Export - Import  Bank,Export-Import Bank,null,0.0,0.0,0,0,0,0,31,12,4,2020,2020-12-31,1,2021,0,0
Bureau,Other Agencies,Morris K. Udall Scholarship,null,0.0,0.0,0,0,0,0,31,12,4,2020,2020-12-31,1,2021,0,0
Bureau,Other Agencies,Commission On Fine Arts,null,0.0,0.0,0,0,0,0,31,12,4,2020,2020-12-31,1,2021,0,0
Bureau,Department of the Treasury,International Monetary Funds,null,0.0,0.0,0,0,0,0,31,12,4,2020,2020-12-31,1,2021,0,0
Bureau,Other Agencies,National Mediation Board,null,0.0,0.0,0,0,0,0,31,12,4,2020,2020-12-31,1,2021,0,0
Bureau,Department of Homeland Security,Office of Health Affairs,null,0.0,0.0,0,0,0,0,31,12,4,2020,2020-12-31,1,2021,0,0
Bureau,Other Agencies/Boards/Commissions,U.S.-China Security Review Commission,null,0.0,0.0,482,1,0,0,31,12,4,2020,2020-12-31,1,2021,482,1
Bureau,U.S. Tax Court,U.S. Tax Court,null,0.0,0.0,0,0,0,0,31,12,4,2020,2020-12-31,1,2021,0,0
Bureau,Legis Branch-Library of Congress,Library of Congress,null,0.0,0.0,0,0,0,0,31,12,4,2020,2020-12-31,1,2021,0,0
Bureau,Department of Commerce,Minority Business Development Agency,null,0.0,0.0,0,0,0,0,31,12,4,2020,2020-12-31,1,2021,0,0
Bureau,Department of Commerce,Economic and Statistical Analysis,null,0.0,0.0,0,0,0,0,31,12,4,2020,2020-12-31,1,2021,0,0
Bureau,Department of Labor,Departmental Management,null,0.0,0.0,0,0,0,0,31,12,4,2020,2020-12-31,1,2021,0,0
Bureau,Department of State,Civil Monetary Penalties,null,0.0,0.0,0,0,0,0,31,12,4,2020,2020-12-31,1,2021,0,0
Bureau,Department of the Treasury,U.S. Treasury IG Office,null,0.0,0.0,0,0,0,0,31,12,4,2020,2020-12-31,1,2021,0,0
Bureau,Department of the Treasury,Treasury Forfeiture Fund,null,0.0,0.0,0,0,0,0,31,12,4,2020,2020-12-31,1,2021,0,0
Bureau,Smithsonian Institution,National Gallery of Art,null,0.0,0.0,0,0,0,0,31,12,4,2020,2020-12-31,1,2021,0,0
Bureau,National Foundation  Arts & Humanities,National Endowment for the Arts,null,0.0,0.0,0,0,0,0,31,12,4,2020,2020-12-31,1,2021,0,0
Bureau,Farm Credit Administration,Farm Credit System Insurance Corporation,null,0.0,0.0,0,0,0,0,31,12,4,2020,2020-12-31,1,2021,0,0
Bureau,Department of Housing and Urban Development,Government National Mortgage Association,null,0.0,0.0,0,0,0,0,31,12,4,2020,2020-12-31,1,2021,0,0
Bureau,Department of Housing and Urban Development,Community Planning and Development,null,0.0,0.0,0,0,0,0,31,12,4,2020,2020-12-31,1,2021,0,0
Bureau,Department of Housing and Urban Development,"Policy, Development and Research",null,0.0,0.0,0,0,0,0,31,12,4,2020,2020-12-31,1,2021,0,0
Bureau,Occupational Safety & Health Rev Comm,Occupational Safety & Health Rev Comm,null,0.0,0.0,0,0,0,0,31,12,4,2020,2020-12-31,1,2021,0,0
Bureau,Other Agencies,Architect of the Capitol,null,0.0,0.0,0,0,0,0,31,12,4,2020,2020-12-31,1,2021,0,0
Bureau,Other Agencies,District of Columbia Government,null,0.0,0.0,0,0,0,0,31,12,4,2020,2020-12-31,1,2021,0,0
Bureau,Other Agencies,Defense Nuclear Facilities Safety Board,null,0.0,0.0,0,0,0,0,31,12,4,2020,2020-12-31,1,2021,0,0
Bureau,Other Agencies,Archit.&Trans. Barriers Compliance Bd,null,0.0,0.0,0,0,0,0,31,12,4,2020,2020-12-31,1,2021,0,0
Bureau,Office of Government Ethics,Office of Government Ethics,null,0.0,0.0,0,0,0,0,31,12,4,2020,2020-12-31,1,2021,0,0
Bureau,Other Agencies,Gulf Coast Ecosystem Restoration Council,null,0.0,0.0,0,0,0,0,31,12,4,2020,2020-12-31,1,2021,0,0
Bureau,Other Agencies,Delta Regional Authority,null,0.0,0.0,0,0,0,0,31,12,4,2020,2020-12-31,1,2021,0,0
Bureau,Department of the Treasury,Pandemic Receivables,null,0.0,0.0,0,0,0,0,31,12,4,2020,2020-12-31,1,2021,0,0
Bureau,Legislative Branch-Office of Tech.,Open World Leadership,null,0.0,0.0,0,0,0,0,31,12,4,2020,2020-12-31,1,2021,0,0
Bureau,Funds Appropriated to the President,Executive Branch,null,0.0,0.0,0,0,0,0,31,12,4,2020,2020-12-31,1,2021,0,0
Bureau,Funds Appropriated to the President,Trade and Development Agency,null,0.0,0.0,0,0,0,0,31,12,4,2020,2020-12-31,1,2021,0,0
Bureau,Department of Justice,General Administration,null,0.0,0.0,0,0,0,0,31,12,4,2020,2020-12-31,1,2021,0,0
Bureau,Department of Justice,Office of Justice Assistance Programs,null,0.0,0.0,0,0,0,0,31,12,4,2020,2020-12-31,1,2021,0,0
Bureau,Department of State,International Commissions,null,0.0,0.0,0,0,0,0,31,12,4,2020,2020-12-31,1,2021,0,0
Bureau,Department of the Treasury,Office of Sec International Affairs,null,0.0,0.0,0,0,0,0,31,12,4,2020,2020-12-31,1,2021,0,0
Bureau,Department of the Treasury,Treasury IG for Tax Admin,null,0.0,0.0,0,0,0,0,31,12,4,2020,2020-12-31,1,2021,0,0
Bureau,National Credit Union Administration,National Credit Union Administration,null,0.0,0.0,0,0,0,0,31,12,4,2020,2020-12-31,1,2021,0,0
Bureau,Smithsonian Institution,JFK Center for the Performing Arts,null,0.0,0.0,0,0,0,0,31,12,4,2020,2020-12-31,1,2021,0,0
Bureau,Tennessee Valley Authority,Tennessee Valley Authority,null,0.0,0.0,0,0,0,0,31,12,4,2020,2020-12-31,1,2021,0,0
Bureau,Department of Homeland Security,Science and Technology,null,0.0,0.0,0,0,0,0,31,12,4,2020,2020-12-31,1,2021,0,0
Bureau,Department of Homeland Security,Info Analysis Infrastructure Prot-NPPD,null,0.0,0.0,0,0,0,0,31,12,4,2020,2020-12-31,1,2021,0,0
Bureau,American Battle Monuments Commission,American Battle Monuments Commission,null,0.0,0.0,0,0,0,0,31,12,4,2020,2020-12-31,1,2021,0,0
Bureau,Neighborhood Reinvestment Corporation,Neighborhood Reinvestment Corporation,null,0.0,0.0,0,0,0,0,31,12,4,2020,2020-12-31,1,2021,0,0
Bureau,Selective Service System,Selective Service System,null,0.0,0.0,0,0,0,0,31,12,4,2020,2020-12-31,1,2021,0,0
Bureau,Federal Mediation/Conciliation Service,Federal Mediation/Conciliation Service,null,0.0,0.0,0,0,0,0,31,12,4,2020,2020-12-31,1,2021,0,0
Bureau,Other Agencies,Advisory Council on Hist. Preservation,null,0.0,0.0,0,0,0,0,31,12,4,2020,2020-12-31,1,2021,0,0
Bureau,Other Agencies,National Capital Planning Commission,null,0.0,0.0,0,0,0,0,31,12,4,2020,2020-12-31,1,2021,0,0
Bureau,Department of the Treasury,Office of Financial Research,null,0.0,0.0,0,0,0,0,31,12,4,2020,2020-12-31,1,2021,0,0
Bureau,Smithsonian Institution,Administrative Conference of the US,null,0.0,0.0,0,0,0,0,31,12,4,2020,2020-12-31,1,2021,0,0
Bureau,US International Development Fin. Corp.,US International Development Fin. Corp.,null,0.0,0.0,0,0,0,0,31,12,4,2020,2020-12-31,1,2021,0,0
Bureau,Legislative Branch-GAO,Government Accountability Office,null,0.0,0.0,0,0,0,0,31,12,4,2020,2020-12-31,1,2021,0,0
Bureau,Funds Appropriated to the President,Inter-American Foundation,null,0.0,0.0,0,0,0,0,31,12,4,2020,2020-12-31,1,2021,0,0
Bureau,Funds Appropriated to the President,Peace Corps,null,0.0,0.0,0,0,0,0,31,12,4,2020,2020-12-31,1,2021,0,0
Bureau,Funds Appropriated to the President,African Development Foundation,null,0.0,0.0,0,0,0,0,31,12,4,2020,2020-12-31,1,2021,0,0
Bureau,Department of the Treasury,Office of the Secretary,null,0.0,0.0,0,0,0,0,31,12,4,2020,2020-12-31,1,2021,0,0
Bureau,Department of the Treasury,Interest on Tax/Deposit of Earnings,null,0.0,0.0,0,0,0,0,31,12,4,2020,2020-12-31,1,2021,0,0
Bureau,Other Agencies/Boards/Commissions,U.S. Comm. on Int. Religious Freedom,null,0.0,0.0,0,0,0,0,31,12,4,2020,2020-12-31,1,2021,0,0
Bureau,Federal Deposit Insurance Corporation,Federal Deposit Insurance Corporation,null,0.0,0.0,0,0,0,0,31,12,4,2020,2020-12-31,1,2021,0,0
Bureau,Federal Labor Relations Authority,Federal Labor Relations Authority,null,0.0,0.0,0,0,0,0,31,12,4,2020,2020-12-31,1,2021,0,0
Bureau,Department of Homeland Security,Management Headquarters,null,0.0,0.0,0,0,0,0,31,12,4,2020,2020-12-31,1,2021,0,0
Bureau,Department of Homeland Security,Federal Law Enforcement Training Ctr.,null,0.0,0.0,0,0,0,0,31,12,4,2020,2020-12-31,1,2021,0,0
Bureau,Other Agencies,Federal Mine Safety & Health Review Comm,null,0.0,0.0,0,0,0,0,31,12,4,2020,2020-12-31,1,2021,0,0
Bureau,Other Agencies,Chemical Safety Board,null,0.0,0.0,0,0,0,0,31,12,4,2020,2020-12-31,1,2021,0,0
Bureau,Other Agencies,National Transportation Safety Board,null,0.0,0.0,0,0,0,0,31,12,4,2020,2020-12-31,1,2021,0,0
Bureau,Other Agencies,Denali Commission,null,0.0,0.0,0,0,0,0,31,12,4,2020,2020-12-31,1,2021,0,0
Bureau,Other Agencies,Federal Housing Finance Agency OIG,null,0.0,0.0,0,0,0,0,31,12,4,2020,2020-12-31,1,2021,0,0
Bureau,Other Agencies/Boards/Commissions,Medicare Payment Advisory Commission,null,0.0,0.0,0,0,0,0,31,12,4,2020,2020-12-31,1,2021,0,0
Bureau,Department of Homeland Security,Office of Biometric Identity Management,null,0.0,0.0,0,0,0,0,31,12,4,2020,2020-12-31,1,2021,0,0
Bureau,Other Agencies,Surface Transportation Board,null,0.0,0.0,0,0,0,0,31,12,4,2020,2020-12-31,1,2021,0,0
Bureau,Other Agencies,Privacy & Civil Liberties Oversight Bd,null,0.0,0.0,0,0,0,0,31,12,4,2020,2020-12-31,1,2021,0,0
Bureau,Department of the Treasury,Treasury Franchise Fund,null,100.0,100.0,0,0,66,1,31,12,4,2020,2020-12-31,1,2021,66,1
Bureau,Legislative Branch-CBO,Congressional Budget Office,null,0.0,0.0,0,0,0,0,31,12,4,2020,2020-12-31,1,2021,0,0
Bureau,Funds Appropriated to the President,Defense Security Assistance Agency,null,0.0,0.0,0,0,0,0,31,12,4,2020,2020-12-31,1,2021,0,0
Bureau,Department of Commerce,Office of the Inspector General,null,0.0,0.0,0,0,0,0,31,12,4,2020,2020-12-31,1,2021,0,0
Bureau,Office of Special Counsel,Office of Special Counsel,null,0.0,0.0,0,0,0,0,31,12,4,2020,2020-12-31,1,2021,0,0
Bureau,National Foundation  Arts & Humanities,National Endowment for the Humanities,null,0.0,0.0,0,0,0,0,31,12,4,2020,2020-12-31,1,2021,0,0
Bureau,Department of Homeland Security,U.S. Secret Service,null,0.0,0.0,0,0,0,0,31,12,4,2020,2020-12-31,1,2021,0,0
Bureau,Department of Education,Office of Postsecondary Education,null,0.0,0.0,0,0,0,0,31,12,4,2020,2020-12-31,1,2021,0,0
Bureau,Other Agencies,U.S. Institute of Peace,null,0.0,0.0,0,0,0,0,31,12,4,2020,2020-12-31,1,2021,0,0
Bureau,Other Agencies,Comm. for Purchase from Blind/Handic.,null,0.0,0.0,0,0,0,0,31,12,4,2020,2020-12-31,1,2021,0,0
Bureau,Legislative Branch-Office of Tech.,Medicaid & CHIP Payment & Access Comm.,null,0.0,0.0,0,0,0,0,31,12,4,2020,2020-12-31,1,2021,0,0
Bureau,Department of Homeland Security,Office of the Inspector General DHS,null,100.0,100.0,0,0,100,1,31,12,4,2020,2020-12-31,1,2021,100,1
Bureau,Department of Health & Human Services,Office of the Inspector General,null,100.0,100.0,0,0,131,1,31,12,4,2020,2020-12-31,1,2021,131,1
Bureau,Merit Systems Protection Board,Merit Systems Protection Board,null,100.0,100.0,0,0,144,1,31,12,4,2020,2020-12-31,1,2021,144,1
Bureau,U.S. Court of Appeals / Veterans Claims,U.S. Court of Appeals / Veterans Claims,null,100.0,100.0,0,0,172,1,31,12,4,2020,2020-12-31,1,2021,172,1
Bureau,Other Agencies,Federal Housing Finance Agency,null,0.0,0.0,191,1,0,0,31,12,4,2020,2020-12-31,1,2021,191,1
Bureau,Department of Transportation,Office of the Inspector General,null,100.0,100.0,0,0,211,1,31,12,4,2020,2020-12-31,1,2021,211,1
Bureau,Farm Credit Administration,Farm Credit Administration,null,100.0,100.0,0,0,630,1,31,12,4,2020,2020-12-31,1,2021,630,1
Bureau,Other Agencies,Millennium Challenge Corporation,null,100.0,100.0,0,0,817,1,31,12,4,2020,2020-12-31,1,2021,817,1
Bureau,Department of the Treasury,Tobacco Tax and Trade,null,100.0,100.0,0,0,1000,1,31,12,4,2020,2020-12-31,1,2021,1000,1
Bureau,Department of Transportation,Research Innovative Technology Admin,null,100.0,100.0,0,0,1599,2,31,12,4,2020,2020-12-31,1,2021,1599,2
Bureau,Department of State,Passport NSF,null,100.0,100.0,0,0,2394442,15431,31,12,4,2020,2020-12-31,1,2021,2394442,15431
Bureau,Department of Homeland Security,U.S. Coast Guard,null,100.0,100.0,0,0,78776929,12863,31,12,4,2020,2020-12-31,1,2021,78776929,12863
Bureau,Department of Commerce,National Technical Information Service,null,100.0,100.0,0,0,2100,1,31,12,4,2020,2020-12-31,1,2021,2100,1
Bureau,Consumer Product Safety Commission,Consumer Product Safety Commission,null,100.0,100.0,0,0,2500,1,31,12,4,2020,2020-12-31,1,2021,2500,1
Bureau,Department of Commerce,International Trade Administration,null,0.0,0.0,2739,41,0,0,31,12,4,2020,2020-12-31,1,2021,2739,41
Bureau,Department of Homeland Security,Domestic Nuclear Detection Office,null,0.0,0.0,2803,5,0,0,31,12,4,2020,2020-12-31,1,2021,2803,5
Bureau,Other Agencies,John C. Stennis,null,0.0,0.0,2934,2,0,0,31,12,4,2020,2020-12-31,1,2021,2934,2
Bureau,Department of the Treasury,Spec Insp Gen-Troubled Asset Rel Prog,null,100.0,100.0,0,0,3916,1,31,12,4,2020,2020-12-31,1,2021,3916,1
Bureau,Department of Commerce,General Administration,null,100.0,100.0,0,0,4660,1,31,12,4,2020,2020-12-31,1,2021,4660,1
Bureau,Other Agencies,U.S.  Agency of Global Media,null,100.0,100.0,0,0,4930,2,31,12,4,2020,2020-12-31,1,2021,4930,2
Bureau,Other Agencies,U.S. Inst. for Env. Conflict Resolution,null,0.0,0.0,5003,2,0,0,31,12,4,2020,2020-12-31,1,2021,5003,2
Bureau,Department of Transportation,Maritime Administration,null,100.0,100.0,0,0,5395,6,31,12,4,2020,2020-12-31,1,2021,5395,6
Bureau,Other Agencies,Council of Insps. Gen. of Intg. & Effy.,null,0.0,0.0,5475,9,0,0,31,12,4,2020,2020-12-31,1,2021,5475,9
Bureau,Other Agencies,Election Assistance Commission,null,0.0,0.0,5576,1,0,0,31,12,4,2020,2020-12-31,1,2021,5576,1
Bureau,Smithsonian Institution,Smithsonian Institution,null,0.0,0.0,5670,1,0,0,31,12,4,2020,2020-12-31,1,2021,5670,1
Bureau,Department of Health & Human Services,Office of the Secretary,null,100.0,100.0,0,0,8329,8,31,12,4,2020,2020-12-31,1,2021,8329,8
Bureau,Department of Transportation,St. Lawrence Seaway Development Corp.,null,100.0,100.0,0,0,8903,2,31,12,4,2020,2020-12-31,1,2021,8903,2
Bureau,Department of Labor,Bureau of Labor Statistics,null,100.0,100.0,0,0,10534,1,31,12,4,2020,2020-12-31,1,2021,10534,1
Bureau,Department of Justice,U.S. Marshals Service,null,0.0,0.0,11961,9,0,0,31,12,4,2020,2020-12-31,1,2021,11961,9
Bureau,Department of Transportation,National Highway Traffic Safety Admin.,null,100.0,100.0,0,0,18189,3,31,12,4,2020,2020-12-31,1,2021,18189,3
Bureau,Department of Justice,Bureau of ATF and Explosives,null,100.0,100.0,0,0,20422,4,31,12,4,2020,2020-12-31,1,2021,20422,4
Agency,National Science Foundation,null,CFO,99.80654205412226,98.78048780487805,926,1,477731,81,31,12,4,2020,2020-12-31,1,2021,478657,82
Agency,National Aeronautics and Space Administration,null,CFO,100.0,100.0,0,0,1268442,128,31,12,4,2020,2020-12-31,1,2021,1268442,128
Agency,Nuclear Regulatory Commission,null,CFO,99.5862666583599,99.6774193548387,10227,1,2461655,309,31,12,4,2020,2020-12-31,1,2021,2471882,310
Agency,General Services Administration,null,CFO,75.04968006898503,66.1715380929564,1619157,706,4870367,1381,31,12,4,2020,2020-12-31,1,2021,6489524,2087
Agency,Department of Veterans Affairs,null,CFO,60.06761652835057,71.65256346441015,4366212,3417,6567801,8637,31,12,4,2020,2020-12-31,1,2021,10934013,12054
Agency,Department of State,null,CFO,79.90410695149306,90.90796889784836,4110170,2210,16342616,22097,31,12,4,2020,2020-12-31,1,2021,20452786,24307
Agency,Office of Personnel Management,null,CFO,98.3532087651813,96.70487106017193,373161,46,22286724,1350,31,12,4,2020,2020-12-31,1,2021,22659885,1396
Bureau,Equal Employment Opportunity Commission,Equal Employment Opportunity Commission,null,100.0,100.0,0,0,24541,11,31,12,4,2020,2020-12-31,1,2021,24541,11
Bureau,Department of Agriculture,Federal Crop Insurance Corporation,null,86.41855818164788,0.0,4350,1,27679,0,31,12,4,2020,2020-12-31,1,2021,32029,1
Bureau,Department of the Treasury,U.S. Mint,null,100.0,100.0,0,0,45558,25,31,12,4,2020,2020-12-31,1,2021,45558,25
Bureau,Legislative Branch-GPO,Government Publishing Office,null,100.0,100.0,0,0,84359,27,31,12,4,2020,2020-12-31,1,2021,84359,27
Bureau,Department of the Treasury,Bureau of Engraving and Printing,null,100.0,100.0,0,0,84528,1,31,12,4,2020,2020-12-31,1,2021,84528,1
Bureau,Department of the Interior,Office of the Secretary,null,100.0,100.0,0,0,88635,21,31,12,4,2020,2020-12-31,1,2021,88635,21
Bureau,Department of the Interior,Bureau of Reclamation,null,100.0,100.0,0,0,95773,78,31,12,4,2020,2020-12-31,1,2021,95773,78
Bureau,Department of Housing and Urban Development,Management and Administration,null,3.24220426960153,62.5,99169,3,3323,5,31,12,4,2020,2020-12-31,1,2021,102492,8
Bureau,Armed Forces Retirement Home,Armed Forces Retirement Home,null,72.94544866205855,88.88888888888889,30099,13,81154,104,31,12,4,2020,2020-12-31,1,2021,111253,117
Bureau,National Archives & Records Admin,Nat'l Archives & Records Administration,null,100.0,100.0,0,0,118848,101,31,12,4,2020,2020-12-31,1,2021,118848,101
Bureau,Department of the Treasury,Community Dev Financial Inst Fund,null,100.0,100.0,0,0,4506298,8,31,12,4,2020,2020-12-31,1,2021,4506298,8
Agency,Department of Commerce,null,CFO,99.99063477969285,98.00680602819641,2739,41,29243770,2016,31,12,4,2020,2020-12-31,1,2021,29246509,2057
Agency,Agency for International Development,null,CFO,95.3570246525137,95.3125,1676237,3,34426410,61,31,12,4,2020,2020-12-31,1,2021,36102647,64
Agency,Department of the Treasury,null,CFO,98.66845406775106,99.46753692889041,605525,31,44869812,5791,31,12,4,2020,2020-12-31,1,2021,45475337,5822
Agency,Department of Transportation,null,CFO,99.0788647303713,99.29276754737123,609735,53,65584126,7441,31,12,4,2020,2020-12-31,1,2021,66193861,7494
Agency,Department of the Interior,null,CFO,99.99990570983522,99.99701919637535,86,1,91207730,33547,31,12,4,2020,2020-12-31,1,2021,91207816,33548
Agency,Department of Justice,null,CFO,95.79930545198604,98.99989500209996,3849179,381,87782787,37715,31,12,4,2020,2020-12-31,1,2021,91631966,38096
Agency,Department of Housing and Urban Development,null,CFO,99.43983258040497,99.83700081499593,790556,8,140337966,4900,31,12,4,2020,2020-12-31,1,2021,141128522,4908
Agency,Department of Labor,null,CFO,89.38334459015422,90.72496067121132,20726873,4245,174502907,41523,31,12,4,2020,2020-12-31,1,2021,195229780,45768
Agency,Social Security Administration,null,CFO,58.42332992960558,33.253889147897475,2086998594,996434,2932640041,496438,31,12,4,2020,2020-12-31,1,2021,5019638635,1492872
Bureau,Department of Transportation,Federal Highway Administration,null,100.0,100.0,0,0,123342,7,31,12,4,2020,2020-12-31,1,2021,123342,7
Bureau,Department of Transportation,Federal Railroad Administration,null,100.0,100.0,0,0,127629,12,31,12,4,2020,2020-12-31,1,2021,127629,12
Bureau,Department of the Interior,Geological Survey,null,100.0,100.0,0,0,135591,120,31,12,4,2020,2020-12-31,1,2021,135591,120
Bureau,Legislative Branch - U.S. House/Senate,U.S. House of Representatives,null,0.0,0.0,216891,161,0,0,31,12,4,2020,2020-12-31,1,2021,216891,161
Bureau,Other Agencies,James Madison Memorial Fellowship,null,0.0,0.0,221290,25,0,0,31,12,4,2020,2020-12-31,1,2021,221290,25
Bureau,Department of Justice,Federal Bureau of Investigation,null,100.0,100.0,0,0,260265,66,31,12,4,2020,2020-12-31,1,2021,260265,66
Bureau,Department of the Treasury,Internal Revenue Service,null,100.0,100.0,0,0,267235,138,31,12,4,2020,2020-12-31,1,2021,267235,138
Bureau,Department of Commerce,Bureau of the Census,null,100.0,100.0,0,0,281317,501,31,12,4,2020,2020-12-31,1,2021,281317,501
Bureau,Department of Commerce,Nat'l Telecomm & Information Admin.,null,100.0,100.0,0,0,296093,1,31,12,4,2020,2020-12-31,1,2021,296093,1
Bureau,Department of Justice,Drug Enforcement Administration,null,100.0,100.0,0,0,307978,21,31,12,4,2020,2020-12-31,1,2021,307978,21
Bureau,Securities & Exchange Commission,Securities and Exchange Commission,null,100.0,100.0,0,0,308160,53,31,12,4,2020,2020-12-31,1,2021,308160,53
Bureau,Other Agencies,Consumer Financial Protection Bureau,null,0.0,0.0,5681484,74,0,0,31,12,4,2020,2020-12-31,1,2021,5681484,74
Bureau,Department of Commerce,Patent and Trademark Office,null,100.0,100.0,0,0,352312,569,31,12,4,2020,2020-12-31,1,2021,352312,569
Bureau,Department of Transportation,Pipeline Hazardous Material Safety Admin,null,100.0,100.0,0,0,386240,24,31,12,4,2020,2020-12-31,1,2021,386240,24
Bureau,Federal Maritime Commission,Salaries and Expenses,null,100.0,100.0,0,0,397016,6,31,12,4,2020,2020-12-31,1,2021,397016,6
Bureau,Department of the Treasury,D.C. Pension Program,null,100.0,100.0,0,0,402782,23,31,12,4,2020,2020-12-31,1,2021,402782,23
Bureau,National Science Foundation,National Science Foundation,null,99.80654205412226,98.78048780487805,926,1,477731,81,31,12,4,2020,2020-12-31,1,2021,478657,82
Bureau,Federal Election Commission,Federal Election Commission,null,88.99821543466912,98.21428571428571,72500,2,586484,110,31,12,4,2020,2020-12-31,1,2021,658984,112
Bureau,Department of Commerce,Nat'l Institute of Standards& Technology,null,100.0,100.0,0,0,670552,5,31,12,4,2020,2020-12-31,1,2021,670552,5
Bureau,Department of the Interior,Fish and Wildlife Service,null,100.0,100.0,0,0,703719,76,31,12,4,2020,2020-12-31,1,2021,703719,76
Bureau,Department of Veterans Affairs,Life Insurance,null,100.0,100.0,0,0,735269,135,31,12,4,2020,2020-12-31,1,2021,735269,135
Bureau,Department of Agriculture,Food Safety and Inspection Service,null,100.0,100.0,0,0,752630,848,31,12,4,2020,2020-12-31,1,2021,752630,848
Bureau,Department of Transportation,Federal Transit Administration,null,100.0,100.0,0,0,784592,2,31,12,4,2020,2020-12-31,1,2021,784592,2
Bureau,Department of Justice,Federal Prison System,null,100.0,100.0,0,0,902521,136,31,12,4,2020,2020-12-31,1,2021,902521,136
Bureau,Department of Justice,Federal Prison Industries,null,100.0,100.0,0,0,935102,183,31,12,4,2020,2020-12-31,1,2021,935102,183
Bureau,Department of Veterans Affairs,Housing Credit Assistance,null,0.0,0.0,944684,22,0,0,31,12,4,2020,2020-12-31,1,2021,944684,22
Bureau,Department of Health & Human Services,Substance Abuse & Mental Health Admin.,null,100.0,100.0,0,0,960275,13,31,12,4,2020,2020-12-31,1,2021,960275,13
Bureau,Department of Transportation,Office of the Secretary,null,100.0,100.0,0,0,1040394,15,31,12,4,2020,2020-12-31,1,2021,1040394,15
Bureau,The Judiciary,Administrative Office of the U.S. Courts,null,93.69729131780971,59.177215189873415,66320,129,985926,187,31,12,4,2020,2020-12-31,1,2021,1052246,316
Bureau,Department of Homeland Security,Citizenship and Immigration Services,null,100.0,100.0,0,0,1062493,1244,31,12,4,2020,2020-12-31,1,2021,1062493,1244
Bureau,Department of the Treasury,Comptroller of the Currency,null,99.88453231961236,84.0,1273,4,1101200,21,31,12,4,2020,2020-12-31,1,2021,1102473,25
Bureau,Department of Energy,Bonneville Power Administration,null,100.0,100.0,0,0,1649642,31,31,12,4,2020,2020-12-31,1,2021,1649642,31
Bureau,Department of Labor,Employment Standards Administration,null,84.59004715352832,93.32845703726517,13442650,1733,73790907,24243,31,12,4,2020,2020-12-31,1,2021,87233557,25976
Bureau,National Aeronautics and Space Administration,National Aeronautics and Space Admin,null,100.0,100.0,0,0,1268442,128,31,12,4,2020,2020-12-31,1,2021,1268442,128
Bureau,Department of Veterans Affairs,Veterans Benefits,null,0.0,0.0,1290244,1694,0,0,31,12,4,2020,2020-12-31,1,2021,1290244,1694
Bureau,Presidio Trust Corporation,Presidio Trust Corporation,null,100.0,100.0,0,0,1517237,78,31,12,4,2020,2020-12-31,1,2021,1517237,78
Bureau,Department of the Treasury,Financial Crimes Enforcement Network,null,96.08733374589127,75.0,62910,1,1544945,3,31,12,4,2020,2020-12-31,1,2021,1607855,4
Bureau,Department of Commerce,Bureau of Industry and Security,null,100.0,100.0,0,0,1738130,23,31,12,4,2020,2020-12-31,1,2021,1738130,23
Bureau,Department of Housing and Urban Development,Public and Indian Housing Programs,null,71.87672577459652,40.0,683924,3,1747955,2,31,12,4,2020,2020-12-31,1,2021,2431879,5
Bureau,Department of Labor,Mine Safety and Health Administration,null,85.27364295613732,91.84685008260901,4364813,1135,25274649,12786,31,12,4,2020,2020-12-31,1,2021,29639462,13921
Bureau,Department of Agriculture,U.S. Department of Agriculture,null,83.9840826304227,54.6133853151397,5412705,1397,28383080,1681,31,12,4,2020,2020-12-31,1,2021,33795785,3078
Bureau,Agency for International Development,Agency for International Development,null,95.3570246525137,95.3125,1676237,3,34426410,61,31,12,4,2020,2020-12-31,1,2021,36102647,64
Bureau,Department of Health & Human Services,Indian Health Services,null,74.25251915292421,6.851604278074866,10107368,2787,29148387,205,31,12,4,2020,2020-12-31,1,2021,39255755,2992
Bureau,Department of the Interior,Bureau of Indian Affairs,null,100.0,100.0,0,0,54852510,30210,31,12,4,2020,2020-12-31,1,2021,54852510,30210
Bureau,Department of Labor,Occupational Safety and Health Admin,null,94.90774803350074,74.79868228404099,2919410,1377,54411021,4087,31,12,4,2020,2020-12-31,1,2021,57330431,5464
Bureau,Department of Transportation,Federal Motor Carrier Safety Admin,null,100.0,100.0,0,0,61175749,7101,31,12,4,2020,2020-12-31,1,2021,61175749,7101
Bureau,Department of Agriculture,Forest Service,null,90.53583805964014,25.362937660119556,6453775,874,61737947,297,31,12,4,2020,2020-12-31,1,2021,68191722,1171
Bureau,Department of Veterans Affairs,Medical and Construction,null,85.63333499825184,89.21671566568669,977959,1027,5829181,8497,31,12,4,2020,2020-12-31,1,2021,6807140,9524
Bureau,Department of Health & Human Services,Centers for Disease Control,null,0.8900138235321832,12.5,7047056,98,63283,14,31,12,4,2020,2020-12-31,1,2021,7110339,112
Bureau,Department of the Interior,National Park Service,null,100.0,100.0,0,0,7821051,1865,31,12,4,2020,2020-12-31,1,2021,7821051,1865
Bureau,Department of Agriculture,Food and Nutrition Service,null,0.6322043957194682,1.1516314779270633,7933022,515,50472,6,31,12,4,2020,2020-12-31,1,2021,7983494,521
Bureau,Department of the Interior,Office of Natural Resources Revenue,null,100.0,100.0,0,0,8372806,501,31,12,4,2020,2020-12-31,1,2021,8372806,501
Bureau,Department of Homeland Security,Bureau of Customs & Border Protection,null,100.0,100.0,0,0,8771871,629,31,12,4,2020,2020-12-31,1,2021,8771871,629
Bureau,Department of Energy,Energy Consolidated Reports,null,100.0,100.0,0,0,12855452,76,31,12,4,2020,2020-12-31,1,2021,12855452,76
Bureau,Department of Homeland Security,Immigration and Customs Enforcement,null,100.0,100.0,0,0,13307886,521,31,12,4,2020,2020-12-31,1,2021,13307886,521
Bureau,Department of the Treasury,Bureau of the Fiscal Service,null,100.0,100.0,0,0,13618512,4215,31,12,4,2020,2020-12-31,1,2021,13618512,4215
Bureau,Department of the Interior,Bureau of Land Management,null,100.0,100.0,0,0,15889204,351,31,12,4,2020,2020-12-31,1,2021,15889204,351
Bureau,Department of Health & Human Services,National Institutes of Health,null,38.97235004576991,22.803347280334727,9900180,369,6322270,109,31,12,4,2020,2020-12-31,1,2021,16222450,478
Bureau,Department of Labor,Employee Benefit Security Administration,null,100.0,100.0,0,0,17652069,396,31,12,4,2020,2020-12-31,1,2021,17652069,396
Bureau,Department of State,Department of State,null,77.23949660057423,75.10139702568725,4110170,2210,13948174,6666,31,12,4,2020,2020-12-31,1,2021,18058344,8876
Bureau,Department of Commerce,NOAA,null,100.0,100.0,0,0,20793411,904,31,12,4,2020,2020-12-31,1,2021,20793411,904
Bureau,Railroad Retirement Board,Railroad Retirement Board,null,100.0,100.0,0,0,22009163,4400,31,12,4,2020,2020-12-31,1,2021,22009163,4400
Bureau,Department of Agriculture,Commodity Credit Corporation,null,100.0,100.0,0,0,130340355,10966,31,12,4,2020,2020-12-31,1,2021,130340355,10966
Bureau,Office of Personnel Management,Office of Personnel Management,null,98.3532087651813,96.70487106017193,373161,46,22286724,1350,31,12,4,2020,2020-12-31,1,2021,22659885,1396
Bureau,Department of the Treasury,Departmental Offices,null,97.72880465350407,98.1159420289855,541342,26,23293772,1354,31,12,4,2020,2020-12-31,1,2021,23835114,1380
Bureau,Environmental Protection Agency,Environmental Protection Agency,null,99.98197721150672,99.13793103448276,4360,2,24187235,230,31,12,4,2020,2020-12-31,1,2021,24191595,232
Bureau,Department of Health & Human Services,Administration for Children and Families,null,100.0,100.0,0,0,29708295,1814,31,12,4,2020,2020-12-31,1,2021,29708295,1814
Bureau,Department of Justice,Legal Activities,null,95.69788306949917,99.01266024364998,3837218,372,85356499,37305,31,12,4,2020,2020-12-31,1,2021,89193717,37677
Bureau,Department of Health & Human Services,Health Resources and Services Admin,null,100.0,100.0,0,0,92118711,578,31,12,4,2020,2020-12-31,1,2021,92118711,578
Bureau,U.S. Postal Service,U.S. Postal Service,null,48.94763860618539,83.59068551148745,47376549,10542,45423368,53702,31,12,4,2020,2020-12-31,1,2021,92799917,64244
Bureau,Department of Health & Human Services,Food and Drug Administration,null,29.757740578102503,10.315512708150745,72061928,10233,30528633,1177,31,12,4,2020,2020-12-31,1,2021,102590561,11410
Bureau,Department of Housing and Urban Development,Housing Programs,null,99.99461521287432,99.9591419816139,7463,2,138586688,4893,31,12,4,2020,2020-12-31,1,2021,138594151,4895
Bureau,Federal Communications Commission,Federal Communications Commission,null,100.0,100.0,0,0,205320179,20509,31,12,4,2020,2020-12-31,1,2021,205320179,20509
Bureau,Department of Homeland Security,Emergency Preparedness & Resp,null,100.0,100.0,0,0,301354801,43093,31,12,4,2020,2020-12-31,1,2021,301354801,43093
Bureau,Federal Trade Commission,Federal Trade Commission,null,100.0,100.0,0,0,483060628,55,31,12,4,2020,2020-12-31,1,2021,483060628,55
Bureau,Department of Agriculture,Farm Service Agency,null,100.0,100.0,0,0,643825444,11690,31,12,4,2020,2020-12-31,1,2021,643825444,11690
Bureau,Commodity Futures Trading Commission,Commodity Futures Trading Commission,null,100.0,100.0,0,0,651938594,366,31,12,4,2020,2020-12-31,1,2021,651938594,366
Bureau,Small Business Administration,Small Business Administration,null,100.0,100.0,0,0,12370402730,119782,31,12,4,2020,2020-12-31,1,2021,12370402730,119782
Bureau,Department of Education,Federal Student Aid,null,100.0,100.0,0,0,135911358378,23483951,31,12,4,2020,2020-12-31,1,2021,135911358378,23483951
Bureau,Department of Agriculture,Rural Development,null,99.99870052473892,99.96349413298566,9547,7,734671619,19168,31,12,4,2020,2020-12-31,1,2021,734681166,19175
Bureau,Department of Education,Departmental Management,null,93.89168177914402,81.3844714686623,51866318,398,797243308,1740,31,12,4,2020,2020-12-31,1,2021,849109626,2138
Bureau,Securities & Exchange Commission,SEC Enforcement,null,100.0,100.0,0,0,1958478368,938,31,12,4,2020,2020-12-31,1,2021,1958478368,938
Bureau,Department of Defense,Consolidated Report,null,45.154931137347866,15.868367990246393,1290580009,1453257,1062557722,274104,31,12,4,2020,2020-12-31,1,2021,2353137731,1727361
Bureau,Social Security Administration,Social Security Administration,null,58.42332992960558,33.253889147897475,2086998594,996434,2932640041,496438,31,12,4,2020,2020-12-31,1,2021,5019638635,1492872
Bureau,Department of Health & Human Services,Centers for Medicare & Medicaid Services,null,99.05874906387105,99.42686265278722,89248147,6574,9392617270,1140446,31,12,4,2020,2020-12-31,1,2021,9481865417,1147020
Bureau,Other Agencies,U.S. Holocaust Memorial Council,null,0.0,0.0,0,0,0,0,31,12,4,2020,2020-12-31,1,2021,0,0
Bureau,Department of Agriculture,Agricultural Marketing Service,null,91.45295038472997,33.862111043319096,451812,1084,4834363,555,31,03,1,2021,2021-03-31,2,2021,5286175,1639
Bureau,Department of Justice,U.S. Marshals Service,null,0.0,0.0,4267,3,0,0,31,03,1,2021,2021-03-31,2,2021,4267,3
Bureau,Department of the Treasury,Bureau of Engraving and Printing,null,100.0,100.0,0,0,84528,1,31,03,1,2021,2021-03-31,2,2021,84528,1
Bureau,Department of the Interior,Office of Surface Mining,null,100.0,100.0,0,0,5511946,348,31,03,1,2021,2021-03-31,2,2021,5511946,348
Bureau,Department of Education,Departmental Management,null,85.44746081351202,73.23580034423408,134171294,622,787807285,1702,31,03,1,2021,2021-03-31,2,2021,921978579,2324
Bureau,Department of Education,Federal Student Aid,null,100.0,100.0,0,0,134614195297,23302634,31,03,1,2021,2021-03-31,2,2021,134614195297,23302634
Agency,Federal Trade Commission,null,Non-CFO,100.0,100.0,0,0,483058157,55,31,03,1,2021,2021-03-31,2,2021,483058157,55
Bureau,Department of the Treasury,International Monetary Funds,null,0.0,0.0,0,0,0,0,31,03,1,2021,2021-03-31,2,2021,0,0
Bureau,Other Agencies,National Mediation Board,null,0.0,0.0,0,0,0,0,31,03,1,2021,2021-03-31,2,2021,0,0
Bureau,Consumer Product Safety Commission,Consumer Product Safety Commission,null,100.0,100.0,0,0,2500,1,31,03,1,2021,2021-03-31,2,2021,2500,1
Bureau,Other Agencies,U.S. Holocaust Memorial Council,null,0.0,0.0,0,0,0,0,31,03,1,2021,2021-03-31,2,2021,0,0
Bureau,Small Business Administration,Small Business Administration,null,100.0,100.0,0,0,12394281956,119416,31,03,1,2021,2021-03-31,2,2021,12394281956,119416
Agency,Small Business Administration,null,CFO,100.0,100.0,0,0,12394281956,119416,31,03,1,2021,2021-03-31,2,2021,12394281956,119416
Agency,Department of Education,null,CFO,99.90100702258074,99.99733104003019,134171294,622,135402002582,23304336,31,03,1,2021,2021-03-31,2,2021,135536173876,23304958
Agency,Selective Service System,null,Non-CFO,0.0,0.0,0,0,0,0,31,03,1,2021,2021-03-31,2,2021,0,0
Agency,Legislative Branch-GPO,null,Non-CFO,100.0,100.0,0,0,75651,9,31,03,1,2021,2021-03-31,2,2021,75651,9
Agency,Armed Forces Retirement Home,null,Non-CFO,71.07681713443219,86.06557377049181,32761,17,80508,105,31,03,1,2021,2021-03-31,2,2021,113269,122
Agency,National Archives & Records Admin,null,Non-CFO,100.0,100.0,0,0,145306,114,31,03,1,2021,2021-03-31,2,2021,145306,114
Agency,Legislative Branch - U.S. House/Senate,null,Non-CFO,0.0,0.0,227194,176,0,0,31,03,1,2021,2021-03-31,2,2021,227194,176
Agency,Federal Maritime Commission,null,Non-CFO,100.0,100.0,0,0,397140,6,31,03,1,2021,2021-03-31,2,2021,397140,6
Bureau,Department of Commerce,International Trade Administration,null,0.0,0.0,0,0,0,0,31,03,1,2021,2021-03-31,2,2021,0,0
Bureau,Department of the Interior,"Bureau of Ocean Energy Mgmt., Reg & Enf",null,0.0,0.0,0,0,0,0,31,03,1,2021,2021-03-31,2,2021,0,0
Bureau,Department of State,International Commissions,null,0.0,0.0,0,0,0,0,31,03,1,2021,2021-03-31,2,2021,0,0
Bureau,Department of Homeland Security,Management Headquarters,null,0.0,0.0,0,0,0,0,31,03,1,2021,2021-03-31,2,2021,0,0
Bureau,Department of Homeland Security,U.S. Secret Service,null,0.0,0.0,0,0,0,0,31,03,1,2021,2021-03-31,2,2021,0,0
Bureau,Department of Housing and Urban Development,Government National Mortgage Association,null,0.0,0.0,0,0,0,0,31,03,1,2021,2021-03-31,2,2021,0,0
Bureau,Other Agencies,Comm. for Purchase from Blind/Handic.,null,0.0,0.0,0,0,0,0,31,03,1,2021,2021-03-31,2,2021,0,0
Bureau,Other Agencies,National Capital Planning Commission,null,0.0,0.0,0,0,0,0,31,03,1,2021,2021-03-31,2,2021,0,0
Bureau,Department of Homeland Security,Office of Health Affairs,null,0.0,0.0,0,0,0,0,31,03,1,2021,2021-03-31,2,2021,0,0
Bureau,US International Development Fin. Corp.,US International Development Fin. Corp.,null,0.0,0.0,0,0,0,0,31,03,1,2021,2021-03-31,2,2021,0,0
Agency,Commodity Futures Trading Commission,null,Non-CFO,100.0,100.0,0,0,654411202,365,31,03,1,2021,2021-03-31,2,2021,654411202,365
Agency,Securities & Exchange Commission,null,Non-CFO,100.0,100.0,0,0,2084586787,1097,31,03,1,2021,2021-03-31,2,2021,2084586787,1097
Bureau,Legislative Branch-CBO,Congressional Budget Office,null,0.0,0.0,0,0,0,0,31,03,1,2021,2021-03-31,2,2021,0,0
Bureau,Department of Commerce,Office of the Inspector General,null,0.0,0.0,0,0,0,0,31,03,1,2021,2021-03-31,2,2021,0,0
Bureau,Department of Commerce,National Technical Information Service,null,0.0,0.0,0,0,0,0,31,03,1,2021,2021-03-31,2,2021,0,0
Bureau,Department of the Treasury,Treasury IG for Tax Admin,null,0.0,0.0,0,0,0,0,31,03,1,2021,2021-03-31,2,2021,0,0
Bureau,Department of the Treasury,U.S. Treasury IG Office,null,0.0,0.0,0,0,0,0,31,03,1,2021,2021-03-31,2,2021,0,0
Bureau,Smithsonian Institution,National Gallery of Art,null,0.0,0.0,0,0,0,0,31,03,1,2021,2021-03-31,2,2021,0,0
Bureau,Federal Deposit Insurance Corporation,Federal Deposit Insurance Corporation,null,0.0,0.0,0,0,0,0,31,03,1,2021,2021-03-31,2,2021,0,0
Bureau,Tennessee Valley Authority,Tennessee Valley Authority,null,0.0,0.0,0,0,0,0,31,03,1,2021,2021-03-31,2,2021,0,0
Bureau,Farm Credit Administration,Farm Credit System Insurance Corporation,null,0.0,0.0,0,0,0,0,31,03,1,2021,2021-03-31,2,2021,0,0
Bureau,Federal Mediation/Conciliation Service,Federal Mediation/Conciliation Service,null,0.0,0.0,0,0,0,0,31,03,1,2021,2021-03-31,2,2021,0,0
Bureau,Other Agencies,U.S. Institute of Peace,null,0.0,0.0,0,0,0,0,31,03,1,2021,2021-03-31,2,2021,0,0
Bureau,Other Agencies,Advisory Council on Hist. Preservation,null,0.0,0.0,0,0,0,0,31,03,1,2021,2021-03-31,2,2021,0,0
Bureau,Other Agencies,Defense Nuclear Facilities Safety Board,null,0.0,0.0,0,0,0,0,31,03,1,2021,2021-03-31,2,2021,0,0
Bureau,Other Agencies,Denali Commission,null,0.0,0.0,0,0,0,0,31,03,1,2021,2021-03-31,2,2021,0,0
Bureau,Other Agencies,Federal Housing Finance Agency OIG,null,0.0,0.0,0,0,0,0,31,03,1,2021,2021-03-31,2,2021,0,0
Bureau,Smithsonian Institution,Administrative Conference of the US,null,0.0,0.0,0,0,0,0,31,03,1,2021,2021-03-31,2,2021,0,0
Bureau,Legislative Branch-Office of Tech.,Medicaid & CHIP Payment & Access Comm.,null,0.0,0.0,0,0,0,0,31,03,1,2021,2021-03-31,2,2021,0,0
Bureau,Department of Health & Human Services,Office of the Inspector General,null,0.0,0.0,0,0,0,0,31,03,1,2021,2021-03-31,2,2021,0,0
Bureau,Other Agencies,Delta Regional Authority,null,0.0,0.0,0,0,0,0,31,03,1,2021,2021-03-31,2,2021,0,0
Bureau,Other Agencies,Privacy & Civil Liberties Oversight Bd,null,0.0,0.0,0,0,0,0,31,03,1,2021,2021-03-31,2,2021,0,0
Bureau,Department of the Treasury,Pandemic Receivables,null,0.0,0.0,0,0,0,0,31,03,1,2021,2021-03-31,2,2021,0,0
Agency,Department of Agriculture,null,CFO,98.96199286772324,93.58185725931965,17940151,3464,1710386220,50508,31,03,1,2021,2021-03-31,2,2021,1728326371,53972
Agency,Department of Defense,null,CFO,43.407653185524715,14.318862084506085,1368129863,1612190,1049387593,269426,31,03,1,2021,2021-03-31,2,2021,2417517456,1881616
Agency,Social Security Administration,null,CFO,59.51897971608444,34.217977036426745,1867938798,911008,2746418214,473881,31,03,1,2021,2021-03-31,2,2021,4614357012,1384889
Agency,Export - Import  Bank,null,Non-CFO,0.0,0.0,0,0,0,0,31,03,1,2021,2021-03-31,2,2021,0,0
Agency,Legislative Branch-Office of Tech.,null,Non-CFO,0.0,0.0,0,0,0,0,31,03,1,2021,2021-03-31,2,2021,0,0
Agency,Legislative Branch-CBO,null,Non-CFO,0.0,0.0,0,0,0,0,31,03,1,2021,2021-03-31,2,2021,0,0
Agency,Office of Special Counsel,null,Non-CFO,0.0,0.0,0,0,0,0,31,03,1,2021,2021-03-31,2,2021,0,0
Agency,National Foundation  Arts & Humanities,null,Non-CFO,0.0,0.0,0,0,0,0,31,03,1,2021,2021-03-31,2,2021,0,0
Agency,U.S. Postal Service,null,Non-CFO,54.36763548992871,71.10834371108344,35742657,17168,42584770,42254,31,03,1,2021,2021-03-31,2,2021,78327427,59422
Agency,Federal Communications Commission,null,Non-CFO,100.0,100.0,0,0,210610963,16657,31,03,1,2021,2021-03-31,2,2021,210610963,16657
Bureau,Office of Compliance,Office of Compliance,null,0.0,0.0,0,0,0,0,31,03,1,2021,2021-03-31,2,2021,0,0
Bureau,Legislative Branch-Office of Tech.,Open World Leadership,null,0.0,0.0,0,0,0,0,31,03,1,2021,2021-03-31,2,2021,0,0
Bureau,Department of Commerce,Economic and Statistical Analysis,null,0.0,0.0,0,0,0,0,31,03,1,2021,2021-03-31,2,2021,0,0
Bureau,Department of the Treasury,Treasury Forfeiture Fund,null,0.0,0.0,0,0,0,0,31,03,1,2021,2021-03-31,2,2021,0,0
Bureau,Other Agencies/Boards/Commissions,U.S.-China Security Review Commission,null,0.0,0.0,0,0,0,0,31,03,1,2021,2021-03-31,2,2021,0,0
Bureau,National Foundation  Arts & Humanities,National Endowment for the Humanities,null,0.0,0.0,0,0,0,0,31,03,1,2021,2021-03-31,2,2021,0,0
Bureau,Selective Service System,Selective Service System,null,0.0,0.0,0,0,0,0,31,03,1,2021,2021-03-31,2,2021,0,0
Bureau,Occupational Safety & Health Rev Comm,Occupational Safety & Health Rev Comm,null,0.0,0.0,0,0,0,0,31,03,1,2021,2021-03-31,2,2021,0,0
Bureau,Department of the Treasury,Office of Financial Research,null,0.0,0.0,0,0,0,0,31,03,1,2021,2021-03-31,2,2021,0,0
Bureau,Other Agencies,Surface Transportation Board,null,0.0,0.0,0,0,0,0,31,03,1,2021,2021-03-31,2,2021,0,0
Bureau,Department of the Treasury,Treasury Franchise Fund,null,0.0,0.0,0,0,0,0,31,03,1,2021,2021-03-31,2,2021,0,0
Bureau,Department of Health & Human Services,Administration for Community Living,null,0.0,0.0,0,0,0,0,31,03,1,2021,2021-03-31,2,2021,0,0
Agency,Department of Health & Human Services,null,CFO,97.84857045480602,96.69566048972176,208436318,38008,9479834370,1112237,31,03,1,2021,2021-03-31,2,2021,9688270688,1150245
Agency,National Credit Union Administration,null,Non-CFO,0.0,0.0,0,0,0,0,31,03,1,2021,2021-03-31,2,2021,0,0
Agency,Legislative Branch-GAO,null,Non-CFO,0.0,0.0,0,0,0,0,31,03,1,2021,2021-03-31,2,2021,0,0
Agency,Tennessee Valley Authority,null,Non-CFO,0.0,0.0,0,0,0,0,31,03,1,2021,2021-03-31,2,2021,0,0
Agency,U.S. Tax Court,null,Non-CFO,0.0,0.0,0,0,0,0,31,03,1,2021,2021-03-31,2,2021,0,0
Agency,US International Development Fin. Corp.,null,Non-CFO,0.0,0.0,0,0,0,0,31,03,1,2021,2021-03-31,2,2021,0,0
Agency,Office of Government Ethics,null,Non-CFO,0.0,0.0,0,0,0,0,31,03,1,2021,2021-03-31,2,2021,0,0
Agency,Federal Mediation/Conciliation Service,null,Non-CFO,0.0,0.0,0,0,0,0,31,03,1,2021,2021-03-31,2,2021,0,0
Agency,Occupational Safety & Health Rev Comm,null,Non-CFO,0.0,0.0,0,0,0,0,31,03,1,2021,2021-03-31,2,2021,0,0
Agency,Neighborhood Reinvestment Corporation,null,Non-CFO,0.0,0.0,0,0,0,0,31,03,1,2021,2021-03-31,2,2021,0,0
Agency,Federal Labor Relations Authority,null,Non-CFO,0.0,0.0,0,0,0,0,31,03,1,2021,2021-03-31,2,2021,0,0
Agency,Equal Employment Opportunity Commission,null,Non-CFO,100.0,100.0,0,0,37960,17,31,03,1,2021,2021-03-31,2,2021,37960,17
Bureau,Department of Labor,Departmental Management,null,0.0,0.0,0,0,0,0,31,03,1,2021,2021-03-31,2,2021,0,0
Bureau,National Credit Union Administration,National Credit Union Administration,null,0.0,0.0,0,0,0,0,31,03,1,2021,2021-03-31,2,2021,0,0
Bureau,Department of Homeland Security,Science and Technology,null,0.0,0.0,0,0,0,0,31,03,1,2021,2021-03-31,2,2021,0,0
Bureau,Other Agencies/Boards/Commissions,Medicare Payment Advisory Commission,null,0.0,0.0,0,0,0,0,31,03,1,2021,2021-03-31,2,2021,0,0
Agency,Federal Deposit Insurance Corporation,null,Non-CFO,0.0,0.0,0,0,0,0,31,03,1,2021,2021-03-31,2,2021,0,0
Agency,American Battle Monuments Commission,null,Non-CFO,0.0,0.0,0,0,0,0,31,03,1,2021,2021-03-31,2,2021,0,0
Agency,National Labor Relations Board,null,Non-CFO,0.0,0.0,0,0,0,0,31,03,1,2021,2021-03-31,2,2021,0,0
Agency,Merit Systems Protection Board,null,Non-CFO,100.0,100.0,0,0,144,1,31,03,1,2021,2021-03-31,2,2021,144,1
Agency,U.S. Court of Appeals / Veterans Claims,null,Non-CFO,100.0,100.0,0,0,172,1,31,03,1,2021,2021-03-31,2,2021,172,1
Agency,Farm Credit Administration,null,Non-CFO,100.0,100.0,0,0,630,1,31,03,1,2021,2021-03-31,2,2021,630,1
Agency,Other Agencies/Boards/Commissions,null,Non-CFO,0.0,0.0,1024,1,0,0,31,03,1,2021,2021-03-31,2,2021,1024,1
Agency,Consumer Product Safety Commission,null,Non-CFO,100.0,100.0,0,0,2500,1,31,03,1,2021,2021-03-31,2,2021,2500,1
Agency,Smithsonian Institution,null,Non-CFO,0.0,0.0,8949,2,0,0,31,03,1,2021,2021-03-31,2,2021,8949,2
Agency,Federal Election Commission,null,Non-CFO,100.0,100.0,0,0,875146,143,31,03,1,2021,2021-03-31,2,2021,875146,143
Agency,The Judiciary,null,Non-CFO,98.85901534282947,59.936908517350155,11964,127,1036604,190,31,03,1,2021,2021-03-31,2,2021,1048568,317
Agency,Funds Appropriated to the President,null,Non-CFO,0.0,0.0,1236200,6,0,0,31,03,1,2021,2021-03-31,2,2021,1236200,6
Agency,Presidio Trust Corporation,null,Non-CFO,99.27065923862581,97.33333333333333,10997,2,1496803,73,31,03,1,2021,2021-03-31,2,2021,1507800,75
Agency,Pension Benefit Guaranty Corp,null,Non-CFO,100.0,100.0,0,0,2921238,1158,31,03,1,2021,2021-03-31,2,2021,2921238,1158
Agency,Corp. for National and Community Service,null,Non-CFO,79.34021135911999,12.794612794612794,933702,1036,3585715,152,31,03,1,2021,2021-03-31,2,2021,4519417,1188
Agency,Other Agencies,null,Non-CFO,0.46050734974510027,4.132231404958677,5997564,116,27747,5,31,03,1,2021,2021-03-31,2,2021,6025311,121
Agency,Railroad Retirement Board,null,Non-CFO,100.0,100.0,0,0,22230423,4447,31,03,1,2021,2021-03-31,2,2021,22230423,4447
Bureau,Legislative Branch-GAO,Government Accountability Office,null,0.0,0.0,0,0,0,0,31,03,1,2021,2021-03-31,2,2021,0,0
Bureau,Funds Appropriated to the President,African Development Foundation,null,0.0,0.0,0,0,0,0,31,03,1,2021,2021-03-31,2,2021,0,0
Bureau,Federal Labor Relations Authority,Federal Labor Relations Authority,null,0.0,0.0,0,0,0,0,31,03,1,2021,2021-03-31,2,2021,0,0
Bureau,American Battle Monuments Commission,American Battle Monuments Commission,null,0.0,0.0,0,0,0,0,31,03,1,2021,2021-03-31,2,2021,0,0
Bureau,Other Agencies,District of Columbia Government,null,0.0,0.0,0,0,0,0,31,03,1,2021,2021-03-31,2,2021,0,0
Agency,National Science Foundation,null,CFO,100.0,100.0,0,0,541399,78,31,03,1,2021,2021-03-31,2,2021,541399,78
Agency,National Aeronautics and Space Administration,null,CFO,100.0,100.0,0,0,1250613,136,31,03,1,2021,2021-03-31,2,2021,1250613,136
Agency,Nuclear Regulatory Commission,null,CFO,99.97097605028989,99.69040247678019,762,1,2624656,322,31,03,1,2021,2021-03-31,2,2021,2625418,323
Agency,General Services Administration,null,CFO,74.02382742835351,57.63213530655391,1697453,1002,4837201,1363,31,03,1,2021,2021-03-31,2,2021,6534654,2365
Agency,Department of Veterans Affairs,null,CFO,60.03182939430151,71.32019460707512,4409265,3478,6622676,8649,31,03,1,2021,2021-03-31,2,2021,11031941,12127
Agency,Department of Energy,null,CFO,100.0,100.0,0,0,14501454,117,31,03,1,2021,2021-03-31,2,2021,14501454,117
Agency,Office of Personnel Management,null,CFO,97.0931640454129,94.07988587731812,647249,83,21619195,1319,31,03,1,2021,2021-03-31,2,2021,22266444,1402
Agency,Environmental Protection Agency,null,CFO,100.0,100.0,0,0,24323933,232,31,03,1,2021,2021-03-31,2,2021,24323933,232
Agency,Department of State,null,CFO,55.37866170695586,82.07701996107019,11961855,4696,14845622,21505,31,03,1,2021,2021-03-31,2,2021,26807477,26201
Agency,Department of Commerce,null,CFO,100.0,100.0,0,0,29360503,1935,31,03,1,2021,2021-03-31,2,2021,29360503,1935
Agency,Agency for International Development,null,CFO,100.0,100.0,0,0,33726267,43,31,03,1,2021,2021-03-31,2,2021,33726267,43
Agency,Department of the Treasury,null,CFO,98.01798381841127,99.4321304268181,912755,31,45139089,5428,31,03,1,2021,2021-03-31,2,2021,46051844,5459
Agency,Department of Transportation,null,CFO,99.89300361290007,99.83803482251317,70948,12,66237833,7397,31,03,1,2021,2021-03-31,2,2021,66308781,7409
Agency,Department of the Interior,null,CFO,99.99520193984334,99.91157429338386,3954,28,82404350,31637,31,03,1,2021,2021-03-31,2,2021,82408304,31665
Agency,Department of Justice,null,CFO,96.15779177402423,99.00613625635916,3549542,379,88833322,37755,31,03,1,2021,2021-03-31,2,2021,92382864,38134
Agency,Department of Housing and Urban Development,null,CFO,98.38293183867334,99.27154997976528,2324411,36,141417891,4906,31,03,1,2021,2021-03-31,2,2021,143742302,4942
Agency,Department of Labor,null,CFO,89.7775544162896,87.02573233286701,19827214,6121,174130424,41057,31,03,1,2021,2021-03-31,2,2021,193957638,47178
Bureau,U.S. Tax Court,U.S. Tax Court,null,0.0,0.0,0,0,0,0,31,03,1,2021,2021-03-31,2,2021,0,0
Bureau,Office of Special Counsel,Office of Special Counsel,null,0.0,0.0,0,0,0,0,31,03,1,2021,2021-03-31,2,2021,0,0
Bureau,Department of Housing and Urban Development,Community Planning and Development,null,0.0,0.0,0,0,0,0,31,03,1,2021,2021-03-31,2,2021,0,0
Bureau,Other Agencies,Chemical Safety Board,null,0.0,0.0,0,0,0,0,31,03,1,2021,2021-03-31,2,2021,0,0
Bureau,Other Agencies,Morris K. Udall Scholarship,null,0.0,0.0,0,0,0,0,31,03,1,2021,2021-03-31,2,2021,0,0
Bureau,Other Agencies,National Transportation Safety Board,null,0.0,0.0,0,0,0,0,31,03,1,2021,2021-03-31,2,2021,0,0
Bureau,Legis Branch-Library of Congress,Library of Congress,null,0.0,0.0,0,0,0,0,31,03,1,2021,2021-03-31,2,2021,0,0
Bureau,Funds Appropriated to the President,Executive Branch,null,0.0,0.0,0,0,0,0,31,03,1,2021,2021-03-31,2,2021,0,0
Bureau,Funds Appropriated to the President,Inter-American Foundation,null,0.0,0.0,0,0,0,0,31,03,1,2021,2021-03-31,2,2021,0,0
Bureau,Funds Appropriated to the President,Defense Security Assistance Agency,null,0.0,0.0,0,0,0,0,31,03,1,2021,2021-03-31,2,2021,0,0
Bureau,Funds Appropriated to the President,Peace Corps,null,0.0,0.0,0,0,0,0,31,03,1,2021,2021-03-31,2,2021,0,0
Bureau,Department of Commerce,Minority Business Development Agency,null,0.0,0.0,0,0,0,0,31,03,1,2021,2021-03-31,2,2021,0,0
Bureau,Department of Justice,General Administration,null,0.0,0.0,0,0,0,0,31,03,1,2021,2021-03-31,2,2021,0,0
Bureau,Department of the Treasury,Office of the Secretary,null,0.0,0.0,0,0,0,0,31,03,1,2021,2021-03-31,2,2021,0,0
Bureau,Department of the Treasury,Office of Sec International Affairs,null,0.0,0.0,0,0,0,0,31,03,1,2021,2021-03-31,2,2021,0,0
Bureau,Department of the Treasury,Interest on Tax/Deposit of Earnings,null,0.0,0.0,0,0,0,0,31,03,1,2021,2021-03-31,2,2021,0,0
Bureau,Smithsonian Institution,JFK Center for the Performing Arts,null,0.0,0.0,0,0,0,0,31,03,1,2021,2021-03-31,2,2021,0,0
Bureau,National Foundation  Arts & Humanities,National Endowment for the Arts,null,0.0,0.0,0,0,0,0,31,03,1,2021,2021-03-31,2,2021,0,0
Bureau,National Labor Relations Board,National Labor Relations Board,null,0.0,0.0,0,0,0,0,31,03,1,2021,2021-03-31,2,2021,0,0
Bureau,Department of Homeland Security,U.S. Coast Guard,null,0.0,0.0,0,0,0,0,31,03,1,2021,2021-03-31,2,2021,0,0
Bureau,Department of Homeland Security,Info Analysis Infrastructure Prot-NPPD,null,0.0,0.0,0,0,0,0,31,03,1,2021,2021-03-31,2,2021,0,0
Bureau,Department of Homeland Security,Federal Law Enforcement Training Ctr.,null,0.0,0.0,0,0,0,0,31,03,1,2021,2021-03-31,2,2021,0,0
Bureau,Export - Import  Bank,Export-Import Bank,null,0.0,0.0,0,0,0,0,31,03,1,2021,2021-03-31,2,2021,0,0
Bureau,Department of Education,Office of Postsecondary Education,null,0.0,0.0,0,0,0,0,31,03,1,2021,2021-03-31,2,2021,0,0
Bureau,Other Agencies,Federal Mine Safety & Health Review Comm,null,0.0,0.0,0,0,0,0,31,03,1,2021,2021-03-31,2,2021,0,0
Bureau,Other Agencies,Commission On Fine Arts,null,0.0,0.0,0,0,0,0,31,03,1,2021,2021-03-31,2,2021,0,0
Bureau,Department of Homeland Security,Office of Biometric Identity Management,null,0.0,0.0,0,0,0,0,31,03,1,2021,2021-03-31,2,2021,0,0
Bureau,Department of Transportation,Research Innovative Technology Admin,null,100.0,100.0,0,0,218,2,31,03,1,2021,2021-03-31,2,2021,218,2
Agency,Department of Homeland Security,null,CFO,99.9994441011302,99.98604131769962,1617,7,290878629,50141,31,03,1,2021,2021-03-31,2,2021,290880246,50148
Agency,Legis Branch-Library of Congress,null,Non-CFO,0.0,0.0,0,0,0,0,31,03,1,2021,2021-03-31,2,2021,0,0
Agency,Office of Compliance,null,Non-CFO,0.0,0.0,0,0,0,0,31,03,1,2021,2021-03-31,2,2021,0,0
Bureau,Department of State,Civil Monetary Penalties,null,0.0,0.0,0,0,0,0,31,03,1,2021,2021-03-31,2,2021,0,0
Bureau,Neighborhood Reinvestment Corporation,Neighborhood Reinvestment Corporation,null,0.0,0.0,0,0,0,0,31,03,1,2021,2021-03-31,2,2021,0,0
Bureau,Other Agencies,Archit.&Trans. Barriers Compliance Bd,null,0.0,0.0,0,0,0,0,31,03,1,2021,2021-03-31,2,2021,0,0
Bureau,Office of Government Ethics,Office of Government Ethics,null,0.0,0.0,0,0,0,0,31,03,1,2021,2021-03-31,2,2021,0,0
Bureau,Other Agencies,Gulf Coast Ecosystem Restoration Council,null,0.0,0.0,0,0,0,0,31,03,1,2021,2021-03-31,2,2021,0,0
Bureau,Department of the Interior,Bureau of Safety and Environmental Enf.,null,100.0,100.0,0,0,86,1,31,03,1,2021,2021-03-31,2,2021,86,1
Bureau,Department of Homeland Security,Office of the Inspector General DHS,null,100.0,100.0,0,0,100,1,31,03,1,2021,2021-03-31,2,2021,100,1
Bureau,Merit Systems Protection Board,Merit Systems Protection Board,null,100.0,100.0,0,0,144,1,31,03,1,2021,2021-03-31,2,2021,144,1
Bureau,U.S. Court of Appeals / Veterans Claims,U.S. Court of Appeals / Veterans Claims,null,100.0,100.0,0,0,172,1,31,03,1,2021,2021-03-31,2,2021,172,1
Bureau,Department of Transportation,Office of the Inspector General,null,100.0,100.0,0,0,213,1,31,03,1,2021,2021-03-31,2,2021,213,1
Bureau,Farm Credit Administration,Farm Credit Administration,null,100.0,100.0,0,0,630,1,31,03,1,2021,2021-03-31,2,2021,630,1
Bureau,Other Agencies,Millennium Challenge Corporation,null,100.0,100.0,0,0,817,1,31,03,1,2021,2021-03-31,2,2021,817,1
Bureau,Department of the Treasury,Tobacco Tax and Trade,null,100.0,100.0,0,0,1000,1,31,03,1,2021,2021-03-31,2,2021,1000,1
Bureau,Other Agencies/Boards/Commissions,U.S. Comm. on Int. Religious Freedom,null,0.0,0.0,1024,1,0,0,31,03,1,2021,2021-03-31,2,2021,1024,1
Bureau,Department of Justice,Office of Justice Assistance Programs,null,100.0,100.0,0,0,1077,2,31,03,1,2021,2021-03-31,2,2021,1077,2
Bureau,Other Agencies,Federal Housing Finance Agency,null,0.0,0.0,1239,2,0,0,31,03,1,2021,2021-03-31,2,2021,1239,2
Bureau,Other Agencies,National Council on Disability,null,0.0,0.0,1579,2,0,0,31,03,1,2021,2021-03-31,2,2021,1579,2
Bureau,Department of Homeland Security,Domestic Nuclear Detection Office,null,0.0,0.0,1617,7,0,0,31,03,1,2021,2021-03-31,2,2021,1617,7
Bureau,Other Agencies,John C. Stennis,null,0.0,0.0,2934,2,0,0,31,03,1,2021,2021-03-31,2,2021,2934,2
Bureau,Department of Housing and Urban Development,"Policy, Development and Research",null,0.0,0.0,0,0,0,0,31,03,1,2021,2021-03-31,2,2021,0,0
Bureau,Department of the Treasury,Spec Insp Gen-Troubled Asset Rel Prog,null,100.0,100.0,0,0,3916,1,31,03,1,2021,2021-03-31,2,2021,3916,1
Bureau,Department of Commerce,General Administration,null,100.0,100.0,0,0,4660,1,31,03,1,2021,2021-03-31,2,2021,4660,1
Bureau,Other Agencies,Council of Insps. Gen. of Intg. & Effy.,null,0.0,0.0,4900,8,0,0,31,03,1,2021,2021-03-31,2,2021,4900,8
Bureau,Other Agencies,U.S.  Agency of Global Media,null,100.0,100.0,0,0,4930,2,31,03,1,2021,2021-03-31,2,2021,4930,2
Bureau,Other Agencies,U.S. Inst. for Env. Conflict Resolution,null,0.0,0.0,5003,2,0,0,31,03,1,2021,2021-03-31,2,2021,5003,2
Bureau,Department of Transportation,Maritime Administration,null,100.0,100.0,0,0,5613,6,31,03,1,2021,2021-03-31,2,2021,5613,6
Bureau,Other Agencies,Election Assistance Commission,null,13.214007782101167,50.0,5576,1,849,1,31,03,1,2021,2021-03-31,2,2021,6425,2
Bureau,Department of Transportation,Federal Highway Administration,null,100.0,100.0,0,0,7317,7,31,03,1,2021,2021-03-31,2,2021,7317,7
Bureau,Department of Health & Human Services,Office of the Secretary,null,100.0,100.0,0,0,8340,7,31,03,1,2021,2021-03-31,2,2021,8340,7
Bureau,Department of Transportation,St. Lawrence Seaway Development Corp.,null,100.0,100.0,0,0,8903,2,31,03,1,2021,2021-03-31,2,2021,8903,2
Bureau,Smithsonian Institution,Smithsonian Institution,null,0.0,0.0,8949,2,0,0,31,03,1,2021,2021-03-31,2,2021,8949,2
Bureau,Department of Labor,Bureau of Labor Statistics,null,100.0,100.0,0,0,10260,1,31,03,1,2021,2021-03-31,2,2021,10260,1
Bureau,Department of Agriculture,Federal Crop Insurance Corporation,null,74.99714904778196,99.76635514018692,4385,1,13153,427,31,03,1,2021,2021-03-31,2,2021,17538,428
Bureau,Department of Transportation,National Highway Traffic Safety Admin.,null,100.0,100.0,0,0,18330,3,31,03,1,2021,2021-03-31,2,2021,18330,3
Bureau,Department of Justice,Bureau of ATF and Explosives,null,100.0,100.0,0,0,20422,4,31,03,1,2021,2021-03-31,2,2021,20422,4
Bureau,Equal Employment Opportunity Commission,Equal Employment Opportunity Commission,null,100.0,100.0,0,0,37960,17,31,03,1,2021,2021-03-31,2,2021,37960,17
Bureau,Department of the Treasury,U.S. Mint,null,97.57838137033961,93.10344827586206,1225,2,49361,27,31,03,1,2021,2021-03-31,2,2021,50586,29
Bureau,Legislative Branch-GPO,Government Publishing Office,null,100.0,100.0,0,0,75651,9,31,03,1,2021,2021-03-31,2,2021,75651,9
Bureau,Department of the Interior,Bureau of Reclamation,null,100.0,100.0,0,0,91473,72,31,03,1,2021,2021-03-31,2,2021,91473,72
Bureau,Other Agencies,Architect of the Capitol,null,0.0,0.0,108246,47,0,0,31,03,1,2021,2021-03-31,2,2021,108246,47
Bureau,Armed Forces Retirement Home,Armed Forces Retirement Home,null,71.07681713443219,86.06557377049181,32761,17,80508,105,31,03,1,2021,2021-03-31,2,2021,113269,122
Bureau,Department of Transportation,Federal Railroad Administration,null,100.0,100.0,0,0,130772,12,31,03,1,2021,2021-03-31,2,2021,130772,12
Bureau,Department of the Interior,Geological Survey,null,100.0,100.0,0,0,140258,126,31,03,1,2021,2021-03-31,2,2021,140258,126
Bureau,National Archives & Records Admin,Nat'l Archives & Records Administration,null,100.0,100.0,0,0,145306,114,31,03,1,2021,2021-03-31,2,2021,145306,114
Bureau,Other Agencies,James Madison Memorial Fellowship,null,0.0,0.0,221290,25,0,0,31,03,1,2021,2021-03-31,2,2021,221290,25
Bureau,Legislative Branch - U.S. House/Senate,U.S. House of Representatives,null,0.0,0.0,227194,176,0,0,31,03,1,2021,2021-03-31,2,2021,227194,176
Bureau,Department of the Treasury,Internal Revenue Service,null,100.0,100.0,0,0,266828,125,31,03,1,2021,2021-03-31,2,2021,266828,125
Bureau,Department of Justice,Federal Bureau of Investigation,null,100.0,100.0,0,0,278624,68,31,03,1,2021,2021-03-31,2,2021,278624,68
Bureau,Department of Commerce,Nat'l Telecomm & Information Admin.,null,100.0,100.0,0,0,296094,1,31,03,1,2021,2021-03-31,2,2021,296094,1
Bureau,Securities & Exchange Commission,Securities and Exchange Commission,null,100.0,100.0,0,0,307928,53,31,03,1,2021,2021-03-31,2,2021,307928,53
Bureau,Department of Justice,Drug Enforcement Administration,null,100.0,100.0,0,0,315669,21,31,03,1,2021,2021-03-31,2,2021,315669,21
Bureau,Department of Commerce,Bureau of the Census,null,100.0,100.0,0,0,320121,432,31,03,1,2021,2021-03-31,2,2021,320121,432
Bureau,Department of Commerce,Patent and Trademark Office,null,100.0,100.0,0,0,377709,620,31,03,1,2021,2021-03-31,2,2021,377709,620
Bureau,Department of Transportation,Pipeline Hazardous Material Safety Admin,null,100.0,100.0,0,0,390049,24,31,03,1,2021,2021-03-31,2,2021,390049,24
Bureau,Department of the Treasury,D.C. Pension Program,null,100.0,100.0,0,0,392805,21,31,03,1,2021,2021-03-31,2,2021,392805,21
Bureau,Federal Maritime Commission,Salaries and Expenses,null,100.0,100.0,0,0,397140,6,31,03,1,2021,2021-03-31,2,2021,397140,6
Bureau,Department of the Interior,Office of the Secretary,null,100.0,100.0,0,0,501985,17,31,03,1,2021,2021-03-31,2,2021,501985,17
Bureau,National Science Foundation,National Science Foundation,null,100.0,100.0,0,0,541399,78,31,03,1,2021,2021-03-31,2,2021,541399,78
Bureau,Department of Housing and Urban Development,Management and Administration,null,1.2802733616605833,63.63636363636363,622881,4,8078,7,31,03,1,2021,2021-03-31,2,2021,630959,11
Bureau,Department of Commerce,Nat'l Institute of Standards& Technology,null,100.0,100.0,0,0,686873,6,31,03,1,2021,2021-03-31,2,2021,686873,6
Bureau,Department of the Interior,Fish and Wildlife Service,null,100.0,100.0,0,0,738224,75,31,03,1,2021,2021-03-31,2,2021,738224,75
Bureau,Department of Veterans Affairs,Life Insurance,null,100.0,100.0,0,0,782222,139,31,03,1,2021,2021-03-31,2,2021,782222,139
Bureau,Department of Transportation,Federal Transit Administration,null,100.0,100.0,0,0,784632,2,31,03,1,2021,2021-03-31,2,2021,784632,2
Bureau,Department of Agriculture,Food Safety and Inspection Service,null,98.28159308690945,97.98387096774194,13586,15,777030,729,31,03,1,2021,2021-03-31,2,2021,790616,744
Bureau,Federal Election Commission,Federal Election Commission,null,100.0,100.0,0,0,875146,143,31,03,1,2021,2021-03-31,2,2021,875146,143
Bureau,Department of Justice,Federal Prison System,null,100.0,100.0,0,0,896902,132,31,03,1,2021,2021-03-31,2,2021,896902,132
Bureau,Department of Veterans Affairs,Housing Credit Assistance,null,0.0,0.0,944684,22,0,0,31,03,1,2021,2021-03-31,2,2021,944684,22
Bureau,Department of Health & Human Services,Substance Abuse & Mental Health Admin.,null,100.0,100.0,0,0,960397,14,31,03,1,2021,2021-03-31,2,2021,960397,14
Bureau,Department of Justice,Federal Prison Industries,null,100.0,100.0,0,0,1043089,183,31,03,1,2021,2021-03-31,2,2021,1043089,183
Bureau,The Judiciary,Administrative Office of the U.S. Courts,null,98.85901534282947,59.936908517350155,11964,127,1036604,190,31,03,1,2021,2021-03-31,2,2021,1048568,317
Bureau,Department of Homeland Security,Citizenship and Immigration Services,null,100.0,100.0,0,0,1058329,1257,31,03,1,2021,2021-03-31,2,2021,1058329,1257
Bureau,Department of the Treasury,Comptroller of the Currency,null,99.89131436612367,95.45454545454545,1191,1,1094630,21,31,03,1,2021,2021-03-31,2,2021,1095821,22
Bureau,Funds Appropriated to the President,Trade and Development Agency,null,0.0,0.0,1236200,6,0,0,31,03,1,2021,2021-03-31,2,2021,1236200,6
Bureau,National Aeronautics and Space Administration,National Aeronautics and Space Admin,null,100.0,100.0,0,0,1250613,136,31,03,1,2021,2021-03-31,2,2021,1250613,136
Bureau,Department of Veterans Affairs,Veterans Benefits,null,0.0,0.0,1291610,1696,0,0,31,03,1,2021,2021-03-31,2,2021,1291610,1696
Bureau,Presidio Trust Corporation,Presidio Trust Corporation,null,99.27065923862581,97.33333333333333,10997,2,1496803,73,31,03,1,2021,2021-03-31,2,2021,1507800,75
Bureau,Department of Transportation,Office of the Secretary,null,100.0,100.0,0,0,1043371,14,31,03,1,2021,2021-03-31,2,2021,1043371,14
Bureau,Department of Veterans Affairs,Administration and Cemeteries,null,0.934523656554888,1.7402945113788488,1195010,734,11273,13,31,03,1,2021,2021-03-31,2,2021,1206283,747
Bureau,Department of the Treasury,Financial Crimes Enforcement Network,null,100.0,100.0,0,0,1544945,3,31,03,1,2021,2021-03-31,2,2021,1544945,3
Bureau,Department of Energy,Bonneville Power Administration,null,100.0,100.0,0,0,1619892,26,31,03,1,2021,2021-03-31,2,2021,1619892,26
Bureau,Department of Commerce,Bureau of Industry and Security,null,100.0,100.0,0,0,1738130,23,31,03,1,2021,2021-03-31,2,2021,1738130,23
Bureau,Department of Transportation,Federal Aviation Administration,null,96.3479030347837,95.78544061302682,70739,11,1866203,250,31,03,1,2021,2021-03-31,2,2021,1936942,261
Bureau,Department of State,Passport NSF,null,100.0,100.0,0,0,2372762,15278,31,03,1,2021,2021-03-31,2,2021,2372762,15278
Bureau,Nuclear Regulatory Commission,Nuclear Regulatory Commission,null,99.97097605028989,99.69040247678019,762,1,2624656,322,31,03,1,2021,2021-03-31,2,2021,2625418,323
Bureau,Pension Benefit Guaranty Corp,Pension Benefit Guaranty Corporation,null,100.0,100.0,0,0,2921238,1158,31,03,1,2021,2021-03-31,2,2021,2921238,1158
Bureau,Department of Labor,Employment and Training Administration,null,0.0,0.0,3369967,11,0,0,31,03,1,2021,2021-03-31,2,2021,3369967,11
Bureau,Department of Housing and Urban Development,Public and Indian Housing Programs,null,51.18239350611057,22.22222222222222,1667194,7,1747955,2,31,03,1,2021,2021-03-31,2,2021,3415149,9
Bureau,Corp. for National and Community Service,Corp. for National and Community Service,null,79.34021135911999,12.794612794612794,933702,1036,3585715,152,31,03,1,2021,2021-03-31,2,2021,4519417,1188
Bureau,Department of the Treasury,Community Dev Financial Inst Fund,null,100.0,100.0,0,0,4533407,8,31,03,1,2021,2021-03-31,2,2021,4533407,8
Bureau,Department of Commerce,Economic Development Administration,null,100.0,100.0,0,0,5104978,10,31,03,1,2021,2021-03-31,2,2021,5104978,10
Bureau,Other Agencies,Consumer Financial Protection Bureau,null,0.37316856117946035,3.5714285714285716,5646797,27,21151,1,31,03,1,2021,2021-03-31,2,2021,5667948,28
Bureau,Department of Health & Human Services,Program Support Center,null,100.0,100.0,0,0,6483980,375,31,03,1,2021,2021-03-31,2,2021,6483980,375
Bureau,General Services Administration,General Services Administration,null,74.02382742835351,57.63213530655391,1697453,1002,4837201,1363,31,03,1,2021,2021-03-31,2,2021,6534654,2365
Bureau,Department of Veterans Affairs,Medical and Construction,null,85.63330983840208,89.22608421715846,977961,1026,5829181,8497,31,03,1,2021,2021-03-31,2,2021,6807142,9523
Bureau,Department of Agriculture,Food and Nutrition Service,null,0.6888789699397375,2.2388059701492535,7077557,262,49094,6,31,03,1,2021,2021-03-31,2,2021,7126651,268
Bureau,Department of the Interior,National Park Service,null,100.0,100.0,0,0,7768322,1849,31,03,1,2021,2021-03-31,2,2021,7768322,1849
Bureau,Department of the Interior,Office of Natural Resources Revenue,null,100.0,100.0,0,0,7837673,532,31,03,1,2021,2021-03-31,2,2021,7837673,532
Bureau,Department of Homeland Security,Transportation Safety Administration,null,100.0,100.0,0,0,8084084,5586,31,03,1,2021,2021-03-31,2,2021,8084084,5586
Bureau,Department of Health & Human Services,Centers for Disease Control,null,1.5811754005190477,15.454545454545455,8673714,93,139350,17,31,03,1,2021,2021-03-31,2,2021,8813064,110
Bureau,Department of Homeland Security,Bureau of Customs & Border Protection,null,100.0,100.0,0,0,9016863,575,31,03,1,2021,2021-03-31,2,2021,9016863,575
Bureau,Department of Energy,Energy Consolidated Reports,null,100.0,100.0,0,0,12881562,91,31,03,1,2021,2021-03-31,2,2021,12881562,91
Bureau,Department of Homeland Security,Immigration and Customs Enforcement,null,100.0,100.0,0,0,13572458,561,31,03,1,2021,2021-03-31,2,2021,13572458,561
Bureau,Department of the Treasury,Bureau of the Fiscal Service,null,100.0,100.0,0,0,13835216,3861,31,03,1,2021,2021-03-31,2,2021,13835216,3861
Bureau,Department of the Interior,Bureau of Land Management,null,100.0,100.0,0,0,15972935,340,31,03,1,2021,2021-03-31,2,2021,15972935,340
Bureau,Department of Health & Human Services,National Institutes of Health,null,35.828919108710856,22.26980728051392,10880835,363,6075144,104,31,03,1,2021,2021-03-31,2,2021,16955979,467
Bureau,Department of Labor,Employee Benefit Security Administration,null,100.0,100.0,0,0,17200332,397,31,03,1,2021,2021-03-31,2,2021,17200332,397
Bureau,Department of Commerce,NOAA,null,100.0,100.0,0,0,20831938,842,31,03,1,2021,2021-03-31,2,2021,20831938,842
Bureau,Department of Agriculture,U.S. Department of Agriculture,null,81.1031781374769,56.182707993474715,4176784,1343,17926319,1722,31,03,1,2021,2021-03-31,2,2021,22103103,3065
Bureau,Railroad Retirement Board,Railroad Retirement Board,null,100.0,100.0,0,0,22230423,4447,31,03,1,2021,2021-03-31,2,2021,22230423,4447
Bureau,Office of Personnel Management,Office of Personnel Management,null,97.0931640454129,94.07988587731812,647249,83,21619195,1319,31,03,1,2021,2021-03-31,2,2021,22266444,1402
Bureau,Department of the Treasury,Departmental Offices,null,96.2449085897367,97.98125450612834,910339,28,23332453,1359,31,03,1,2021,2021-03-31,2,2021,24242792,1387
Bureau,Securities & Exchange Commission,SEC Enforcement,null,100.0,100.0,0,0,2084278859,1044,31,03,1,2021,2021-03-31,2,2021,2084278859,1044
Bureau,Department of Defense,Consolidated Report,null,43.407653185524715,14.318862084506085,1368129863,1612190,1049387593,269426,31,03,1,2021,2021-03-31,2,2021,2417517456,1881616
Bureau,Department of Labor,Mine Safety and Health Administration,null,92.98891773592885,94.82825164029332,1702978,670,22586824,12285,31,03,1,2021,2021-03-31,2,2021,24289802,12955
Bureau,Environmental Protection Agency,Environmental Protection Agency,null,100.0,100.0,0,0,24323933,232,31,03,1,2021,2021-03-31,2,2021,24323933,232
Bureau,Department of State,Department of State,null,51.045653693935044,57.008147944703836,11961855,4696,12472860,6227,31,03,1,2021,2021-03-31,2,2021,24434715,10923
Bureau,Department of Health & Human Services,Administration for Children and Families,null,100.0,100.0,0,0,29457648,1746,31,03,1,2021,2021-03-31,2,2021,29457648,1746
Bureau,Agency for International Development,Agency for International Development,null,100.0,100.0,0,0,33726267,43,31,03,1,2021,2021-03-31,2,2021,33726267,43
Bureau,Department of the Interior,Bureau of Indian Affairs,null,99.99098195062734,99.90107754813637,3954,28,43841448,28277,31,03,1,2021,2021-03-31,2,2021,43845402,28305
Bureau,Department of Health & Human Services,Indian Health Services,null,53.46222584558947,6.5083281924737815,26191060,3031,30088082,211,31,03,1,2021,2021-03-31,2,2021,56279142,3242
Bureau,Department of Labor,Occupational Safety and Health Admin,null,98.83872963537321,73.97868561278864,663694,1465,56488716,4165,31,03,1,2021,2021-03-31,2,2021,57152410,5630
Bureau,Department of Agriculture,Farm Service Agency,null,100.0,100.0,0,0,792839891,14332,31,03,1,2021,2021-03-31,2,2021,792839891,14332
Bureau,Social Security Administration,Social Security Administration,null,59.51897971608444,34.217977036426745,1867938798,911008,2746418214,473881,31,03,1,2021,2021-03-31,2,2021,4614357012,1384889
Bureau,Department of Health & Human Services,Centers for Medicare & Medicaid Services,null,98.9336503334808,97.72104295798746,100006975,25840,9278434088,1108012,31,03,1,2021,2021-03-31,2,2021,9378441063,1133852
Bureau,Department of Transportation,Federal Motor Carrier Safety Admin,null,99.9996628076209,99.98586572438163,209,1,61982212,7074,31,03,1,2021,2021-03-31,2,2021,61982421,7075
Bureau,Department of Agriculture,Forest Service,null,90.91571884734809,28.19047619047619,6207218,754,62121997,296,31,03,1,2021,2021-03-31,2,2021,68329215,1050
Bureau,U.S. Postal Service,U.S. Postal Service,null,54.36763548992871,71.10834371108344,35742657,17168,42584770,42254,31,03,1,2021,2021-03-31,2,2021,78327427,59422
Bureau,Department of Justice,Legal Activities,null,96.05303503406161,99.00320776225445,3545275,376,86277539,37345,31,03,1,2021,2021-03-31,2,2021,89822814,37721
Bureau,Department of Labor,Employment Standards Administration,null,84.67330680970039,85.89625319330116,14090575,3975,77844292,24209,31,03,1,2021,2021-03-31,2,2021,91934867,28184
Bureau,Department of Health & Human Services,Food and Drug Administration,null,33.943369529676566,11.652757989008752,62683734,8681,32210198,1145,31,03,1,2021,2021-03-31,2,2021,94893932,9826
Bureau,Department of Health & Human Services,Health Resources and Services Admin,null,100.0,100.0,0,0,95977143,606,31,03,1,2021,2021-03-31,2,2021,95977143,606
Bureau,Department of Agriculture,Commodity Credit Corporation,null,100.0,100.0,0,0,132506927,10934,31,03,1,2021,2021-03-31,2,2021,132506927,10934
Bureau,Department of Housing and Urban Development,Housing Programs,null,99.97542094811831,99.49207639171068,34336,25,139661858,4897,31,03,1,2021,2021-03-31,2,2021,139696194,4922
Bureau,Federal Communications Commission,Federal Communications Commission,null,100.0,100.0,0,0,210610963,16657,31,03,1,2021,2021-03-31,2,2021,210610963,16657
Bureau,Department of Homeland Security,Emergency Preparedness & Resp,null,100.0,100.0,0,0,259146795,42161,31,03,1,2021,2021-03-31,2,2021,259146795,42161
Bureau,Federal Trade Commission,Federal Trade Commission,null,100.0,100.0,0,0,483058157,55,31,03,1,2021,2021-03-31,2,2021,483058157,55
Bureau,Commodity Futures Trading Commission,Commodity Futures Trading Commission,null,100.0,100.0,0,0,654411202,365,31,03,1,2021,2021-03-31,2,2021,654411202,365
Bureau,Department of Agriculture,Rural Development,null,99.99874035903314,99.9767571587951,8809,5,699317446,21507,31,03,1,2021,2021-03-31,2,2021,699326255,21512
Bureau,Tennessee Valley Authority,Tennessee Valley Authority,null,0.0,0.0,0,0,0,0,30,06,2,2021,2021-06-30,3,2021,0,0
Bureau,Department of Transportation,Research Innovative Technology Admin,null,0.0,0.0,0,0,0,0,30,06,2,2021,2021-06-30,3,2021,0,0
Bureau,Other Agencies,National Transportation Safety Board,null,0.0,0.0,0,0,0,0,30,06,2,2021,2021-06-30,3,2021,0,0
Bureau,Department of Agriculture,Rural Development,null,99.99913765157602,99.964853703541,6153,8,713510545,22754,30,06,2,2021,2021-06-30,3,2021,713516698,22762
Agency,Funds Appropriated to the President,null,Non-CFO,0.0,0.0,1236200,7,0,0,30,06,2,2021,2021-06-30,3,2021,1236200,7
Bureau,Department of Health & Human Services,Office of the Inspector General,null,0.0,0.0,0,0,0,0,30,06,2,2021,2021-06-30,3,2021,0,0
Bureau,Department of Health & Human Services,Health Resources and Services Admin,null,100.0,100.0,0,0,98926442,621,30,06,2,2021,2021-06-30,3,2021,98926442,621
Bureau,Department of Agriculture,Commodity Credit Corporation,null,100.0,100.0,0,0,138035294,10832,30,06,2,2021,2021-06-30,3,2021,138035294,10832
Bureau,Department of Housing and Urban Development,Housing Programs,null,100.0,100.0,0,0,139935091,4797,30,06,2,2021,2021-06-30,3,2021,139935091,4797
Bureau,Federal Communications Commission,Federal Communications Commission,null,100.0,100.0,0,0,211982293,3721,30,06,2,2021,2021-06-30,3,2021,211982293,3721
Bureau,Department of Homeland Security,Emergency Preparedness & Resp,null,100.0,100.0,0,0,251239364,41146,30,06,2,2021,2021-06-30,3,2021,251239364,41146
Bureau,Department of Agriculture,Farm Service Agency,null,100.0,100.0,0,0,624134663,13870,30,06,2,2021,2021-06-30,3,2021,624134663,13870
Bureau,Commodity Futures Trading Commission,Commodity Futures Trading Commission,null,100.0,100.0,0,0,656882406,365,30,06,2,2021,2021-06-30,3,2021,656882406,365
Agency,General Services Administration,null,CFO,62.31889489398436,57.40272865083375,2664443,843,4406589,1136,30,06,2,2021,2021-06-30,3,2021,7071032,1979
Agency,Department of Energy,null,CFO,100.0,100.0,0,0,14516619,99,30,06,2,2021,2021-06-30,3,2021,14516619,99
Agency,Corp. for National and Community Service,null,Non-CFO,79.76368044863497,13.013698630136986,909129,1016,3583432,152,30,06,2,2021,2021-06-30,3,2021,4492561,1168
Bureau,Department of State,International Commissions,null,0.0,0.0,0,0,0,0,30,06,2,2021,2021-06-30,3,2021,0,0
Bureau,Selective Service System,Selective Service System,null,0.0,0.0,0,0,0,0,30,06,2,2021,2021-06-30,3,2021,0,0
Bureau,Department of Housing and Urban Development,Government National Mortgage Association,null,0.0,0.0,0,0,0,0,30,06,2,2021,2021-06-30,3,2021,0,0
Bureau,Department of Housing and Urban Development,"Policy, Development and Research",null,0.0,0.0,0,0,0,0,30,06,2,2021,2021-06-30,3,2021,0,0
Bureau,Other Agencies,Archit.&Trans. Barriers Compliance Bd,null,0.0,0.0,0,0,0,0,30,06,2,2021,2021-06-30,3,2021,0,0
Bureau,Other Agencies,Gulf Coast Ecosystem Restoration Council,null,0.0,0.0,0,0,0,0,30,06,2,2021,2021-06-30,3,2021,0,0
Bureau,Department of Homeland Security,Office of Health Affairs,null,0.0,0.0,0,0,0,0,30,06,2,2021,2021-06-30,3,2021,0,0
Bureau,Other Agencies,Defense Nuclear Facilities Safety Board,null,0.0,0.0,0,0,0,0,30,06,2,2021,2021-06-30,3,2021,0,0
Bureau,Other Agencies,Surface Transportation Board,null,0.0,0.0,0,0,0,0,30,06,2,2021,2021-06-30,3,2021,0,0
Agency,Legislative Branch-GAO,null,Non-CFO,0.0,0.0,0,0,0,0,30,06,2,2021,2021-06-30,3,2021,0,0
Agency,Other Agencies/Boards/Commissions,null,Non-CFO,0.0,0.0,1024,1,0,0,30,06,2,2021,2021-06-30,3,2021,1024,1
Agency,U.S. Postal Service,null,Non-CFO,55.017633969763736,81.93730356998952,34661531,11207,42394289,50838,30,06,2,2021,2021-06-30,3,2021,77055820,62045
Bureau,Other Agencies,Federal Housing Finance Agency OIG,null,0.0,0.0,0,0,0,0,30,06,2,2021,2021-06-30,3,2021,0,0
Agency,Office of Personnel Management,null,CFO,93.05589906407761,90.96551724137932,1613287,131,21619195,1319,30,06,2,2021,2021-06-30,3,2021,23232482,1450
Agency,Department of the Treasury,null,CFO,98.12422994958858,99.43711180124224,832151,29,43531016,5123,30,06,2,2021,2021-06-30,3,2021,44363167,5152
Agency,Federal Maritime Commission,null,Non-CFO,100.0,100.0,0,0,397266,6,30,06,2,2021,2021-06-30,3,2021,397266,6
Agency,Securities & Exchange Commission,null,Non-CFO,100.0,100.0,0,0,2105935184,1107,30,06,2,2021,2021-06-30,3,2021,2105935184,1107
Bureau,Export - Import  Bank,Export-Import Bank,null,0.0,0.0,0,0,0,0,30,06,2,2021,2021-06-30,3,2021,0,0
Bureau,Office of Special Counsel,Office of Special Counsel,null,0.0,0.0,0,0,0,0,30,06,2,2021,2021-06-30,3,2021,0,0
Agency,Department of Commerce,null,CFO,100.0,100.0,0,0,61849348,1900,30,06,2,2021,2021-06-30,3,2021,61849348,1900
Bureau,Department of Justice,General Administration,null,0.0,0.0,0,0,0,0,30,06,2,2021,2021-06-30,3,2021,0,0
Bureau,Legislative Branch-Office of Tech.,Open World Leadership,null,0.0,0.0,0,0,0,0,30,06,2,2021,2021-06-30,3,2021,0,0
Bureau,Department of Justice,U.S. Marshals Service,null,0.0,0.0,0,0,0,0,30,06,2,2021,2021-06-30,3,2021,0,0
Agency,National Science Foundation,null,CFO,100.0,100.0,0,0,533678,78,30,06,2,2021,2021-06-30,3,2021,533678,78
Agency,Pension Benefit Guaranty Corp,null,Non-CFO,100.0,100.0,0,0,3366092,1141,30,06,2,2021,2021-06-30,3,2021,3366092,1141
Bureau,Federal Deposit Insurance Corporation,Federal Deposit Insurance Corporation,null,0.0,0.0,0,0,0,0,30,06,2,2021,2021-06-30,3,2021,0,0
Bureau,Department of Homeland Security,Info Analysis Infrastructure Prot-NPPD,null,0.0,0.0,0,0,0,0,30,06,2,2021,2021-06-30,3,2021,0,0
Bureau,Federal Mediation/Conciliation Service,Federal Mediation/Conciliation Service,null,0.0,0.0,0,0,0,0,30,06,2,2021,2021-06-30,3,2021,0,0
Bureau,Other Agencies,Delta Regional Authority,null,0.0,0.0,0,0,0,0,30,06,2,2021,2021-06-30,3,2021,0,0
Agency,Environmental Protection Agency,null,CFO,100.0,100.0,0,0,24643592,236,30,06,2,2021,2021-06-30,3,2021,24643592,236
Agency,Legislative Branch-Office of Tech.,null,Non-CFO,0.0,0.0,0,0,0,0,30,06,2,2021,2021-06-30,3,2021,0,0
Agency,Federal Deposit Insurance Corporation,null,Non-CFO,0.0,0.0,0,0,0,0,30,06,2,2021,2021-06-30,3,2021,0,0
Agency,Legislative Branch-CBO,null,Non-CFO,0.0,0.0,0,0,0,0,30,06,2,2021,2021-06-30,3,2021,0,0
Agency,Legis Branch-Library of Congress,null,Non-CFO,0.0,0.0,0,0,0,0,30,06,2,2021,2021-06-30,3,2021,0,0
Agency,Office of Special Counsel,null,Non-CFO,0.0,0.0,0,0,0,0,30,06,2,2021,2021-06-30,3,2021,0,0
Agency,U.S. Tax Court,null,Non-CFO,0.0,0.0,0,0,0,0,30,06,2,2021,2021-06-30,3,2021,0,0
Agency,National Foundation  Arts & Humanities,null,Non-CFO,0.0,0.0,0,0,0,0,30,06,2,2021,2021-06-30,3,2021,0,0
Agency,Legislative Branch - U.S. House/Senate,null,Non-CFO,0.0,0.0,242304,167,0,0,30,06,2,2021,2021-06-30,3,2021,242304,167
Agency,Agency for International Development,null,CFO,100.0,100.0,0,0,37221816,59,30,06,2,2021,2021-06-30,3,2021,37221816,59
Bureau,Department of the Treasury,Interest on Tax/Deposit of Earnings,null,0.0,0.0,0,0,0,0,30,06,2,2021,2021-06-30,3,2021,0,0
Bureau,Department of the Treasury,Treasury Forfeiture Fund,null,0.0,0.0,0,0,0,0,30,06,2,2021,2021-06-30,3,2021,0,0
Agency,National Aeronautics and Space Administration,null,CFO,100.0,100.0,0,0,1215551,120,30,06,2,2021,2021-06-30,3,2021,1215551,120
Agency,Department of State,null,CFO,98.26533048941306,99.71367215461704,354930,64,20106028,22288,30,06,2,2021,2021-06-30,3,2021,20460958,22352
Agency,Department of Transportation,null,CFO,99.89076148093137,99.75550122249389,72370,18,66177155,7344,30,06,2,2021,2021-06-30,3,2021,66249525,7362
Agency,Social Security Administration,null,CFO,62.517167082104564,36.24122581091574,1633891460,829304,2725147953,471386,30,06,2,2021,2021-06-30,3,2021,4359039413,1300690
Agency,Department of Health & Human Services,null,CFO,98.15640568931113,97.72184179217479,177463027,26961,9448463131,1156495,30,06,2,2021,2021-06-30,3,2021,9625926158,1183456
Agency,Small Business Administration,null,CFO,100.0,100.0,0,0,12431248241,119029,30,06,2,2021,2021-06-30,3,2021,12431248241,119029
Agency,Export - Import  Bank,null,Non-CFO,0.0,0.0,0,0,0,0,30,06,2,2021,2021-06-30,3,2021,0,0
Agency,Federal Mediation/Conciliation Service,null,Non-CFO,0.0,0.0,0,0,0,0,30,06,2,2021,2021-06-30,3,2021,0,0
Agency,Occupational Safety & Health Rev Comm,null,Non-CFO,0.0,0.0,0,0,0,0,30,06,2,2021,2021-06-30,3,2021,0,0
Agency,Selective Service System,null,Non-CFO,0.0,0.0,0,0,0,0,30,06,2,2021,2021-06-30,3,2021,0,0
Agency,Neighborhood Reinvestment Corporation,null,Non-CFO,0.0,0.0,0,0,0,0,30,06,2,2021,2021-06-30,3,2021,0,0
Agency,Federal Labor Relations Authority,null,Non-CFO,0.0,0.0,0,0,0,0,30,06,2,2021,2021-06-30,3,2021,0,0
Agency,U.S. Court of Appeals / Veterans Claims,null,Non-CFO,100.0,100.0,0,0,173,1,30,06,2,2021,2021-06-30,3,2021,173,1
Agency,Farm Credit Administration,null,Non-CFO,100.0,100.0,0,0,630,1,30,06,2,2021,2021-06-30,3,2021,630,1
Agency,Railroad Retirement Board,null,Non-CFO,100.0,99.97626957759849,0,1,21725439,4213,30,06,2,2021,2021-06-30,3,2021,21725439,4214
Bureau,Legislative Branch-GAO,Government Accountability Office,null,0.0,0.0,0,0,0,0,30,06,2,2021,2021-06-30,3,2021,0,0
Bureau,National Labor Relations Board,National Labor Relations Board,null,0.0,0.0,0,0,0,0,30,06,2,2021,2021-06-30,3,2021,0,0
Bureau,Other Agencies,National Capital Planning Commission,null,0.0,0.0,0,0,0,0,30,06,2,2021,2021-06-30,3,2021,0,0
Agency,Presidio Trust Corporation,null,Non-CFO,0.0,0.0,1496012,71,0,0,30,06,2,2021,2021-06-30,3,2021,1496012,71
Bureau,U.S. Tax Court,U.S. Tax Court,null,0.0,0.0,0,0,0,0,30,06,2,2021,2021-06-30,3,2021,0,0
Bureau,Legis Branch-Library of Congress,Library of Congress,null,0.0,0.0,0,0,0,0,30,06,2,2021,2021-06-30,3,2021,0,0
Bureau,Legislative Branch-CBO,Congressional Budget Office,null,0.0,0.0,0,0,0,0,30,06,2,2021,2021-06-30,3,2021,0,0
Bureau,Funds Appropriated to the President,Executive Branch,null,0.0,0.0,0,0,0,0,30,06,2,2021,2021-06-30,3,2021,0,0
Bureau,Department of State,Civil Monetary Penalties,null,0.0,0.0,0,0,0,0,30,06,2,2021,2021-06-30,3,2021,0,0
Bureau,Smithsonian Institution,JFK Center for the Performing Arts,null,0.0,0.0,0,0,0,0,30,06,2,2021,2021-06-30,3,2021,0,0
Bureau,Department of Homeland Security,Science and Technology,null,0.0,0.0,0,0,0,0,30,06,2,2021,2021-06-30,3,2021,0,0
Bureau,Neighborhood Reinvestment Corporation,Neighborhood Reinvestment Corporation,null,0.0,0.0,0,0,0,0,30,06,2,2021,2021-06-30,3,2021,0,0
Bureau,Legislative Branch-Office of Tech.,Medicaid & CHIP Payment & Access Comm.,null,0.0,0.0,0,0,0,0,30,06,2,2021,2021-06-30,3,2021,0,0
Bureau,Department of the Treasury,Treasury Franchise Fund,null,0.0,0.0,0,0,0,0,30,06,2,2021,2021-06-30,3,2021,0,0
Agency,Department of the Interior,null,CFO,99.99988629168263,99.98349126688018,91,5,80029235,30282,30,06,2,2021,2021-06-30,3,2021,80029326,30287
Agency,Department of Justice,null,CFO,95.2783302005771,98.83836274407435,4428662,445,89365741,37863,30,06,2,2021,2021-06-30,3,2021,93794403,38308
Agency,Department of Housing and Urban Development,null,CFO,99.27247765650671,99.87533762725951,1039132,6,141792495,4807,30,06,2,2021,2021-06-30,3,2021,142831627,4813
Agency,Department of Labor,null,CFO,86.23013052473146,74.06754519852957,27294021,12063,170921518,34454,30,06,2,2021,2021-06-30,3,2021,198215539,46517
Agency,Department of Homeland Security,null,CFO,99.99152711356977,99.9744081893794,31024,16,366125188,62504,30,06,2,2021,2021-06-30,3,2021,366156212,62520
Agency,Department of Agriculture,null,CFO,98.84540153751642,93.50496722184475,18235815,3537,1561171710,50920,30,06,2,2021,2021-06-30,3,2021,1579407525,54457
Agency,Department of Defense,null,CFO,95.28056570996883,95.43882030386466,112694888,78157,2275194869,1635369,30,06,2,2021,2021-06-30,3,2021,2387889757,1713526
Agency,Department of Education,null,CFO,99.95063202763082,99.9985683935158,65758540,328,133135053331,22910996,30,06,2,2021,2021-06-30,3,2021,133200811871,22911324
Agency,Tennessee Valley Authority,null,Non-CFO,0.0,0.0,0,0,0,0,30,06,2,2021,2021-06-30,3,2021,0,0
Agency,National Labor Relations Board,null,Non-CFO,0.0,0.0,0,0,0,0,30,06,2,2021,2021-06-30,3,2021,0,0
Agency,Other Agencies,null,Non-CFO,3.846236342343347,4.2105263157894735,672435,91,26898,4,30,06,2,2021,2021-06-30,3,2021,699333,95
Agency,Federal Communications Commission,null,Non-CFO,100.0,100.0,0,0,211982293,3721,30,06,2,2021,2021-06-30,3,2021,211982293,3721
Agency,Federal Trade Commission,null,Non-CFO,100.0,100.0,0,0,483052147,55,30,06,2,2021,2021-06-30,3,2021,483052147,55
Agency,Commodity Futures Trading Commission,null,Non-CFO,100.0,100.0,0,0,656882406,365,30,06,2,2021,2021-06-30,3,2021,656882406,365
Bureau,Department of Labor,Departmental Management,null,0.0,0.0,0,0,0,0,30,06,2,2021,2021-06-30,3,2021,0,0
Bureau,American Battle Monuments Commission,American Battle Monuments Commission,null,0.0,0.0,0,0,0,0,30,06,2,2021,2021-06-30,3,2021,0,0
Bureau,Other Agencies,U.S. Holocaust Memorial Council,null,0.0,0.0,0,0,0,0,30,06,2,2021,2021-06-30,3,2021,0,0
Agency,Merit Systems Protection Board,null,Non-CFO,100.0,100.0,0,0,144,1,30,06,2,2021,2021-06-30,3,2021,144,1
Agency,National Credit Union Administration,null,Non-CFO,0.0,0.0,1319,5,0,0,30,06,2,2021,2021-06-30,3,2021,1319,5
Agency,Consumer Product Safety Commission,null,Non-CFO,100.0,100.0,0,0,2500,1,30,06,2,2021,2021-06-30,3,2021,2500,1
Agency,Smithsonian Institution,null,Non-CFO,0.0,0.0,7350,1,0,0,30,06,2,2021,2021-06-30,3,2021,7350,1
Agency,Equal Employment Opportunity Commission,null,Non-CFO,100.0,100.0,0,0,27704,15,30,06,2,2021,2021-06-30,3,2021,27704,15
Agency,Armed Forces Retirement Home,null,Non-CFO,70.72962881616516,84.55284552845528,33317,19,80508,104,30,06,2,2021,2021-06-30,3,2021,113825,123
Agency,Federal Election Commission,null,Non-CFO,100.0,100.0,0,0,903738,145,30,06,2,2021,2021-06-30,3,2021,903738,145
Agency,The Judiciary,null,Non-CFO,98.8848657691537,59.81012658227848,11965,127,1061000,189,30,06,2,2021,2021-06-30,3,2021,1072965,316
Bureau,Department of Commerce,Minority Business Development Agency,null,0.0,0.0,0,0,0,0,30,06,2,2021,2021-06-30,3,2021,0,0
Bureau,Department of the Treasury,Office of the Secretary,null,0.0,0.0,0,0,0,0,30,06,2,2021,2021-06-30,3,2021,0,0
Bureau,Department of Health & Human Services,Administration for Community Living,null,0.0,0.0,0,0,0,0,30,06,2,2021,2021-06-30,3,2021,0,0
Bureau,Occupational Safety & Health Rev Comm,Occupational Safety & Health Rev Comm,null,0.0,0.0,0,0,0,0,30,06,2,2021,2021-06-30,3,2021,0,0
Bureau,Other Agencies,Chemical Safety Board,null,0.0,0.0,0,0,0,0,30,06,2,2021,2021-06-30,3,2021,0,0
Bureau,Department of the Treasury,Office of Financial Research,null,0.0,0.0,0,0,0,0,30,06,2,2021,2021-06-30,3,2021,0,0
Agency,Office of Compliance,null,Non-CFO,0.0,0.0,0,0,0,0,30,06,2,2021,2021-06-30,3,2021,0,0
Bureau,Funds Appropriated to the President,Inter-American Foundation,null,0.0,0.0,0,0,0,0,30,06,2,2021,2021-06-30,3,2021,0,0
Bureau,Funds Appropriated to the President,Peace Corps,null,0.0,0.0,0,0,0,0,30,06,2,2021,2021-06-30,3,2021,0,0
Bureau,Department of Commerce,International Trade Administration,null,0.0,0.0,0,0,0,0,30,06,2,2021,2021-06-30,3,2021,0,0
Bureau,Department of Commerce,National Technical Information Service,null,0.0,0.0,0,0,0,0,30,06,2,2021,2021-06-30,3,2021,0,0
Bureau,Department of Education,Office of Postsecondary Education,null,0.0,0.0,0,0,0,0,30,06,2,2021,2021-06-30,3,2021,0,0
Bureau,Other Agencies,District of Columbia Government,null,0.0,0.0,0,0,0,0,30,06,2,2021,2021-06-30,3,2021,0,0
Bureau,Other Agencies,Comm. for Purchase from Blind/Handic.,null,0.0,0.0,0,0,0,0,30,06,2,2021,2021-06-30,3,2021,0,0
Bureau,Other Agencies,National Mediation Board,null,0.0,0.0,0,0,0,0,30,06,2,2021,2021-06-30,3,2021,0,0
Agency,Nuclear Regulatory Commission,null,CFO,100.0,100.0,0,0,2609778,323,30,06,2,2021,2021-06-30,3,2021,2609778,323
Bureau,Office of Compliance,Office of Compliance,null,0.0,0.0,0,0,0,0,30,06,2,2021,2021-06-30,3,2021,0,0
Bureau,Funds Appropriated to the President,Defense Security Assistance Agency,null,0.0,0.0,0,0,0,0,30,06,2,2021,2021-06-30,3,2021,0,0
Bureau,Department of the Treasury,U.S. Treasury IG Office,null,0.0,0.0,0,0,0,0,30,06,2,2021,2021-06-30,3,2021,0,0
Bureau,Department of Homeland Security,Management Headquarters,null,0.0,0.0,0,0,0,0,30,06,2,2021,2021-06-30,3,2021,0,0
Bureau,Department of Homeland Security,Office of Biometric Identity Management,null,0.0,0.0,0,0,0,0,30,06,2,2021,2021-06-30,3,2021,0,0
Agency,American Battle Monuments Commission,null,Non-CFO,0.0,0.0,0,0,0,0,30,06,2,2021,2021-06-30,3,2021,0,0
Agency,US International Development Fin. Corp.,null,Non-CFO,0.0,0.0,0,0,0,0,30,06,2,2021,2021-06-30,3,2021,0,0
Agency,Office of Government Ethics,null,Non-CFO,0.0,0.0,0,0,0,0,30,06,2,2021,2021-06-30,3,2021,0,0
Agency,National Archives & Records Admin,null,Non-CFO,100.0,100.0,0,0,130359,107,30,06,2,2021,2021-06-30,3,2021,130359,107
Agency,Legislative Branch-GPO,null,Non-CFO,53.128687004887915,15.517241379310345,66741,49,75651,9,30,06,2,2021,2021-06-30,3,2021,142392,58
Bureau,Funds Appropriated to the President,African Development Foundation,null,0.0,0.0,0,0,0,0,30,06,2,2021,2021-06-30,3,2021,0,0
Bureau,Department of Commerce,Office of the Inspector General,null,0.0,0.0,0,0,0,0,30,06,2,2021,2021-06-30,3,2021,0,0
Bureau,Department of the Interior,"Bureau of Ocean Energy Mgmt., Reg & Enf",null,0.0,0.0,0,0,0,0,30,06,2,2021,2021-06-30,3,2021,0,0
Bureau,Department of the Treasury,Office of Sec International Affairs,null,0.0,0.0,0,0,0,0,30,06,2,2021,2021-06-30,3,2021,0,0
Bureau,Department of the Treasury,Treasury IG for Tax Admin,null,0.0,0.0,0,0,0,0,30,06,2,2021,2021-06-30,3,2021,0,0
Bureau,Other Agencies/Boards/Commissions,U.S.-China Security Review Commission,null,0.0,0.0,0,0,0,0,30,06,2,2021,2021-06-30,3,2021,0,0
Bureau,Federal Labor Relations Authority,Federal Labor Relations Authority,null,0.0,0.0,0,0,0,0,30,06,2,2021,2021-06-30,3,2021,0,0
Bureau,National Foundation  Arts & Humanities,National Endowment for the Humanities,null,0.0,0.0,0,0,0,0,30,06,2,2021,2021-06-30,3,2021,0,0
Bureau,Farm Credit Administration,Farm Credit System Insurance Corporation,null,0.0,0.0,0,0,0,0,30,06,2,2021,2021-06-30,3,2021,0,0
Bureau,Other Agencies,Federal Mine Safety & Health Review Comm,null,0.0,0.0,0,0,0,0,30,06,2,2021,2021-06-30,3,2021,0,0
Bureau,Other Agencies,U.S. Institute of Peace,null,0.0,0.0,0,0,0,0,30,06,2,2021,2021-06-30,3,2021,0,0
Bureau,Other Agencies,Advisory Council on Hist. Preservation,null,0.0,0.0,0,0,0,0,30,06,2,2021,2021-06-30,3,2021,0,0
Bureau,Other Agencies,Commission On Fine Arts,null,0.0,0.0,0,0,0,0,30,06,2,2021,2021-06-30,3,2021,0,0
Bureau,Other Agencies,Denali Commission,null,0.0,0.0,0,0,0,0,30,06,2,2021,2021-06-30,3,2021,0,0
Bureau,Department of the Treasury,International Monetary Funds,null,0.0,0.0,0,0,0,0,30,06,2,2021,2021-06-30,3,2021,0,0
Bureau,Smithsonian Institution,Administrative Conference of the US,null,0.0,0.0,0,0,0,0,30,06,2,2021,2021-06-30,3,2021,0,0
Bureau,US International Development Fin. Corp.,US International Development Fin. Corp.,null,0.0,0.0,0,0,0,0,30,06,2,2021,2021-06-30,3,2021,0,0
Bureau,Other Agencies,Privacy & Civil Liberties Oversight Bd,null,0.0,0.0,0,0,0,0,30,06,2,2021,2021-06-30,3,2021,0,0
Bureau,Smithsonian Institution,National Gallery of Art,null,0.0,0.0,0,0,0,0,30,06,2,2021,2021-06-30,3,2021,0,0
Bureau,National Foundation  Arts & Humanities,National Endowment for the Arts,null,0.0,0.0,0,0,0,0,30,06,2,2021,2021-06-30,3,2021,0,0
Bureau,Department of Homeland Security,U.S. Secret Service,null,0.0,0.0,0,0,0,0,30,06,2,2021,2021-06-30,3,2021,0,0
Bureau,Office of Government Ethics,Office of Government Ethics,null,0.0,0.0,0,0,0,0,30,06,2,2021,2021-06-30,3,2021,0,0
Bureau,Department of the Interior,Bureau of Safety and Environmental Enf.,null,0.0,0.0,0,0,0,0,30,06,2,2021,2021-06-30,3,2021,0,0
Bureau,Other Agencies/Boards/Commissions,Medicare Payment Advisory Commission,null,0.0,0.0,0,0,0,0,30,06,2,2021,2021-06-30,3,2021,0,0
Bureau,Department of the Treasury,Pandemic Receivables,null,0.0,0.0,0,0,0,0,30,06,2,2021,2021-06-30,3,2021,0,0
Bureau,Department of Homeland Security,Office of the Inspector General DHS,null,100.0,100.0,0,0,100,1,30,06,2,2021,2021-06-30,3,2021,100,1
Bureau,Merit Systems Protection Board,Merit Systems Protection Board,null,100.0,100.0,0,0,144,1,30,06,2,2021,2021-06-30,3,2021,144,1
Bureau,U.S. Court of Appeals / Veterans Claims,U.S. Court of Appeals / Veterans Claims,null,100.0,100.0,0,0,173,1,30,06,2,2021,2021-06-30,3,2021,173,1
Bureau,Department of Transportation,Office of the Inspector General,null,100.0,100.0,0,0,214,1,30,06,2,2021,2021-06-30,3,2021,214,1
Bureau,Other Agencies,National Council on Disability,null,0.0,0.0,1579,2,0,0,30,06,2,2021,2021-06-30,3,2021,1579,2
Bureau,Consumer Product Safety Commission,Consumer Product Safety Commission,null,100.0,100.0,0,0,2500,1,30,06,2,2021,2021-06-30,3,2021,2500,1
Bureau,Other Agencies,John C. Stennis,null,0.0,0.0,2934,2,0,0,30,06,2,2021,2021-06-30,3,2021,2934,2
Bureau,Department of the Treasury,Spec Insp Gen-Troubled Asset Rel Prog,null,100.0,100.0,0,0,3916,1,30,06,2,2021,2021-06-30,3,2021,3916,1
Bureau,Department of Transportation,Maritime Administration,null,100.0,100.0,0,0,4385,4,30,06,2,2021,2021-06-30,3,2021,4385,4
Bureau,Department of Transportation,Federal Highway Administration,null,100.0,100.0,0,0,4533,5,30,06,2,2021,2021-06-30,3,2021,4533,5
Bureau,Department of Commerce,General Administration,null,100.0,100.0,0,0,4660,1,30,06,2,2021,2021-06-30,3,2021,4660,1
Bureau,Other Agencies,U.S.  Agency of Global Media,null,100.0,100.0,0,0,4930,2,30,06,2,2021,2021-06-30,3,2021,4930,2
Bureau,Other Agencies,U.S. Inst. for Env. Conflict Resolution,null,0.0,0.0,5003,2,0,0,30,06,2,2021,2021-06-30,3,2021,5003,2
Bureau,Other Agencies,Election Assistance Commission,null,0.0,0.0,5576,1,0,0,30,06,2,2021,2021-06-30,3,2021,5576,1
Bureau,Equal Employment Opportunity Commission,Equal Employment Opportunity Commission,null,100.0,100.0,0,0,27704,15,30,06,2,2021,2021-06-30,3,2021,27704,15
Bureau,Department of Commerce,Economic and Statistical Analysis,null,0.0,0.0,0,0,0,0,30,06,2,2021,2021-06-30,3,2021,0,0
Bureau,Department of Homeland Security,Federal Law Enforcement Training Ctr.,null,0.0,0.0,0,0,0,0,30,06,2,2021,2021-06-30,3,2021,0,0
Bureau,Other Agencies,Morris K. Udall Scholarship,null,0.0,0.0,0,0,0,0,30,06,2,2021,2021-06-30,3,2021,0,0
Bureau,Farm Credit Administration,Farm Credit Administration,null,100.0,100.0,0,0,630,1,30,06,2,2021,2021-06-30,3,2021,630,1
Bureau,Other Agencies,Millennium Challenge Corporation,null,100.0,100.0,0,0,817,1,30,06,2,2021,2021-06-30,3,2021,817,1
Bureau,Department of the Treasury,Tobacco Tax and Trade,null,100.0,100.0,0,0,1000,1,30,06,2,2021,2021-06-30,3,2021,1000,1
Bureau,Other Agencies/Boards/Commissions,U.S. Comm. on Int. Religious Freedom,null,0.0,0.0,1024,1,0,0,30,06,2,2021,2021-06-30,3,2021,1024,1
Bureau,Department of Justice,Office of Justice Assistance Programs,null,100.0,100.0,0,0,1101,3,30,06,2,2021,2021-06-30,3,2021,1101,3
Bureau,Other Agencies,Federal Housing Finance Agency,null,0.0,0.0,1239,2,0,0,30,06,2,2021,2021-06-30,3,2021,1239,2
Bureau,National Credit Union Administration,National Credit Union Administration,null,0.0,0.0,1319,5,0,0,30,06,2,2021,2021-06-30,3,2021,1319,5
Bureau,Smithsonian Institution,Smithsonian Institution,null,0.0,0.0,7350,1,0,0,30,06,2,2021,2021-06-30,3,2021,7350,1
Bureau,Department of Transportation,St. Lawrence Seaway Development Corp.,null,97.57575757575758,66.66666666666667,192,1,7728,2,30,06,2,2021,2021-06-30,3,2021,7920,3
Bureau,Department of Health & Human Services,Office of the Secretary,null,100.0,100.0,0,0,9105,8,30,06,2,2021,2021-06-30,3,2021,9105,8
Bureau,Department of Labor,Bureau of Labor Statistics,null,100.0,100.0,0,0,10260,1,30,06,2,2021,2021-06-30,3,2021,10260,1
Bureau,Department of Transportation,National Highway Traffic Safety Admin.,null,100.0,100.0,0,0,18516,3,30,06,2,2021,2021-06-30,3,2021,18516,3
Bureau,Department of Justice,Bureau of ATF and Explosives,null,100.0,100.0,0,0,20422,4,30,06,2,2021,2021-06-30,3,2021,20422,4
Bureau,Department of Agriculture,Federal Crop Insurance Corporation,null,83.84828390293667,99.7560975609756,4433,1,23013,409,30,06,2,2021,2021-06-30,3,2021,27446,410
Bureau,Other Agencies,Architect of the Capitol,null,0.0,0.0,48052,24,0,0,30,06,2,2021,2021-06-30,3,2021,48052,24
Bureau,Department of the Treasury,U.S. Mint,null,93.85010876013446,96.42857142857143,3110,1,47460,27,30,06,2,2021,2021-06-30,3,2021,50570,28
Bureau,Department of the Interior,Bureau of Reclamation,null,100.0,100.0,0,0,83331,67,30,06,2,2021,2021-06-30,3,2021,83331,67
Bureau,Armed Forces Retirement Home,Armed Forces Retirement Home,null,70.72962881616516,84.55284552845528,33317,19,80508,104,30,06,2,2021,2021-06-30,3,2021,113825,123
Bureau,Other Agencies,Council of Insps. Gen. of Intg. & Effy.,null,0.0,0.0,4900,8,0,0,30,06,2,2021,2021-06-30,3,2021,4900,8
Bureau,Department of Homeland Security,Domestic Nuclear Detection Office,null,0.0,0.0,31024,16,0,0,30,06,2,2021,2021-06-30,3,2021,31024,16
Bureau,Department of the Treasury,Bureau of Engraving and Printing,null,100.0,100.0,0,0,84528,1,30,06,2,2021,2021-06-30,3,2021,84528,1
Bureau,Department of Housing and Urban Development,Community Planning and Development,null,100.0,100.0,0,0,101371,1,30,06,2,2021,2021-06-30,3,2021,101371,1
Bureau,Department of Transportation,Federal Railroad Administration,null,100.0,100.0,0,0,132418,12,30,06,2,2021,2021-06-30,3,2021,132418,12
Bureau,Legislative Branch-GPO,Government Publishing Office,null,53.128687004887915,15.517241379310345,66741,49,75651,9,30,06,2,2021,2021-06-30,3,2021,142392,58
Bureau,Department of the Treasury,Internal Revenue Service,null,100.0,100.0,0,0,217736,70,30,06,2,2021,2021-06-30,3,2021,217736,70
Bureau,Securities & Exchange Commission,Securities and Exchange Commission,null,100.0,100.0,0,0,306738,51,30,06,2,2021,2021-06-30,3,2021,306738,51
Bureau,Department of Commerce,Bureau of the Census,null,100.0,100.0,0,0,316591,427,30,06,2,2021,2021-06-30,3,2021,316591,427
Bureau,Department of Justice,Drug Enforcement Administration,null,100.0,100.0,0,0,326271,23,30,06,2,2021,2021-06-30,3,2021,326271,23
Bureau,Department of the Treasury,D.C. Pension Program,null,100.0,100.0,0,0,388850,21,30,06,2,2021,2021-06-30,3,2021,388850,21
Bureau,Department of Transportation,Pipeline Hazardous Material Safety Admin,null,100.0,100.0,0,0,393939,24,30,06,2,2021,2021-06-30,3,2021,393939,24
Bureau,Federal Maritime Commission,Salaries and Expenses,null,100.0,100.0,0,0,397266,6,30,06,2,2021,2021-06-30,3,2021,397266,6
Bureau,Department of Transportation,Federal Transit Administration,null,100.0,100.0,0,0,784879,3,30,06,2,2021,2021-06-30,3,2021,784879,3
Bureau,Department of Justice,Federal Prison System,null,100.0,100.0,0,0,862854,124,30,06,2,2021,2021-06-30,3,2021,862854,124
Bureau,Department of Veterans Affairs,Life Insurance,null,100.0,100.0,0,0,867243,156,30,06,2,2021,2021-06-30,3,2021,867243,156
Bureau,Department of Agriculture,Food Safety and Inspection Service,null,96.86807055012487,96.56203288490283,27980,23,865399,646,30,06,2,2021,2021-06-30,3,2021,893379,669
Bureau,Federal Election Commission,Federal Election Commission,null,100.0,100.0,0,0,903738,145,30,06,2,2021,2021-06-30,3,2021,903738,145
Bureau,Department of Transportation,Office of the Secretary,null,100.0,100.0,0,0,1051969,14,30,06,2,2021,2021-06-30,3,2021,1051969,14
Bureau,The Judiciary,Administrative Office of the U.S. Courts,null,98.8848657691537,59.81012658227848,11965,127,1061000,189,30,06,2,2021,2021-06-30,3,2021,1072965,316
Bureau,Department of the Interior,Geological Survey,null,100.0,100.0,0,0,123074,417,30,06,2,2021,2021-06-30,3,2021,123074,417
Bureau,National Archives & Records Admin,Nat'l Archives & Records Administration,null,100.0,100.0,0,0,130359,107,30,06,2,2021,2021-06-30,3,2021,130359,107
Bureau,Other Agencies,James Madison Memorial Fellowship,null,0.0,0.0,222112,26,0,0,30,06,2,2021,2021-06-30,3,2021,222112,26
Bureau,Legislative Branch - U.S. House/Senate,U.S. House of Representatives,null,0.0,0.0,242304,167,0,0,30,06,2,2021,2021-06-30,3,2021,242304,167
Bureau,Department of Justice,Federal Bureau of Investigation,null,100.0,100.0,0,0,296086,64,30,06,2,2021,2021-06-30,3,2021,296086,64
Bureau,Department of Commerce,Nat'l Telecomm & Information Admin.,null,100.0,100.0,0,0,296094,1,30,06,2,2021,2021-06-30,3,2021,296094,1
Bureau,Other Agencies,Consumer Financial Protection Bureau,null,5.258944133508706,4.0,381040,24,21151,1,30,06,2,2021,2021-06-30,3,2021,402191,25
Bureau,Department of Commerce,Patent and Trademark Office,null,100.0,100.0,0,0,445909,557,30,06,2,2021,2021-06-30,3,2021,445909,557
Bureau,National Science Foundation,National Science Foundation,null,100.0,100.0,0,0,533678,78,30,06,2,2021,2021-06-30,3,2021,533678,78
Bureau,Department of the Interior,Office of the Secretary,null,100.0,100.0,0,0,610551,17,30,06,2,2021,2021-06-30,3,2021,610551,17
Bureau,Department of Commerce,Nat'l Institute of Standards& Technology,null,100.0,100.0,0,0,686743,5,30,06,2,2021,2021-06-30,3,2021,686743,5
Bureau,Department of the Interior,Fish and Wildlife Service,null,100.0,100.0,0,0,751787,72,30,06,2,2021,2021-06-30,3,2021,751787,72
Bureau,Department of Housing and Urban Development,Management and Administration,null,0.8931424395238196,63.63636363636363,896369,4,8078,7,30,06,2,2021,2021-06-30,3,2021,904447,11
Bureau,Department of Veterans Affairs,Housing Credit Assistance,null,0.0,0.0,945386,24,0,0,30,06,2,2021,2021-06-30,3,2021,945386,24
Bureau,Department of Health & Human Services,Substance Abuse & Mental Health Admin.,null,100.0,100.0,0,0,986459,14,30,06,2,2021,2021-06-30,3,2021,986459,14
Bureau,Department of Homeland Security,Citizenship and Immigration Services,null,100.0,100.0,0,0,1032159,1244,30,06,2,2021,2021-06-30,3,2021,1032159,1244
Bureau,Department of Justice,Federal Prison Industries,null,100.0,100.0,0,0,1043089,183,30,06,2,2021,2021-06-30,3,2021,1043089,183
Bureau,Department of the Treasury,Comptroller of the Currency,null,99.89038428086658,95.23809523809524,1191,1,1085332,20,30,06,2,2021,2021-06-30,3,2021,1086523,21
Bureau,National Aeronautics and Space Administration,National Aeronautics and Space Admin,null,100.0,100.0,0,0,1215551,120,30,06,2,2021,2021-06-30,3,2021,1215551,120
Bureau,Department of Veterans Affairs,Administration and Cemeteries,null,3.358462791845138,3.2138442521631645,1179106,783,40976,26,30,06,2,2021,2021-06-30,3,2021,1220082,809
Bureau,Funds Appropriated to the President,Trade and Development Agency,null,0.0,0.0,1236200,7,0,0,30,06,2,2021,2021-06-30,3,2021,1236200,7
Bureau,Department of Veterans Affairs,Veterans Benefits,null,0.0,0.0,1295710,1702,0,0,30,06,2,2021,2021-06-30,3,2021,1295710,1702
Bureau,Presidio Trust Corporation,Presidio Trust Corporation,null,0.0,0.0,1496012,71,0,0,30,06,2,2021,2021-06-30,3,2021,1496012,71
Bureau,Department of the Treasury,Financial Crimes Enforcement Network,null,100.0,100.0,0,0,1544945,3,30,06,2,2021,2021-06-30,3,2021,1544945,3
Bureau,Department of Energy,Bonneville Power Administration,null,100.0,100.0,0,0,1553865,25,30,06,2,2021,2021-06-30,3,2021,1553865,25
Bureau,Department of Housing and Urban Development,Public and Indian Housing Programs,null,92.4492705945572,50.0,142763,2,1747955,2,30,06,2,2021,2021-06-30,3,2021,1890718,4
Bureau,Department of Transportation,Federal Aviation Administration,null,96.20168416040084,93.7007874015748,72107,16,1826287,238,30,06,2,2021,2021-06-30,3,2021,1898394,254
Bureau,Department of State,Passport NSF,null,100.0,100.0,0,0,2197788,14152,30,06,2,2021,2021-06-30,3,2021,2197788,14152
Bureau,Nuclear Regulatory Commission,Nuclear Regulatory Commission,null,100.0,100.0,0,0,2609778,323,30,06,2,2021,2021-06-30,3,2021,2609778,323
Bureau,Pension Benefit Guaranty Corp,Pension Benefit Guaranty Corporation,null,100.0,100.0,0,0,3366092,1141,30,06,2,2021,2021-06-30,3,2021,3366092,1141
Bureau,Department of Labor,Employment and Training Administration,null,0.0,0.0,3369968,11,0,0,30,06,2,2021,2021-06-30,3,2021,3369968,11
Bureau,Corp. for National and Community Service,Corp. for National and Community Service,null,79.76368044863497,13.013698630136986,909129,1016,3583432,152,30,06,2,2021,2021-06-30,3,2021,4492561,1168
Bureau,Department of Homeland Security,Bureau of Customs & Border Protection,null,100.0,100.0,0,0,8789350,603,30,06,2,2021,2021-06-30,3,2021,8789350,603
Bureau,Department of Energy,Energy Consolidated Reports,null,100.0,100.0,0,0,12962754,74,30,06,2,2021,2021-06-30,3,2021,12962754,74
Bureau,Department of Homeland Security,Immigration and Customs Enforcement,null,100.0,100.0,0,0,13939302,591,30,06,2,2021,2021-06-30,3,2021,13939302,591
Bureau,Department of the Treasury,Bureau of the Fiscal Service,null,100.0,100.0,0,0,14003648,3631,30,06,2,2021,2021-06-30,3,2021,14003648,3631
Bureau,Department of Health & Human Services,Centers for Disease Control,null,1.0366884935148384,18.556701030927837,14822610,79,155274,18,30,06,2,2021,2021-06-30,3,2021,14977884,97
Bureau,Department of the Interior,Bureau of Land Management,null,100.0,100.0,0,0,15839939,327,30,06,2,2021,2021-06-30,3,2021,15839939,327
Bureau,Department of Labor,Employee Benefit Security Administration,null,100.0,100.0,0,0,17032718,385,30,06,2,2021,2021-06-30,3,2021,17032718,385
Bureau,Department of the Treasury,Community Dev Financial Inst Fund,null,100.0,100.0,0,0,4634951,10,30,06,2,2021,2021-06-30,3,2021,4634951,10
Bureau,Department of Agriculture,Agricultural Marketing Service,null,90.19308568529591,31.02409638554217,497574,1145,4576132,515,30,06,2,2021,2021-06-30,3,2021,5073706,1660
Bureau,Department of Commerce,Economic Development Administration,null,100.0,100.0,0,0,5121576,12,30,06,2,2021,2021-06-30,3,2021,5121576,12
Bureau,Department of the Interior,Office of Surface Mining,null,100.0,100.0,0,0,6492779,362,30,06,2,2021,2021-06-30,3,2021,6492779,362
Bureau,Department of Veterans Affairs,Medical and Construction,null,67.58280276298122,78.74619342644125,2206684,2024,4600456,7499,30,06,2,2021,2021-06-30,3,2021,6807140,9523
Bureau,Department of Health & Human Services,Program Support Center,null,100.0,100.0,0,0,6815834,343,30,06,2,2021,2021-06-30,3,2021,6815834,343
Bureau,Department of Agriculture,Food and Nutrition Service,null,0.7130504560199673,2.0905923344947737,6859644,281,49264,6,30,06,2,2021,2021-06-30,3,2021,6908908,287
Bureau,General Services Administration,General Services Administration,null,62.31889489398436,57.40272865083375,2664443,843,4406589,1136,30,06,2,2021,2021-06-30,3,2021,7071032,1979
Bureau,Department of the Interior,National Park Service,null,100.0,100.0,0,0,7864749,1807,30,06,2,2021,2021-06-30,3,2021,7864749,1807
Bureau,Department of the Interior,Office of Natural Resources Revenue,null,100.0,100.0,0,0,8100158,560,30,06,2,2021,2021-06-30,3,2021,8100158,560
Bureau,Department of Homeland Security,Transportation Safety Administration,null,100.0,100.0,0,0,8222583,5843,30,06,2,2021,2021-06-30,3,2021,8222583,5843
Bureau,Department of Health & Human Services,National Institutes of Health,null,32.634750522030146,21.663019693654267,12293448,358,5955498,99,30,06,2,2021,2021-06-30,3,2021,18248946,457
Bureau,Department of State,Department of State,null,98.05658053886593,99.21951219512195,354930,64,17908240,8136,30,06,2,2021,2021-06-30,3,2021,18263170,8200
Bureau,Department of Commerce,NOAA,null,100.0,100.0,0,0,19930572,872,30,06,2,2021,2021-06-30,3,2021,19930572,872
Bureau,Department of Agriculture,U.S. Department of Agriculture,null,80.23767849698056,56.18463757663181,4151943,1215,16857446,1558,30,06,2,2021,2021-06-30,3,2021,21009389,2773
Bureau,Railroad Retirement Board,Railroad Retirement Board,null,100.0,99.97626957759849,0,1,21725439,4213,30,06,2,2021,2021-06-30,3,2021,21725439,4214
Bureau,Department of the Treasury,Departmental Offices,null,96.29539301456605,98.02197802197803,827850,27,21518650,1338,30,06,2,2021,2021-06-30,3,2021,22346500,1365
Bureau,Office of Personnel Management,Office of Personnel Management,null,93.05589906407761,90.96551724137932,1613287,131,21619195,1319,30,06,2,2021,2021-06-30,3,2021,23232482,1450
Bureau,Federal Trade Commission,Federal Trade Commission,null,100.0,100.0,0,0,483052147,55,30,06,2,2021,2021-06-30,3,2021,483052147,55
Bureau,Department of Labor,Mine Safety and Health Administration,null,77.94108498326598,68.72246696035242,5247785,2414,18542075,5304,30,06,2,2021,2021-06-30,3,2021,23789860,7718
Bureau,Environmental Protection Agency,Environmental Protection Agency,null,100.0,100.0,0,0,24643592,236,30,06,2,2021,2021-06-30,3,2021,24643592,236
Bureau,Department of Health & Human Services,Indian Health Services,null,100.0,100.0,0,0,25762058,3224,30,06,2,2021,2021-06-30,3,2021,25762058,3224
Bureau,Department of Health & Human Services,Administration for Children and Families,null,100.0,100.0,0,0,29939817,1829,30,06,2,2021,2021-06-30,3,2021,29939817,1829
Bureau,Department of Commerce,Bureau of Industry and Security,null,100.0,100.0,0,0,35047203,25,30,06,2,2021,2021-06-30,3,2021,35047203,25
Bureau,Agency for International Development,Agency for International Development,null,100.0,100.0,0,0,37221816,59,30,06,2,2021,2021-06-30,3,2021,37221816,59
Bureau,Department of the Interior,Bureau of Indian Affairs,null,99.99977342306312,99.9812439042689,91,5,40162867,26653,30,06,2,2021,2021-06-30,3,2021,40162958,26658
Bureau,Department of Labor,Occupational Safety and Health Admin,null,97.45308135907577,91.63021868787277,1505380,421,57600552,4609,30,06,2,2021,2021-06-30,3,2021,59105932,5030
Bureau,Department of Transportation,Federal Motor Carrier Safety Admin,null,99.99988539580688,99.98579343656769,71,1,61952287,7038,30,06,2,2021,2021-06-30,3,2021,61952358,7039
Bureau,Department of Agriculture,Forest Service,null,90.41931587194496,27.63819095477387,6688088,864,63119954,330,30,06,2,2021,2021-06-30,3,2021,69808042,1194
Bureau,U.S. Postal Service,U.S. Postal Service,null,55.017633969763736,81.93730356998952,34661531,11207,42394289,50838,30,06,2,2021,2021-06-30,3,2021,77055820,62045
Bureau,Department of Homeland Security,U.S. Coast Guard,null,100.0,100.0,0,0,82902330,13076,30,06,2,2021,2021-06-30,3,2021,82902330,13076
Bureau,Department of Justice,Legal Activities,null,95.14638348929876,98.82607433983169,4428662,445,86815918,37462,30,06,2,2021,2021-06-30,3,2021,91244580,37907
Bureau,Department of Labor,Employment Standards Administration,null,81.9076316775233,72.38103799592473,17170888,9217,77735913,24155,30,06,2,2021,2021-06-30,3,2021,94906801,33372
Bureau,Department of Health & Human Services,Food and Drug Administration,null,32.45898770144109,8.88610763454318,78754854,12376,37848157,1207,30,06,2,2021,2021-06-30,3,2021,116603011,13583
Bureau,Department of Education,Departmental Management,null,93.22556216851359,84.72286911970191,65758540,328,904927761,1819,30,06,2,2021,2021-06-30,3,2021,970686301,2147
Bureau,Department of Health & Human Services,Centers for Medicare & Medicaid Services,null,99.23132107979345,98.78378378378379,71592115,14148,9242064487,1149132,30,06,2,2021,2021-06-30,3,2021,9313656602,1163280
Bureau,Small Business Administration,Small Business Administration,null,100.0,100.0,0,0,12431248241,119029,30,06,2,2021,2021-06-30,3,2021,12431248241,119029
Bureau,Securities & Exchange Commission,SEC Enforcement,null,100.0,100.0,0,0,2105628446,1056,30,06,2,2021,2021-06-30,3,2021,2105628446,1056
Bureau,Department of Defense,Consolidated Report,null,95.28056570996883,95.43882030386466,112694888,78157,2275194869,1635369,30,06,2,2021,2021-06-30,3,2021,2387889757,1713526
Bureau,Social Security Administration,Social Security Administration,null,62.517167082104564,36.24122581091574,1633891460,829304,2725147953,471386,30,06,2,2021,2021-06-30,3,2021,4359039413,1300690
Bureau,Department of Education,Federal Student Aid,null,100.0,100.0,0,0,132230125570,22909177,30,06,2,2021,2021-06-30,3,2021,132230125570,22909177
Agency,Department of Veterans Affairs,null,CFO,49.4692184794282,62.886851154412966,5626886,4533,5508675,7681,30,06,2,2021,2021-06-30,3,2021,11135561,12214
Bureau,Other Agencies,U.S. Institute of Peace,null,0.0,0.0,0,0,0,0,30,09,3,2021,2021-09-30,4,2021,0,0
Bureau,Other Agencies,Morris K. Udall Scholarship,null,0.0,0.0,0,0,0,0,30,09,3,2021,2021-09-30,4,2021,0,0
Bureau,Department of Homeland Security,Office of the Inspector General DHS,null,100.0,100.0,0,0,100,1,30,09,3,2021,2021-09-30,4,2021,100,1
Bureau,Department of the Treasury,Spec Insp Gen-Troubled Asset Rel Prog,null,100.0,100.0,0,0,3916,1,30,09,3,2021,2021-09-30,4,2021,3916,1
Bureau,Other Agencies,U.S. Inst. for Env. Conflict Resolution,null,0.0,0.0,5003,2,0,0,30,09,3,2021,2021-09-30,4,2021,5003,2
Bureau,Other Agencies,Council of Insps. Gen. of Intg. & Effy.,null,0.0,0.0,5350,9,0,0,30,09,3,2021,2021-09-30,4,2021,5350,9
Bureau,Legislative Branch-GAO,Government Accountability Office,null,100.0,100.0,0,0,29464,8,30,09,3,2021,2021-09-30,4,2021,29464,8
Bureau,Department of Health & Human Services,Indian Health Services,null,100.0,100.0,0,0,24220000,3138,30,09,3,2021,2021-09-30,4,2021,24220000,3138
Bureau,Department of the Treasury,Bureau of Engraving and Printing,null,0.0,0.0,0,0,0,0,30,09,3,2021,2021-09-30,4,2021,0,0
Bureau,Legislative Branch-CBO,Congressional Budget Office,null,0.0,0.0,0,0,0,0,30,09,3,2021,2021-09-30,4,2021,0,0
Bureau,Department of Commerce,International Trade Administration,null,0.0,0.0,0,0,0,0,30,09,3,2021,2021-09-30,4,2021,0,0
Bureau,Department of the Treasury,Interest on Tax/Deposit of Earnings,null,0.0,0.0,0,0,0,0,30,09,3,2021,2021-09-30,4,2021,0,0
Bureau,National Foundation  Arts & Humanities,National Endowment for the Arts,null,0.0,0.0,0,0,0,0,30,09,3,2021,2021-09-30,4,2021,0,0
Bureau,American Battle Monuments Commission,American Battle Monuments Commission,null,0.0,0.0,0,0,0,0,30,09,3,2021,2021-09-30,4,2021,0,0
Agency,U.S. Tax Court,null,Non-CFO,0.0,0.0,0,0,0,0,30,09,3,2021,2021-09-30,4,2021,0,0
Bureau,Other Agencies,Commission On Fine Arts,null,0.0,0.0,0,0,0,0,30,09,3,2021,2021-09-30,4,2021,0,0
Agency,Nuclear Regulatory Commission,null,CFO,100.0,100.0,0,0,2940093,364,30,09,3,2021,2021-09-30,4,2021,2940093,364
Bureau,Department of Agriculture,Commodity Credit Corporation,null,100.0,100.0,0,0,135916502,10953,30,09,3,2021,2021-09-30,4,2021,135916502,10953
Agency,Department of Energy,null,CFO,100.0,100.0,0,0,14391114,90,30,09,3,2021,2021-09-30,4,2021,14391114,90
Bureau,Department of Commerce,Minority Business Development Agency,null,0.0,0.0,0,0,0,0,30,09,3,2021,2021-09-30,4,2021,0,0
Bureau,Other Agencies/Boards/Commissions,U.S.-China Security Review Commission,null,0.0,0.0,0,0,0,0,30,09,3,2021,2021-09-30,4,2021,0,0
Bureau,Export - Import  Bank,Export-Import Bank,null,0.0,0.0,0,0,0,0,30,09,3,2021,2021-09-30,4,2021,0,0
Agency,Department of Agriculture,null,CFO,99.02021058732002,91.85426287895571,17262169,4780,1744562237,53901,30,09,3,2021,2021-09-30,4,2021,1761824406,58681
Agency,Department of Health & Human Services,null,CFO,98.10474152427919,98.13271759863467,182286698,21762,9435752231,1143675,30,09,3,2021,2021-09-30,4,2021,9618038929,1165437
Agency,American Battle Monuments Commission,null,Non-CFO,0.0,0.0,0,0,0,0,30,09,3,2021,2021-09-30,4,2021,0,0
Bureau,Funds Appropriated to the President,Executive Branch,null,0.0,0.0,0,0,0,0,30,09,3,2021,2021-09-30,4,2021,0,0
Bureau,Department of State,Civil Monetary Penalties,null,0.0,0.0,0,0,0,0,30,09,3,2021,2021-09-30,4,2021,0,0
Bureau,Department of the Treasury,Office of the Secretary,null,0.0,0.0,0,0,0,0,30,09,3,2021,2021-09-30,4,2021,0,0
Bureau,Department of the Treasury,Treasury IG for Tax Admin,null,0.0,0.0,0,0,0,0,30,09,3,2021,2021-09-30,4,2021,0,0
Bureau,Department of the Treasury,Treasury Forfeiture Fund,null,0.0,0.0,0,0,0,0,30,09,3,2021,2021-09-30,4,2021,0,0
Bureau,Department of Homeland Security,U.S. Secret Service,null,0.0,0.0,0,0,0,0,30,09,3,2021,2021-09-30,4,2021,0,0
Bureau,Other Agencies,Comm. for Purchase from Blind/Handic.,null,0.0,0.0,0,0,0,0,30,09,3,2021,2021-09-30,4,2021,0,0
Bureau,Other Agencies,Advisory Council on Hist. Preservation,null,0.0,0.0,0,0,0,0,30,09,3,2021,2021-09-30,4,2021,0,0
Bureau,Other Agencies,Archit.&Trans. Barriers Compliance Bd,null,0.0,0.0,0,0,0,0,30,09,3,2021,2021-09-30,4,2021,0,0
Bureau,Smithsonian Institution,Administrative Conference of the US,null,0.0,0.0,0,0,0,0,30,09,3,2021,2021-09-30,4,2021,0,0
Bureau,Other Agencies,Gulf Coast Ecosystem Restoration Council,null,0.0,0.0,0,0,0,0,30,09,3,2021,2021-09-30,4,2021,0,0
Bureau,Other Agencies,National Mediation Board,null,0.0,0.0,0,0,0,0,30,09,3,2021,2021-09-30,4,2021,0,0
Bureau,Department of Health & Human Services,Office of the Inspector General,null,0.0,0.0,0,0,0,0,30,09,3,2021,2021-09-30,4,2021,0,0
Bureau,Department of the Treasury,Pandemic Receivables,null,0.0,0.0,0,0,0,0,30,09,3,2021,2021-09-30,4,2021,0,0
Bureau,Department of Transportation,Office of the Inspector General,null,100.0,100.0,0,0,214,1,30,09,3,2021,2021-09-30,4,2021,214,1
Agency,Department of the Interior,null,CFO,100.0,100.0,0,0,71536817,34099,30,09,3,2021,2021-09-30,4,2021,71536817,34099
Agency,Department of Justice,null,CFO,96.00359623762103,98.95714137106002,3738991,401,89819899,38051,30,09,3,2021,2021-09-30,4,2021,93558890,38452
Agency,Department of Housing and Urban Development,null,CFO,99.61905311392249,99.74337040205303,533625,12,139544958,4664,30,09,3,2021,2021-09-30,4,2021,140078583,4676
Agency,Department of Labor,null,CFO,83.40479303107814,46.42220019821605,32170554,18921,161683937,16394,30,09,3,2021,2021-09-30,4,2021,193854491,35315
Agency,Department of Homeland Security,null,CFO,98.44217112145984,97.77218828602228,5027659,1364,317707339,59862,30,09,3,2021,2021-09-30,4,2021,322734998,61226
Agency,Department of Defense,null,CFO,38.7685414820526,14.885959962646215,1598525239,1464679,1012102170,256164,30,09,3,2021,2021-09-30,4,2021,2610627409,1720843
Agency,Office of Compliance,null,Non-CFO,0.0,0.0,0,0,0,0,30,09,3,2021,2021-09-30,4,2021,0,0
Agency,Armed Forces Retirement Home,null,Non-CFO,67.43822521493416,88.03418803418803,37912,14,78519,103,30,09,3,2021,2021-09-30,4,2021,116431,117
Agency,National Archives & Records Admin,null,Non-CFO,100.0,100.0,0,0,117766,103,30,09,3,2021,2021-09-30,4,2021,117766,103
Agency,Federal Maritime Commission,null,Non-CFO,100.0,100.0,0,0,397392,6,30,09,3,2021,2021-09-30,4,2021,397392,6
Agency,Other Agencies,null,Non-CFO,3.9739214917109207,6.521739130434782,682973,86,28264,6,30,09,3,2021,2021-09-30,4,2021,711237,92
Agency,Federal Election Commission,null,Non-CFO,100.0,100.0,0,0,1020864,164,30,09,3,2021,2021-09-30,4,2021,1020864,164
Agency,The Judiciary,null,Non-CFO,98.87487352318334,58.085808580858085,11965,127,1051471,176,30,09,3,2021,2021-09-30,4,2021,1063436,303
Agency,Funds Appropriated to the President,null,Non-CFO,0.0,0.0,1235225,6,0,0,30,09,3,2021,2021-09-30,4,2021,1235225,6
Agency,Securities & Exchange Commission,null,Non-CFO,100.0,100.0,0,0,2001689850,1087,30,09,3,2021,2021-09-30,4,2021,2001689850,1087
Bureau,Smithsonian Institution,National Gallery of Art,null,0.0,0.0,0,0,0,0,30,09,3,2021,2021-09-30,4,2021,0,0
Bureau,Smithsonian Institution,JFK Center for the Performing Arts,null,0.0,0.0,0,0,0,0,30,09,3,2021,2021-09-30,4,2021,0,0
Bureau,Federal Deposit Insurance Corporation,Federal Deposit Insurance Corporation,null,0.0,0.0,0,0,0,0,30,09,3,2021,2021-09-30,4,2021,0,0
Bureau,Department of Homeland Security,Info Analysis Infrastructure Prot-NPPD,null,0.0,0.0,0,0,0,0,30,09,3,2021,2021-09-30,4,2021,0,0
Bureau,Department of the Interior,Bureau of Safety and Environmental Enf.,null,0.0,0.0,0,0,0,0,30,09,3,2021,2021-09-30,4,2021,0,0
Bureau,Other Agencies,Surface Transportation Board,null,0.0,0.0,0,0,0,0,30,09,3,2021,2021-09-30,4,2021,0,0
Bureau,Other Agencies,Delta Regional Authority,null,0.0,0.0,0,0,0,0,30,09,3,2021,2021-09-30,4,2021,0,0
Bureau,Merit Systems Protection Board,Merit Systems Protection Board,null,100.0,100.0,0,0,144,1,30,09,3,2021,2021-09-30,4,2021,144,1
Agency,National Science Foundation,null,CFO,100.0,100.0,0,0,527228,66,30,09,3,2021,2021-09-30,4,2021,527228,66
Agency,National Aeronautics and Space Administration,null,CFO,100.0,100.0,0,0,1307058,126,30,09,3,2021,2021-09-30,4,2021,1307058,126
Agency,Department of State,null,CFO,97.74979753528068,98.99536321483771,439505,208,19092293,20496,30,09,3,2021,2021-09-30,4,2021,19531798,20704
Agency,Office of Personnel Management,null,CFO,90.83676946871138,87.66233766233766,2208360,171,21891874,1215,30,09,3,2021,2021-09-30,4,2021,24100234,1386
Agency,Environmental Protection Agency,null,CFO,100.0,100.0,0,0,24814614,240,30,09,3,2021,2021-09-30,4,2021,24814614,240
Agency,Agency for International Development,null,CFO,100.0,100.0,0,0,38171581,52,30,09,3,2021,2021-09-30,4,2021,38171581,52
Agency,Department of the Treasury,null,CFO,97.50633753921879,99.38295410721173,1122151,32,43877965,5154,30,09,3,2021,2021-09-30,4,2021,45000116,5186
Agency,Department of Commerce,null,CFO,100.0,100.0,0,0,56849485,5298,30,09,3,2021,2021-09-30,4,2021,56849485,5298
Agency,Department of Transportation,null,CFO,99.80811609178886,98.13195548489666,129383,141,67298366,7407,30,09,3,2021,2021-09-30,4,2021,67427749,7548
Bureau,Department of Commerce,Office of the Inspector General,null,0.0,0.0,0,0,0,0,30,09,3,2021,2021-09-30,4,2021,0,0
Bureau,Department of Commerce,National Technical Information Service,null,0.0,0.0,0,0,0,0,30,09,3,2021,2021-09-30,4,2021,0,0
Bureau,National Foundation  Arts & Humanities,National Endowment for the Humanities,null,0.0,0.0,0,0,0,0,30,09,3,2021,2021-09-30,4,2021,0,0
Bureau,Tennessee Valley Authority,Tennessee Valley Authority,null,0.0,0.0,0,0,0,0,30,09,3,2021,2021-09-30,4,2021,0,0
Bureau,Department of Homeland Security,Federal Law Enforcement Training Ctr.,null,0.0,0.0,0,0,0,0,30,09,3,2021,2021-09-30,4,2021,0,0
Bureau,Neighborhood Reinvestment Corporation,Neighborhood Reinvestment Corporation,null,0.0,0.0,0,0,0,0,30,09,3,2021,2021-09-30,4,2021,0,0
Bureau,Department of Education,Office of Postsecondary Education,null,0.0,0.0,0,0,0,0,30,09,3,2021,2021-09-30,4,2021,0,0
Bureau,Other Agencies,Defense Nuclear Facilities Safety Board,null,0.0,0.0,0,0,0,0,30,09,3,2021,2021-09-30,4,2021,0,0
Bureau,Other Agencies,Federal Housing Finance Agency OIG,null,0.0,0.0,0,0,0,0,30,09,3,2021,2021-09-30,4,2021,0,0
Bureau,Other Agencies,Privacy & Civil Liberties Oversight Bd,null,0.0,0.0,0,0,0,0,30,09,3,2021,2021-09-30,4,2021,0,0
Agency,General Services Administration,null,CFO,97.01704706218388,82.24734042553192,311005,267,10115073,1237,30,09,3,2021,2021-09-30,4,2021,10426078,1504
Agency,Small Business Administration,null,CFO,100.0,100.0,0,0,12471591443,118174,30,09,3,2021,2021-09-30,4,2021,12471591443,118174
Agency,Department of Education,null,CFO,99.75245524349468,99.99846307073034,325262618,345,131070216160,22447012,30,09,3,2021,2021-09-30,4,2021,131395478778,22447357
Agency,Tennessee Valley Authority,null,Non-CFO,0.0,0.0,0,0,0,0,30,09,3,2021,2021-09-30,4,2021,0,0
Agency,Legislative Branch-CBO,null,Non-CFO,0.0,0.0,0,0,0,0,30,09,3,2021,2021-09-30,4,2021,0,0
Agency,Federal Deposit Insurance Corporation,null,Non-CFO,0.0,0.0,0,0,0,0,30,09,3,2021,2021-09-30,4,2021,0,0
Agency,US International Development Fin. Corp.,null,Non-CFO,0.0,0.0,0,0,0,0,30,09,3,2021,2021-09-30,4,2021,0,0
Agency,Occupational Safety & Health Rev Comm,null,Non-CFO,0.0,0.0,0,0,0,0,30,09,3,2021,2021-09-30,4,2021,0,0
Agency,Federal Labor Relations Authority,null,Non-CFO,0.0,0.0,0,0,0,0,30,09,3,2021,2021-09-30,4,2021,0,0
Agency,Export - Import  Bank,null,Non-CFO,0.0,0.0,0,0,0,0,30,09,3,2021,2021-09-30,4,2021,0,0
Agency,National Foundation  Arts & Humanities,null,Non-CFO,0.0,0.0,0,0,0,0,30,09,3,2021,2021-09-30,4,2021,0,0
Agency,Neighborhood Reinvestment Corporation,null,Non-CFO,0.0,0.0,0,0,0,0,30,09,3,2021,2021-09-30,4,2021,0,0
Agency,Merit Systems Protection Board,null,Non-CFO,100.0,100.0,0,0,144,1,30,09,3,2021,2021-09-30,4,2021,144,1
Agency,Farm Credit Administration,null,Non-CFO,100.0,100.0,0,0,630,1,30,09,3,2021,2021-09-30,4,2021,630,1
Agency,U.S. Court of Appeals / Veterans Claims,null,Non-CFO,46.579804560260584,66.66666666666667,492,1,429,2,30,09,3,2021,2021-09-30,4,2021,921,3
Agency,Other Agencies/Boards/Commissions,null,Non-CFO,0.0,0.0,1024,1,0,0,30,09,3,2021,2021-09-30,4,2021,1024,1
Agency,Legislative Branch-GAO,null,Non-CFO,100.0,100.0,0,0,29464,8,30,09,3,2021,2021-09-30,4,2021,29464,8
Agency,Legislative Branch-GPO,null,Non-CFO,100.0,100.0,0,0,75651,9,30,09,3,2021,2021-09-30,4,2021,75651,9
Bureau,Funds Appropriated to the President,Defense Security Assistance Agency,null,0.0,0.0,0,0,0,0,30,09,3,2021,2021-09-30,4,2021,0,0
Bureau,Department of Labor,Departmental Management,null,0.0,0.0,0,0,0,0,30,09,3,2021,2021-09-30,4,2021,0,0
Bureau,Selective Service System,Selective Service System,null,0.0,0.0,0,0,0,0,30,09,3,2021,2021-09-30,4,2021,0,0
Bureau,Office of Government Ethics,Office of Government Ethics,null,0.0,0.0,0,0,0,0,30,09,3,2021,2021-09-30,4,2021,0,0
Bureau,Department of the Treasury,International Monetary Funds,null,0.0,0.0,0,0,0,0,30,09,3,2021,2021-09-30,4,2021,0,0
Agency,Social Security Administration,null,CFO,62.20521396886934,35.81994464735967,1642676257,834127,2703627637,465540,30,09,3,2021,2021-09-30,4,2021,4346303894,1299667
Agency,National Labor Relations Board,null,Non-CFO,0.0,0.0,0,0,0,0,30,09,3,2021,2021-09-30,4,2021,0,0
Agency,Legislative Branch-Office of Tech.,null,Non-CFO,0.0,0.0,0,0,0,0,30,09,3,2021,2021-09-30,4,2021,0,0
Agency,Legis Branch-Library of Congress,null,Non-CFO,0.0,0.0,0,0,0,0,30,09,3,2021,2021-09-30,4,2021,0,0
Agency,Office of Special Counsel,null,Non-CFO,0.0,0.0,0,0,0,0,30,09,3,2021,2021-09-30,4,2021,0,0
Agency,Office of Government Ethics,null,Non-CFO,0.0,0.0,0,0,0,0,30,09,3,2021,2021-09-30,4,2021,0,0
Agency,Selective Service System,null,Non-CFO,0.0,0.0,0,0,0,0,30,09,3,2021,2021-09-30,4,2021,0,0
Agency,Presidio Trust Corporation,null,Non-CFO,100.0,100.0,0,0,1457939,67,30,09,3,2021,2021-09-30,4,2021,1457939,67
Agency,Pension Benefit Guaranty Corp,null,Non-CFO,100.0,100.0,0,0,3509718,1077,30,09,3,2021,2021-09-30,4,2021,3509718,1077
Agency,Corp. for National and Community Service,null,Non-CFO,79.39255796763305,12.418300653594772,930039,1072,3583083,152,30,09,3,2021,2021-09-30,4,2021,4513122,1224
Agency,Railroad Retirement Board,null,Non-CFO,100.0,100.0,0,0,21683492,4196,30,09,3,2021,2021-09-30,4,2021,21683492,4196
Agency,U.S. Postal Service,null,Non-CFO,81.97880346580601,87.38399840912103,12620369,7613,57410325,52731,30,09,3,2021,2021-09-30,4,2021,70030694,60344
Agency,Federal Communications Commission,null,Non-CFO,100.0,100.0,0,0,211614926,11336,30,09,3,2021,2021-09-30,4,2021,211614926,11336
Agency,Federal Trade Commission,null,Non-CFO,100.0,100.0,0,0,483084342,55,30,09,3,2021,2021-09-30,4,2021,483084342,55
Agency,Commodity Futures Trading Commission,null,Non-CFO,100.0,100.0,0,0,659382071,365,30,09,3,2021,2021-09-30,4,2021,659382071,365
Bureau,Legis Branch-Library of Congress,Library of Congress,null,0.0,0.0,0,0,0,0,30,09,3,2021,2021-09-30,4,2021,0,0
Bureau,Department of Justice,General Administration,null,0.0,0.0,0,0,0,0,30,09,3,2021,2021-09-30,4,2021,0,0
Bureau,Department of the Treasury,Office of Sec International Affairs,null,0.0,0.0,0,0,0,0,30,09,3,2021,2021-09-30,4,2021,0,0
Bureau,Other Agencies,National Capital Planning Commission,null,0.0,0.0,0,0,0,0,30,09,3,2021,2021-09-30,4,2021,0,0
Agency,Federal Mediation/Conciliation Service,null,Non-CFO,0.0,0.0,0,0,0,0,30,09,3,2021,2021-09-30,4,2021,0,0
Agency,Consumer Product Safety Commission,null,Non-CFO,100.0,100.0,0,0,2500,1,30,09,3,2021,2021-09-30,4,2021,2500,1
Agency,National Credit Union Administration,null,Non-CFO,0.0,0.0,2996,8,0,0,30,09,3,2021,2021-09-30,4,2021,2996,8
Agency,Smithsonian Institution,null,Non-CFO,0.0,0.0,6970,1,0,0,30,09,3,2021,2021-09-30,4,2021,6970,1
Agency,Equal Employment Opportunity Commission,null,Non-CFO,100.0,100.0,0,0,29089,16,30,09,3,2021,2021-09-30,4,2021,29089,16
Agency,Legislative Branch - U.S. House/Senate,null,Non-CFO,0.0,0.0,219316,173,0,0,30,09,3,2021,2021-09-30,4,2021,219316,173
Bureau,Legislative Branch-Office of Tech.,Open World Leadership,null,0.0,0.0,0,0,0,0,30,09,3,2021,2021-09-30,4,2021,0,0
Bureau,Funds Appropriated to the President,Peace Corps,null,0.0,0.0,0,0,0,0,30,09,3,2021,2021-09-30,4,2021,0,0
Bureau,Funds Appropriated to the President,African Development Foundation,null,0.0,0.0,0,0,0,0,30,09,3,2021,2021-09-30,4,2021,0,0
Bureau,Department of Commerce,Economic and Statistical Analysis,null,0.0,0.0,0,0,0,0,30,09,3,2021,2021-09-30,4,2021,0,0
Bureau,Department of State,International Commissions,null,0.0,0.0,0,0,0,0,30,09,3,2021,2021-09-30,4,2021,0,0
Bureau,Department of the Treasury,U.S. Treasury IG Office,null,0.0,0.0,0,0,0,0,30,09,3,2021,2021-09-30,4,2021,0,0
Bureau,National Labor Relations Board,National Labor Relations Board,null,0.0,0.0,0,0,0,0,30,09,3,2021,2021-09-30,4,2021,0,0
Bureau,Department of Transportation,Research Innovative Technology Admin,null,0.0,0.0,0,0,0,0,30,09,3,2021,2021-09-30,4,2021,0,0
Bureau,Department of Homeland Security,Management Headquarters,null,0.0,0.0,0,0,0,0,30,09,3,2021,2021-09-30,4,2021,0,0
Bureau,Department of Health & Human Services,Administration for Community Living,null,0.0,0.0,0,0,0,0,30,09,3,2021,2021-09-30,4,2021,0,0
Bureau,Department of Housing and Urban Development,"Policy, Development and Research",null,0.0,0.0,0,0,0,0,30,09,3,2021,2021-09-30,4,2021,0,0
Bureau,Federal Mediation/Conciliation Service,Federal Mediation/Conciliation Service,null,0.0,0.0,0,0,0,0,30,09,3,2021,2021-09-30,4,2021,0,0
Bureau,Other Agencies,Federal Mine Safety & Health Review Comm,null,0.0,0.0,0,0,0,0,30,09,3,2021,2021-09-30,4,2021,0,0
Bureau,Other Agencies,National Transportation Safety Board,null,0.0,0.0,0,0,0,0,30,09,3,2021,2021-09-30,4,2021,0,0
Bureau,Other Agencies/Boards/Commissions,Medicare Payment Advisory Commission,null,0.0,0.0,0,0,0,0,30,09,3,2021,2021-09-30,4,2021,0,0
Bureau,Department of the Treasury,Treasury Franchise Fund,null,0.0,0.0,0,0,0,0,30,09,3,2021,2021-09-30,4,2021,0,0
Agency,Department of Veterans Affairs,null,CFO,57.995208835866066,64.06115248921991,4308171,4584,5948209,8171,30,09,3,2021,2021-09-30,4,2021,10256380,12755
Bureau,Funds Appropriated to the President,Inter-American Foundation,null,0.0,0.0,0,0,0,0,30,09,3,2021,2021-09-30,4,2021,0,0
Bureau,Department of Justice,U.S. Marshals Service,null,0.0,0.0,0,0,0,0,30,09,3,2021,2021-09-30,4,2021,0,0
Bureau,Office of Special Counsel,Office of Special Counsel,null,0.0,0.0,0,0,0,0,30,09,3,2021,2021-09-30,4,2021,0,0
Bureau,Federal Labor Relations Authority,Federal Labor Relations Authority,null,0.0,0.0,0,0,0,0,30,09,3,2021,2021-09-30,4,2021,0,0
Bureau,Department of Homeland Security,Science and Technology,null,0.0,0.0,0,0,0,0,30,09,3,2021,2021-09-30,4,2021,0,0
Bureau,Farm Credit Administration,Farm Credit System Insurance Corporation,null,0.0,0.0,0,0,0,0,30,09,3,2021,2021-09-30,4,2021,0,0
Bureau,Department of Housing and Urban Development,Government National Mortgage Association,null,0.0,0.0,0,0,0,0,30,09,3,2021,2021-09-30,4,2021,0,0
Bureau,Occupational Safety & Health Rev Comm,Occupational Safety & Health Rev Comm,null,0.0,0.0,0,0,0,0,30,09,3,2021,2021-09-30,4,2021,0,0
Bureau,Other Agencies,U.S. Holocaust Memorial Council,null,0.0,0.0,0,0,0,0,30,09,3,2021,2021-09-30,4,2021,0,0
Bureau,Other Agencies,District of Columbia Government,null,0.0,0.0,0,0,0,0,30,09,3,2021,2021-09-30,4,2021,0,0
Bureau,Other Agencies,Denali Commission,null,0.0,0.0,0,0,0,0,30,09,3,2021,2021-09-30,4,2021,0,0
Bureau,Legislative Branch-Office of Tech.,Medicaid & CHIP Payment & Access Comm.,null,0.0,0.0,0,0,0,0,30,09,3,2021,2021-09-30,4,2021,0,0
Bureau,Department of Homeland Security,Office of Health Affairs,null,0.0,0.0,0,0,0,0,30,09,3,2021,2021-09-30,4,2021,0,0
Bureau,Department of Homeland Security,Office of Biometric Identity Management,null,0.0,0.0,0,0,0,0,30,09,3,2021,2021-09-30,4,2021,0,0
Bureau,US International Development Fin. Corp.,US International Development Fin. Corp.,null,0.0,0.0,0,0,0,0,30,09,3,2021,2021-09-30,4,2021,0,0
Bureau,Farm Credit Administration,Farm Credit Administration,null,100.0,100.0,0,0,630,1,30,09,3,2021,2021-09-30,4,2021,630,1
Bureau,National Credit Union Administration,National Credit Union Administration,null,0.0,0.0,2996,8,0,0,30,09,3,2021,2021-09-30,4,2021,2996,8
Bureau,Department of Transportation,St. Lawrence Seaway Development Corp.,null,100.0,100.0,0,0,3577,2,30,09,3,2021,2021-09-30,4,2021,3577,2
Bureau,Other Agencies,U.S.  Agency of Global Media,null,100.0,100.0,0,0,4930,2,30,09,3,2021,2021-09-30,4,2021,4930,2
Bureau,Department of the Interior,Office of the Secretary,null,100.0,100.0,0,0,27180,15,30,09,3,2021,2021-09-30,4,2021,27180,15
Bureau,Other Agencies,Architect of the Capitol,null,0.0,0.0,27849,18,0,0,30,09,3,2021,2021-09-30,4,2021,27849,18
Bureau,Equal Employment Opportunity Commission,Equal Employment Opportunity Commission,null,100.0,100.0,0,0,29089,16,30,09,3,2021,2021-09-30,4,2021,29089,16
Bureau,Department of Transportation,Office of the Secretary,null,100.0,100.0,0,0,1063578,17,30,09,3,2021,2021-09-30,4,2021,1063578,17
Bureau,Environmental Protection Agency,Environmental Protection Agency,null,100.0,100.0,0,0,24814614,240,30,09,3,2021,2021-09-30,4,2021,24814614,240
Bureau,Department of the Interior,Bureau of Indian Affairs,null,100.0,100.0,0,0,38409503,30398,30,09,3,2021,2021-09-30,4,2021,38409503,30398
Bureau,Department of Labor,Occupational Safety and Health Admin,null,94.61643722870177,85.13637195680029,3343764,812,58766852,4651,30,09,3,2021,2021-09-30,4,2021,62110616,5463
Bureau,Department of Transportation,Federal Motor Carrier Safety Admin,null,100.0,100.0,0,0,63063426,7096,30,09,3,2021,2021-09-30,4,2021,63063426,7096
Bureau,Department of Agriculture,Forest Service,null,92.11138806754029,29.506802721088434,5495300,829,64165878,347,30,09,3,2021,2021-09-30,4,2021,69661178,1176
Bureau,U.S. Postal Service,U.S. Postal Service,null,81.97880346580601,87.38399840912103,12620369,7613,57410325,52731,30,09,3,2021,2021-09-30,4,2021,70030694,60344
Bureau,Department of Homeland Security,U.S. Coast Guard,null,93.34740070371116,89.03559127439725,4996262,1337,70106142,10857,30,09,3,2021,2021-09-30,4,2021,75102404,12194
Bureau,Department of Labor,Employment Standards Administration,null,73.25041300796832,26.337865867711454,23963411,15981,65620817,5714,30,09,3,2021,2021-09-30,4,2021,89584228,21695
Bureau,Office of Compliance,Office of Compliance,null,0.0,0.0,0,0,0,0,30,09,3,2021,2021-09-30,4,2021,0,0
Bureau,Department of the Interior,"Bureau of Ocean Energy Mgmt., Reg & Enf",null,0.0,0.0,0,0,0,0,30,09,3,2021,2021-09-30,4,2021,0,0
Bureau,Department of the Treasury,Office of Financial Research,null,100.0,100.0,0,0,268,1,30,09,3,2021,2021-09-30,4,2021,268,1
Bureau,Other Agencies,Millennium Challenge Corporation,null,100.0,100.0,0,0,817,1,30,09,3,2021,2021-09-30,4,2021,817,1
Bureau,U.S. Court of Appeals / Veterans Claims,U.S. Court of Appeals / Veterans Claims,null,46.579804560260584,66.66666666666667,492,1,429,2,30,09,3,2021,2021-09-30,4,2021,921,3
Bureau,Department of the Treasury,Tobacco Tax and Trade,null,100.0,100.0,0,0,1000,1,30,09,3,2021,2021-09-30,4,2021,1000,1
Bureau,Department of Justice,Office of Justice Assistance Programs,null,100.0,100.0,0,0,1101,3,30,09,3,2021,2021-09-30,4,2021,1101,3
Bureau,Other Agencies,Federal Housing Finance Agency,null,100.0,100.0,0,0,1366,2,30,09,3,2021,2021-09-30,4,2021,1366,2
Bureau,Other Agencies,National Council on Disability,null,0.0,0.0,1579,2,0,0,30,09,3,2021,2021-09-30,4,2021,1579,2
Bureau,Consumer Product Safety Commission,Consumer Product Safety Commission,null,100.0,100.0,0,0,2500,1,30,09,3,2021,2021-09-30,4,2021,2500,1
Bureau,Other Agencies,John C. Stennis,null,0.0,0.0,2934,2,0,0,30,09,3,2021,2021-09-30,4,2021,2934,2
Bureau,Department of Commerce,General Administration,null,100.0,100.0,0,0,4660,1,30,09,3,2021,2021-09-30,4,2021,4660,1
Bureau,Other Agencies,Election Assistance Commission,null,0.0,0.0,5576,1,0,0,30,09,3,2021,2021-09-30,4,2021,5576,1
Bureau,Department of Transportation,Maritime Administration,null,100.0,100.0,0,0,6049,6,30,09,3,2021,2021-09-30,4,2021,6049,6
Bureau,Department of Transportation,Federal Highway Administration,null,100.0,100.0,0,0,6878,10,30,09,3,2021,2021-09-30,4,2021,6878,10
Bureau,Smithsonian Institution,Smithsonian Institution,null,0.0,0.0,6970,1,0,0,30,09,3,2021,2021-09-30,4,2021,6970,1
Bureau,Department of Health & Human Services,Office of the Secretary,null,100.0,100.0,0,0,8371,8,30,09,3,2021,2021-09-30,4,2021,8371,8
Bureau,Department of Labor,Bureau of Labor Statistics,null,100.0,100.0,0,0,13079,1,30,09,3,2021,2021-09-30,4,2021,13079,1
Bureau,Department of Agriculture,Federal Crop Insurance Corporation,null,55.5139791019486,98.55421686746988,6301,6,7863,409,30,09,3,2021,2021-09-30,4,2021,14164,415
Bureau,Department of Justice,Bureau of ATF and Explosives,null,100.0,100.0,0,0,20422,4,30,09,3,2021,2021-09-30,4,2021,20422,4
Bureau,Other Agencies/Boards/Commissions,U.S. Comm. on Int. Religious Freedom,null,0.0,0.0,1024,1,0,0,30,09,3,2021,2021-09-30,4,2021,1024,1
Bureau,U.S. Tax Court,U.S. Tax Court,null,0.0,0.0,0,0,0,0,30,09,3,2021,2021-09-30,4,2021,0,0
Bureau,Department of Transportation,National Highway Traffic Safety Admin.,null,100.0,100.0,0,0,30381,7,30,09,3,2021,2021-09-30,4,2021,30381,7
Bureau,Department of Homeland Security,Domestic Nuclear Detection Office,null,0.0,0.0,31397,27,0,0,30,09,3,2021,2021-09-30,4,2021,31397,27
Bureau,Other Agencies,Chemical Safety Board,null,0.0,0.0,32420,2,0,0,30,09,3,2021,2021-09-30,4,2021,32420,2
Bureau,Department of the Treasury,U.S. Mint,null,93.49004667908652,96.42857142857143,3110,1,44663,27,30,09,3,2021,2021-09-30,4,2021,47773,28
Bureau,Legislative Branch-GPO,Government Publishing Office,null,100.0,100.0,0,0,75651,9,30,09,3,2021,2021-09-30,4,2021,75651,9
Bureau,Department of the Interior,Bureau of Reclamation,null,100.0,100.0,0,0,78917,60,30,09,3,2021,2021-09-30,4,2021,78917,60
Bureau,Department of the Interior,Geological Survey,null,100.0,100.0,0,0,114600,336,30,09,3,2021,2021-09-30,4,2021,114600,336
Bureau,Armed Forces Retirement Home,Armed Forces Retirement Home,null,67.43822521493416,88.03418803418803,37912,14,78519,103,30,09,3,2021,2021-09-30,4,2021,116431,117
Bureau,National Archives & Records Admin,Nat'l Archives & Records Administration,null,100.0,100.0,0,0,117766,103,30,09,3,2021,2021-09-30,4,2021,117766,103
Bureau,Department of the Treasury,Internal Revenue Service,null,100.0,100.0,0,0,216429,79,30,09,3,2021,2021-09-30,4,2021,216429,79
Bureau,Other Agencies,James Madison Memorial Fellowship,null,0.0,0.0,221222,26,0,0,30,09,3,2021,2021-09-30,4,2021,221222,26
Bureau,Department of Housing and Urban Development,Community Planning and Development,null,100.0,100.0,0,0,234529,2,30,09,3,2021,2021-09-30,4,2021,234529,2
Bureau,Department of Justice,Drug Enforcement Administration,null,100.0,100.0,0,0,315395,22,30,09,3,2021,2021-09-30,4,2021,315395,22
Bureau,Department of Justice,Federal Bureau of Investigation,null,100.0,100.0,0,0,330597,79,30,09,3,2021,2021-09-30,4,2021,330597,79
Bureau,Other Agencies,Consumer Financial Protection Bureau,null,5.258944133508706,4.0,381040,24,21151,1,30,09,3,2021,2021-09-30,4,2021,402191,25
Bureau,Department of the Treasury,D.C. Pension Program,null,100.0,100.0,0,0,478419,22,30,09,3,2021,2021-09-30,4,2021,478419,22
Bureau,National Science Foundation,National Science Foundation,null,100.0,100.0,0,0,527228,66,30,09,3,2021,2021-09-30,4,2021,527228,66
Bureau,Department of Commerce,Patent and Trademark Office,null,100.0,100.0,0,0,557556,731,30,09,3,2021,2021-09-30,4,2021,557556,731
Bureau,Federal Election Commission,Federal Election Commission,null,100.0,100.0,0,0,1020864,164,30,09,3,2021,2021-09-30,4,2021,1020864,164
Bureau,Department of Veterans Affairs,Housing Credit Assistance,null,0.0,0.0,1037583,26,0,0,30,09,3,2021,2021-09-30,4,2021,1037583,26
Bureau,Department of Transportation,Federal Railroad Administration,null,100.0,100.0,0,0,128880,13,30,09,3,2021,2021-09-30,4,2021,128880,13
Bureau,Department of Housing and Urban Development,Public and Indian Housing Programs,null,0.3558808682483594,14.285714285714286,157916,6,564,1,30,09,3,2021,2021-09-30,4,2021,158480,7
Bureau,Legislative Branch - U.S. House/Senate,U.S. House of Representatives,null,0.0,0.0,219316,173,0,0,30,09,3,2021,2021-09-30,4,2021,219316,173
Bureau,Department of Commerce,Nat'l Telecomm & Information Admin.,null,100.0,100.0,0,0,296093,1,30,09,3,2021,2021-09-30,4,2021,296093,1
Bureau,Securities & Exchange Commission,Securities and Exchange Commission,null,100.0,100.0,0,0,298188,52,30,09,3,2021,2021-09-30,4,2021,298188,52
Bureau,Department of Housing and Urban Development,Management and Administration,null,1.301552282438214,28.571428571428573,360578,5,4755,2,30,09,3,2021,2021-09-30,4,2021,365333,7
Bureau,Department of Transportation,Pipeline Hazardous Material Safety Admin,null,100.0,100.0,0,0,397264,24,30,09,3,2021,2021-09-30,4,2021,397264,24
Bureau,Federal Maritime Commission,Salaries and Expenses,null,100.0,100.0,0,0,397392,6,30,09,3,2021,2021-09-30,4,2021,397392,6
Bureau,Department of Justice,Federal Prison System,null,100.0,100.0,0,0,610656,139,30,09,3,2021,2021-09-30,4,2021,610656,139
Bureau,Department of Justice,Federal Prison Industries,null,100.0,100.0,0,0,661956,183,30,09,3,2021,2021-09-30,4,2021,661956,183
Bureau,Department of Commerce,Nat'l Institute of Standards& Technology,null,100.0,100.0,0,0,673322,5,30,09,3,2021,2021-09-30,4,2021,673322,5
Bureau,Department of the Interior,Fish and Wildlife Service,null,100.0,100.0,0,0,747049,68,30,09,3,2021,2021-09-30,4,2021,747049,68
Bureau,Department of Transportation,Federal Transit Administration,null,100.0,100.0,0,0,783499,2,30,09,3,2021,2021-09-30,4,2021,783499,2
Bureau,Department of Agriculture,Food Safety and Inspection Service,null,92.84042353886541,94.59757442116869,63438,49,822620,858,30,09,3,2021,2021-09-30,4,2021,886058,907
Bureau,Department of Veterans Affairs,Life Insurance,null,100.0,100.0,0,0,956220,172,30,09,3,2021,2021-09-30,4,2021,956220,172
Bureau,Department of Health & Human Services,Substance Abuse & Mental Health Admin.,null,100.0,100.0,0,0,999707,14,30,09,3,2021,2021-09-30,4,2021,999707,14
Bureau,Department of Homeland Security,Citizenship and Immigration Services,null,100.0,100.0,0,0,1015474,1229,30,09,3,2021,2021-09-30,4,2021,1015474,1229
Bureau,The Judiciary,Administrative Office of the U.S. Courts,null,98.87487352318334,58.085808580858085,11965,127,1051471,176,30,09,3,2021,2021-09-30,4,2021,1063436,303
Bureau,Funds Appropriated to the President,Trade and Development Agency,null,0.0,0.0,1235225,6,0,0,30,09,3,2021,2021-09-30,4,2021,1235225,6
Bureau,Department of Veterans Affairs,Veterans Benefits,null,0.0,0.0,1294043,1699,0,0,30,09,3,2021,2021-09-30,4,2021,1294043,1699
Bureau,Department of Labor,Employment and Training Administration,null,100.0,100.0,0,0,1128283,11,30,09,3,2021,2021-09-30,4,2021,1128283,11
Bureau,National Aeronautics and Space Administration,National Aeronautics and Space Admin,null,100.0,100.0,0,0,1307058,126,30,09,3,2021,2021-09-30,4,2021,1307058,126
Bureau,Department of Veterans Affairs,Administration and Cemeteries,null,2.8913903399127587,3.026315789473684,1314131,737,39128,23,30,09,3,2021,2021-09-30,4,2021,1353259,760
Bureau,Department of the Treasury,Comptroller of the Currency,null,78.71381254564209,83.33333333333333,291191,4,1076790,20,30,09,3,2021,2021-09-30,4,2021,1367981,24
Bureau,Presidio Trust Corporation,Presidio Trust Corporation,null,100.0,100.0,0,0,1457939,67,30,09,3,2021,2021-09-30,4,2021,1457939,67
Bureau,Department of the Treasury,Financial Crimes Enforcement Network,null,100.0,100.0,0,0,1544945,3,30,09,3,2021,2021-09-30,4,2021,1544945,3
Bureau,Department of Energy,Bonneville Power Administration,null,100.0,100.0,0,0,1553703,25,30,09,3,2021,2021-09-30,4,2021,1553703,25
Bureau,Department of Commerce,Bureau of the Census,null,100.0,100.0,0,0,1841216,3599,30,09,3,2021,2021-09-30,4,2021,1841216,3599
Bureau,Department of Transportation,Federal Aviation Administration,null,93.3445061555975,61.891891891891895,129383,141,1814620,229,30,09,3,2021,2021-09-30,4,2021,1944003,370
Bureau,Department of State,Passport NSF,null,100.0,100.0,0,0,2117590,13651,30,09,3,2021,2021-09-30,4,2021,2117590,13651
Bureau,Nuclear Regulatory Commission,Nuclear Regulatory Commission,null,100.0,100.0,0,0,2940093,364,30,09,3,2021,2021-09-30,4,2021,2940093,364
Bureau,Pension Benefit Guaranty Corp,Pension Benefit Guaranty Corporation,null,100.0,100.0,0,0,3509718,1077,30,09,3,2021,2021-09-30,4,2021,3509718,1077
Bureau,Corp. for National and Community Service,Corp. for National and Community Service,null,79.39255796763305,12.418300653594772,930039,1072,3583083,152,30,09,3,2021,2021-09-30,4,2021,4513122,1224
Bureau,Department of the Treasury,Community Dev Financial Inst Fund,null,100.0,100.0,0,0,4547027,9,30,09,3,2021,2021-09-30,4,2021,4547027,9
Bureau,Department of Commerce,Economic Development Administration,null,100.0,100.0,0,0,5120584,12,30,09,3,2021,2021-09-30,4,2021,5120584,12
Bureau,Department of Veterans Affairs,Medical and Construction,null,88.20335602441554,78.98593780946722,662414,2122,4952861,7976,30,09,3,2021,2021-09-30,4,2021,5615275,10098
Bureau,Department of Agriculture,Agricultural Marketing Service,null,86.72032479510402,19.485433219825957,746486,2128,4874781,515,30,09,3,2021,2021-09-30,4,2021,5621267,2643
Bureau,Department of Health & Human Services,Program Support Center,null,100.0,100.0,0,0,6631877,338,30,09,3,2021,2021-09-30,4,2021,6631877,338
Bureau,Department of Agriculture,Food and Nutrition Service,null,0.463322554643707,0.7575757575757576,6652284,262,30965,2,30,09,3,2021,2021-09-30,4,2021,6683249,264
Bureau,Department of the Interior,Office of Surface Mining,null,100.0,100.0,0,0,7467596,382,30,09,3,2021,2021-09-30,4,2021,7467596,382
Bureau,Department of the Interior,Office of Natural Resources Revenue,null,100.0,100.0,0,0,7641800,542,30,09,3,2021,2021-09-30,4,2021,7641800,542
Bureau,Department of the Interior,National Park Service,null,100.0,100.0,0,0,8060790,2045,30,09,3,2021,2021-09-30,4,2021,8060790,2045
Bureau,Department of Homeland Security,Transportation Safety Administration,null,100.0,100.0,0,0,8175653,5504,30,09,3,2021,2021-09-30,4,2021,8175653,5504
Bureau,Department of Homeland Security,Bureau of Customs & Border Protection,null,100.0,100.0,0,0,8903750,658,30,09,3,2021,2021-09-30,4,2021,8903750,658
Bureau,Department of the Interior,Bureau of Land Management,null,100.0,100.0,0,0,8989382,253,30,09,3,2021,2021-09-30,4,2021,8989382,253
Bureau,General Services Administration,General Services Administration,null,97.01704706218388,82.24734042553192,311005,267,10115073,1237,30,09,3,2021,2021-09-30,4,2021,10426078,1504
Bureau,Department of Commerce,NOAA,null,100.0,100.0,0,0,12616105,922,30,09,3,2021,2021-09-30,4,2021,12616105,922
Bureau,Department of Energy,Energy Consolidated Reports,null,100.0,100.0,0,0,12837411,65,30,09,3,2021,2021-09-30,4,2021,12837411,65
Bureau,Department of Health & Human Services,Centers for Disease Control,null,1.2190421276330978,16.9811320754717,12780226,88,157719,18,30,09,3,2021,2021-09-30,4,2021,12937945,106
Bureau,Department of the Treasury,Bureau of the Fiscal Service,null,100.0,100.0,0,0,13848587,3674,30,09,3,2021,2021-09-30,4,2021,13848587,3674
Bureau,Department of Homeland Security,Immigration and Customs Enforcement,null,100.0,100.0,0,0,14003158,595,30,09,3,2021,2021-09-30,4,2021,14003158,595
Bureau,Department of Health & Human Services,National Institutes of Health,null,34.30280861435768,20.625,11231084,381,5864143,99,30,09,3,2021,2021-09-30,4,2021,17095227,480
Bureau,Department of State,Department of State,null,97.47617003311319,97.05090032610237,439505,208,16974703,6845,30,09,3,2021,2021-09-30,4,2021,17414208,7053
Bureau,Department of Labor,Employee Benefit Security Administration,null,100.0,100.0,0,0,17641527,406,30,09,3,2021,2021-09-30,4,2021,17641527,406
Bureau,Department of Agriculture,U.S. Department of Agriculture,null,79.61794898194528,51.563025210084035,4246316,1441,16587289,1534,30,09,3,2021,2021-09-30,4,2021,20833605,2975
Bureau,Railroad Retirement Board,Railroad Retirement Board,null,100.0,100.0,0,0,21683492,4196,30,09,3,2021,2021-09-30,4,2021,21683492,4196
Bureau,Department of the Treasury,Departmental Offices,null,96.39183114231746,97.99107142857143,827850,27,22115921,1317,30,09,3,2021,2021-09-30,4,2021,22943771,1344
Bureau,Department of Labor,Mine Safety and Health Administration,null,79.19566519874142,72.50290735237111,4863379,2128,18513379,5611,30,09,3,2021,2021-09-30,4,2021,23376758,7739
Bureau,Office of Personnel Management,Office of Personnel Management,null,90.83676946871138,87.66233766233766,2208360,171,21891874,1215,30,09,3,2021,2021-09-30,4,2021,24100234,1386
Bureau,Department of Health & Human Services,Administration for Children and Families,null,100.0,100.0,0,0,31058043,1796,30,09,3,2021,2021-09-30,4,2021,31058043,1796
Bureau,Department of Commerce,Bureau of Industry and Security,null,100.0,100.0,0,0,35739949,27,30,09,3,2021,2021-09-30,4,2021,35739949,27
Bureau,Agency for International Development,Agency for International Development,null,100.0,100.0,0,0,38171581,52,30,09,3,2021,2021-09-30,4,2021,38171581,52
Bureau,Department of Justice,Legal Activities,null,95.91896803933055,98.945347430435,3738991,401,87879772,37621,30,09,3,2021,2021-09-30,4,2021,91618763,38022
Bureau,Department of Health & Human Services,Health Resources and Services Admin,null,100.0,100.0,0,0,106511465,644,30,09,3,2021,2021-09-30,4,2021,106511465,644
Bureau,Department of Health & Human Services,Food and Drug Administration,null,29.23677099467199,6.352848619943618,79947292,14284,33031289,969,30,09,3,2021,2021-09-30,4,2021,112978581,15253
Bureau,Department of Education,Departmental Management,null,73.57530104715033,84.23217550274224,325262618,345,905641161,1843,30,09,3,2021,2021-09-30,4,2021,1230903779,2188
Bureau,Department of Defense,Consolidated Report,null,38.7685414820526,14.885959962646215,1598525239,1464679,1012102170,256164,30,09,3,2021,2021-09-30,4,2021,2610627409,1720843
Bureau,Social Security Administration,Social Security Administration,null,62.20521396886934,35.81994464735967,1642676257,834127,2703627637,465540,30,09,3,2021,2021-09-30,4,2021,4346303894,1299667
Bureau,Department of Health & Human Services,Centers for Medicare & Medicaid Services,null,99.15826905035262,99.38714303202,78328096,7009,9227269617,1136651,30,09,3,2021,2021-09-30,4,2021,9305597713,1143660
Bureau,Federal Communications Commission,Federal Communications Commission,null,100.0,100.0,0,0,211614926,11336,30,09,3,2021,2021-09-30,4,2021,211614926,11336
Bureau,Department of Homeland Security,Emergency Preparedness & Resp,null,100.0,100.0,0,0,215503062,41018,30,09,3,2021,2021-09-30,4,2021,215503062,41018
Bureau,Small Business Administration,Small Business Administration,null,100.0,100.0,0,0,12471591443,118174,30,09,3,2021,2021-09-30,4,2021,12471591443,118174
Bureau,Department of Education,Federal Student Aid,null,100.0,100.0,0,0,130164574999,22445169,30,09,3,2021,2021-09-30,4,2021,130164574999,22445169
Bureau,Department of Housing and Urban Development,Housing Programs,null,99.9891394101163,99.97854077253218,15131,1,139305110,4659,30,09,3,2021,2021-09-30,4,2021,139320241,4660
Bureau,Federal Trade Commission,Federal Trade Commission,null,100.0,100.0,0,0,483084342,55,30,09,3,2021,2021-09-30,4,2021,483084342,55
Bureau,Commodity Futures Trading Commission,Commodity Futures Trading Commission,null,100.0,100.0,0,0,659382071,365,30,09,3,2021,2021-09-30,4,2021,659382071,365
Bureau,Department of Agriculture,Rural Development,null,99.99284846582017,99.74631176332839,52044,65,727679918,25557,30,09,3,2021,2021-09-30,4,2021,727731962,25622
Bureau,Department of Agriculture,Farm Service Agency,null,100.0,100.0,0,0,794476421,13726,30,09,3,2021,2021-09-30,4,2021,794476421,13726
Bureau,Securities & Exchange Commission,SEC Enforcement,null,100.0,100.0,0,0,2001391662,1035,30,09,3,2021,2021-09-30,4,2021,2001391662,1035
Bureau,Department of the Treasury,Comptroller of the Currency,null,96.31733199471275,80.76923076923077,50400,5,1318173,21,31,12,4,2021,2021-12-31,1,2022,1368573,26
Bureau,Other Agencies,Chemical Safety Board,null,100.0,100.0,0,0,33019,2,31,12,4,2021,2021-12-31,1,2022,33019,2
Bureau,Department of Health & Human Services,Program Support Center,null,100.0,100.0,0,0,6707558,327,31,12,4,2021,2021-12-31,1,2022,6707558,327
Bureau,Department of Energy,Bonneville Power Administration,null,100.0,100.0,0,0,1368925,25,31,12,4,2021,2021-12-31,1,2022,1368925,25
Bureau,Department of Homeland Security,Federal Law Enforcement Training Ctr.,null,100.0,100.0,0,0,1632,2,31,12,4,2021,2021-12-31,1,2022,1632,2
Bureau,Occupational Safety & Health Rev Comm,Occupational Safety & Health Rev Comm,null,0.0,0.0,0,0,0,0,31,12,4,2021,2021-12-31,1,2022,0,0
Bureau,Funds Appropriated to the President,Peace Corps,null,0.0,0.0,0,0,0,0,31,12,4,2021,2021-12-31,1,2022,0,0
Bureau,U.S. Tax Court,U.S. Tax Court,null,0.0,0.0,0,0,0,0,31,12,4,2021,2021-12-31,1,2022,0,0
Bureau,Department of the Treasury,Office of Sec International Affairs,null,0.0,0.0,0,0,0,0,31,12,4,2021,2021-12-31,1,2022,0,0
Bureau,Other Agencies,National Council on Disability,null,0.0,0.0,1579,2,0,0,31,12,4,2021,2021-12-31,1,2022,1579,2
Bureau,Department of Homeland Security,Office of Health Affairs,null,0.0,0.0,0,0,0,0,31,12,4,2021,2021-12-31,1,2022,0,0
Bureau,Department of Homeland Security,Office of the Inspector General DHS,null,100.0,100.0,0,0,100,1,31,12,4,2021,2021-12-31,1,2022,100,1
Bureau,Department of Transportation,Office of the Inspector General,null,100.0,100.0,0,0,217,1,31,12,4,2021,2021-12-31,1,2022,217,1
Bureau,Department of the Treasury,Office of Financial Research,null,100.0,100.0,0,0,268,1,31,12,4,2021,2021-12-31,1,2022,268,1
Bureau,Farm Credit Administration,Farm Credit Administration,null,100.0,100.0,0,0,630,1,31,12,4,2021,2021-12-31,1,2022,630,1
Bureau,U.S. Court of Appeals / Veterans Claims,U.S. Court of Appeals / Veterans Claims,null,46.481876332622605,66.66666666666667,502,1,436,2,31,12,4,2021,2021-12-31,1,2022,938,3
Bureau,Department of the Treasury,Tobacco Tax and Trade,null,100.0,100.0,0,0,1000,1,31,12,4,2021,2021-12-31,1,2022,1000,1
Bureau,Other Agencies/Boards/Commissions,U.S. Comm. on Int. Religious Freedom,null,0.0,0.0,1024,1,0,0,31,12,4,2021,2021-12-31,1,2022,1024,1
Bureau,Office of Compliance,Office of Compliance,null,0.0,0.0,0,0,0,0,31,12,4,2021,2021-12-31,1,2022,0,0
Bureau,Department of Housing and Urban Development,Government National Mortgage Association,null,0.0,0.0,0,0,0,0,31,12,4,2021,2021-12-31,1,2022,0,0
Bureau,Other Agencies,Gulf Coast Ecosystem Restoration Council,null,0.0,0.0,0,0,0,0,31,12,4,2021,2021-12-31,1,2022,0,0
Bureau,Other Agencies,Federal Housing Finance Agency OIG,null,0.0,0.0,0,0,0,0,31,12,4,2021,2021-12-31,1,2022,0,0
Bureau,National Foundation  Arts & Humanities,National Endowment for the Humanities,null,0.0,0.0,0,0,0,0,31,12,4,2021,2021-12-31,1,2022,0,0
Agency,Environmental Protection Agency,null,CFO,99.28438082529762,99.2156862745098,182201,2,25278408,253,31,12,4,2021,2021-12-31,1,2022,25460609,255
Agency,Department of Housing and Urban Development,null,CFO,99.2933927035416,99.57707760625925,1010819,20,142041624,4709,31,12,4,2021,2021-12-31,1,2022,143052443,4729
Agency,Tennessee Valley Authority,null,Non-CFO,0.0,0.0,0,0,0,0,31,12,4,2021,2021-12-31,1,2022,0,0
Bureau,Department of Homeland Security,Management Headquarters,null,0.0,0.0,0,0,0,0,31,12,4,2021,2021-12-31,1,2022,0,0
Bureau,Department of Housing and Urban Development,"Policy, Development and Research",null,0.0,0.0,0,0,0,0,31,12,4,2021,2021-12-31,1,2022,0,0
Agency,Department of Labor,null,CFO,83.50334280694858,41.04326181650929,32625319,21791,165143954,15170,31,12,4,2021,2021-12-31,1,2022,197769273,36961
Bureau,Department of Commerce,Office of the Inspector General,null,0.0,0.0,0,0,0,0,31,12,4,2021,2021-12-31,1,2022,0,0
Agency,Department of State,null,CFO,60.483227650722,99.6276437295204,11637367,75,17811817,20067,31,12,4,2021,2021-12-31,1,2022,29449184,20142
Agency,Department of the Interior,null,CFO,99.96889448362003,99.89453280884784,22188,37,71309211,35045,31,12,4,2021,2021-12-31,1,2022,71331399,35082
Agency,Department of Veterans Affairs,null,CFO,97.93812149514527,99.79583630194591,4133120,4605,196320980,2250938,31,12,4,2021,2021-12-31,1,2022,200454100,2255543
Agency,Department of Homeland Security,null,CFO,99.98987521000734,99.95284964931926,28599,24,282436519,50877,31,12,4,2021,2021-12-31,1,2022,282465118,50901
Bureau,Smithsonian Institution,National Gallery of Art,null,0.0,0.0,0,0,0,0,31,12,4,2021,2021-12-31,1,2022,0,0
Bureau,Other Agencies/Boards/Commissions,U.S.-China Security Review Commission,null,0.0,0.0,0,0,0,0,31,12,4,2021,2021-12-31,1,2022,0,0
Bureau,Department of Transportation,Research Innovative Technology Admin,null,0.0,0.0,0,0,0,0,31,12,4,2021,2021-12-31,1,2022,0,0
Bureau,Department of the Treasury,International Monetary Funds,null,0.0,0.0,0,0,0,0,31,12,4,2021,2021-12-31,1,2022,0,0
Bureau,Legislative Branch-Office of Tech.,Medicaid & CHIP Payment & Access Comm.,null,0.0,0.0,0,0,0,0,31,12,4,2021,2021-12-31,1,2022,0,0
Bureau,Department of Health & Human Services,Office of the Inspector General,null,0.0,0.0,0,0,0,0,31,12,4,2021,2021-12-31,1,2022,0,0
Bureau,Other Agencies,Delta Regional Authority,null,0.0,0.0,0,0,0,0,31,12,4,2021,2021-12-31,1,2022,0,0
Agency,National Science Foundation,null,CFO,100.0,100.0,0,0,595663,68,31,12,4,2021,2021-12-31,1,2022,595663,68
Agency,Department of Energy,null,CFO,100.0,100.0,0,0,14108003,93,31,12,4,2021,2021-12-31,1,2022,14108003,93
Agency,Office of Personnel Management,null,CFO,99.33565605054038,98.62012987012987,146408,17,21891574,1215,31,12,4,2021,2021-12-31,1,2022,22037982,1232
Agency,Department of Transportation,null,CFO,99.9590554561559,99.7546681204852,27753,18,67754172,7319,31,12,4,2021,2021-12-31,1,2022,67781925,7337
Agency,Department of Justice,null,CFO,96.5324015365694,99.1853677519782,3239622,314,90185901,38231,31,12,4,2021,2021-12-31,1,2022,93425523,38545
Agency,Export - Import  Bank,null,Non-CFO,0.0,0.0,0,0,0,0,31,12,4,2021,2021-12-31,1,2022,0,0
Agency,Federal Deposit Insurance Corporation,null,Non-CFO,0.0,0.0,0,0,0,0,31,12,4,2021,2021-12-31,1,2022,0,0
Agency,American Battle Monuments Commission,null,Non-CFO,0.0,0.0,0,0,0,0,31,12,4,2021,2021-12-31,1,2022,0,0
Agency,Selective Service System,null,Non-CFO,0.0,0.0,0,0,0,0,31,12,4,2021,2021-12-31,1,2022,0,0
Agency,National Labor Relations Board,null,Non-CFO,0.0,0.0,0,0,0,0,31,12,4,2021,2021-12-31,1,2022,0,0
Agency,Neighborhood Reinvestment Corporation,null,Non-CFO,0.0,0.0,0,0,0,0,31,12,4,2021,2021-12-31,1,2022,0,0
Agency,Federal Labor Relations Authority,null,Non-CFO,0.0,0.0,0,0,0,0,31,12,4,2021,2021-12-31,1,2022,0,0
Agency,Equal Employment Opportunity Commission,null,Non-CFO,100.0,100.0,0,0,17338,14,31,12,4,2021,2021-12-31,1,2022,17338,14
Bureau,Department of the Treasury,Interest on Tax/Deposit of Earnings,null,0.0,0.0,0,0,0,0,31,12,4,2021,2021-12-31,1,2022,0,0
Bureau,Smithsonian Institution,JFK Center for the Performing Arts,null,0.0,0.0,0,0,0,0,31,12,4,2021,2021-12-31,1,2022,0,0
Bureau,Federal Deposit Insurance Corporation,Federal Deposit Insurance Corporation,null,0.0,0.0,0,0,0,0,31,12,4,2021,2021-12-31,1,2022,0,0
Bureau,Department of Homeland Security,U.S. Coast Guard,null,0.0,0.0,0,0,0,0,31,12,4,2021,2021-12-31,1,2022,0,0
Bureau,Department of Homeland Security,Science and Technology,null,0.0,0.0,0,0,0,0,31,12,4,2021,2021-12-31,1,2022,0,0
Bureau,Farm Credit Administration,Farm Credit System Insurance Corporation,null,0.0,0.0,0,0,0,0,31,12,4,2021,2021-12-31,1,2022,0,0
Bureau,Other Agencies,Federal Mine Safety & Health Review Comm,null,0.0,0.0,0,0,0,0,31,12,4,2021,2021-12-31,1,2022,0,0
Bureau,Other Agencies,Commission On Fine Arts,null,0.0,0.0,0,0,0,0,31,12,4,2021,2021-12-31,1,2022,0,0
Bureau,US International Development Fin. Corp.,US International Development Fin. Corp.,null,0.0,0.0,0,0,0,0,31,12,4,2021,2021-12-31,1,2022,0,0
Bureau,Other Agencies,Privacy & Civil Liberties Oversight Bd,null,0.0,0.0,0,0,0,0,31,12,4,2021,2021-12-31,1,2022,0,0
Agency,Nuclear Regulatory Commission,null,CFO,100.0,100.0,0,0,2936862,375,31,12,4,2021,2021-12-31,1,2022,2936862,375
Agency,Department of Defense,null,CFO,34.5676328440524,17.704632416696167,1924174584,1215826,1016533001,261567,31,12,4,2021,2021-12-31,1,2022,2940707585,1477393
Agency,Department of Health & Human Services,null,CFO,98.09879832145242,97.85644877485096,184477786,24486,9518742450,1117824,31,12,4,2021,2021-12-31,1,2022,9703220236,1142310
Agency,Small Business Administration,null,CFO,100.0,100.0,0,0,12469486128,117869,31,12,4,2021,2021-12-31,1,2022,12469486128,117869
Agency,Department of Education,null,CFO,99.93897207864646,99.99904976774216,79749725,212,130597689767,22310123,31,12,4,2021,2021-12-31,1,2022,130677439492,22310335
Agency,Legislative Branch-CBO,null,Non-CFO,0.0,0.0,0,0,0,0,31,12,4,2021,2021-12-31,1,2022,0,0
Agency,Smithsonian Institution,null,Non-CFO,0.0,0.0,0,0,0,0,31,12,4,2021,2021-12-31,1,2022,0,0
Agency,Office of Special Counsel,null,Non-CFO,0.0,0.0,0,0,0,0,31,12,4,2021,2021-12-31,1,2022,0,0
Agency,Legislative Branch-GAO,null,Non-CFO,0.0,0.0,0,0,0,0,31,12,4,2021,2021-12-31,1,2022,0,0
Agency,US International Development Fin. Corp.,null,Non-CFO,0.0,0.0,0,0,0,0,31,12,4,2021,2021-12-31,1,2022,0,0
Agency,Office of Government Ethics,null,Non-CFO,0.0,0.0,0,0,0,0,31,12,4,2021,2021-12-31,1,2022,0,0
Agency,Federal Mediation/Conciliation Service,null,Non-CFO,0.0,0.0,0,0,0,0,31,12,4,2021,2021-12-31,1,2022,0,0
Agency,National Foundation  Arts & Humanities,null,Non-CFO,0.0,0.0,0,0,0,0,31,12,4,2021,2021-12-31,1,2022,0,0
Agency,Office of Compliance,null,Non-CFO,0.0,0.0,0,0,0,0,31,12,4,2021,2021-12-31,1,2022,0,0
Bureau,Legis Branch-Library of Congress,Library of Congress,null,0.0,0.0,0,0,0,0,31,12,4,2021,2021-12-31,1,2022,0,0
Bureau,Department of State,International Commissions,null,0.0,0.0,0,0,0,0,31,12,4,2021,2021-12-31,1,2022,0,0
Bureau,American Battle Monuments Commission,American Battle Monuments Commission,null,0.0,0.0,0,0,0,0,31,12,4,2021,2021-12-31,1,2022,0,0
Agency,National Aeronautics and Space Administration,null,CFO,100.0,100.0,0,0,1558326,126,31,12,4,2021,2021-12-31,1,2022,1558326,126
Agency,General Services Administration,null,CFO,71.57393339243401,40.28722600151172,2961856,790,7457651,533,31,12,4,2021,2021-12-31,1,2022,10419507,1323
Agency,Legis Branch-Library of Congress,null,Non-CFO,0.0,0.0,0,0,0,0,31,12,4,2021,2021-12-31,1,2022,0,0
Agency,U.S. Tax Court,null,Non-CFO,0.0,0.0,0,0,0,0,31,12,4,2021,2021-12-31,1,2022,0,0
Agency,Occupational Safety & Health Rev Comm,null,Non-CFO,0.0,0.0,0,0,0,0,31,12,4,2021,2021-12-31,1,2022,0,0
Bureau,Funds Appropriated to the President,African Development Foundation,null,0.0,0.0,0,0,0,0,31,12,4,2021,2021-12-31,1,2022,0,0
Bureau,Department of Commerce,International Trade Administration,null,0.0,0.0,0,0,0,0,31,12,4,2021,2021-12-31,1,2022,0,0
Bureau,Department of the Treasury,Office of the Secretary,null,0.0,0.0,0,0,0,0,31,12,4,2021,2021-12-31,1,2022,0,0
Bureau,National Foundation  Arts & Humanities,National Endowment for the Arts,null,0.0,0.0,0,0,0,0,31,12,4,2021,2021-12-31,1,2022,0,0
Bureau,Department of Homeland Security,Info Analysis Infrastructure Prot-NPPD,null,0.0,0.0,0,0,0,0,31,12,4,2021,2021-12-31,1,2022,0,0
Bureau,Neighborhood Reinvestment Corporation,Neighborhood Reinvestment Corporation,null,0.0,0.0,0,0,0,0,31,12,4,2021,2021-12-31,1,2022,0,0
Bureau,Selective Service System,Selective Service System,null,0.0,0.0,0,0,0,0,31,12,4,2021,2021-12-31,1,2022,0,0
Bureau,Other Agencies,U.S. Institute of Peace,null,0.0,0.0,0,0,0,0,31,12,4,2021,2021-12-31,1,2022,0,0
Bureau,Other Agencies,Defense Nuclear Facilities Safety Board,null,0.0,0.0,0,0,0,0,31,12,4,2021,2021-12-31,1,2022,0,0
Bureau,Other Agencies,Federal Housing Finance Agency,null,0.0,0.0,0,0,0,0,31,12,4,2021,2021-12-31,1,2022,0,0
Bureau,Other Agencies,Denali Commission,null,0.0,0.0,0,0,0,0,31,12,4,2021,2021-12-31,1,2022,0,0
Bureau,Department of the Interior,Bureau of Safety and Environmental Enf.,null,0.0,0.0,0,0,0,0,31,12,4,2021,2021-12-31,1,2022,0,0
Bureau,Other Agencies/Boards/Commissions,Medicare Payment Advisory Commission,null,0.0,0.0,0,0,0,0,31,12,4,2021,2021-12-31,1,2022,0,0
Agency,Department of Commerce,null,CFO,100.0,100.0,0,0,57799410,6429,31,12,4,2021,2021-12-31,1,2022,57799410,6429
Agency,Merit Systems Protection Board,null,Non-CFO,100.0,100.0,0,0,144,1,31,12,4,2021,2021-12-31,1,2022,144,1
Agency,Farm Credit Administration,null,Non-CFO,100.0,100.0,0,0,630,1,31,12,4,2021,2021-12-31,1,2022,630,1
Agency,U.S. Court of Appeals / Veterans Claims,null,Non-CFO,46.481876332622605,66.66666666666667,502,1,436,2,31,12,4,2021,2021-12-31,1,2022,938,3
Agency,Other Agencies/Boards/Commissions,null,Non-CFO,0.0,0.0,1024,1,0,0,31,12,4,2021,2021-12-31,1,2022,1024,1
Agency,Consumer Product Safety Commission,null,Non-CFO,100.0,100.0,0,0,2500,1,31,12,4,2021,2021-12-31,1,2022,2500,1
Agency,National Credit Union Administration,null,Non-CFO,0.0,0.0,2996,8,0,0,31,12,4,2021,2021-12-31,1,2022,2996,8
Agency,Other Agencies,null,Non-CFO,8.666540554570611,6.172839506172839,622833,76,59100,5,31,12,4,2021,2021-12-31,1,2022,681933,81
Agency,The Judiciary,null,Non-CFO,98.86456052846096,57.525083612040135,11965,127,1041812,172,31,12,4,2021,2021-12-31,1,2022,1053777,299
Agency,Federal Election Commission,null,Non-CFO,100.0,100.0,0,0,1149832,173,31,12,4,2021,2021-12-31,1,2022,1149832,173
Agency,Funds Appropriated to the President,null,Non-CFO,0.0,0.0,1236060,7,0,0,31,12,4,2021,2021-12-31,1,2022,1236060,7
Bureau,Funds Appropriated to the President,Executive Branch,null,0.0,0.0,0,0,0,0,31,12,4,2021,2021-12-31,1,2022,0,0
Bureau,Department of Commerce,Minority Business Development Agency,null,0.0,0.0,0,0,0,0,31,12,4,2021,2021-12-31,1,2022,0,0
Bureau,Department of Justice,Federal Prison System,null,0.0,0.0,0,0,0,0,31,12,4,2021,2021-12-31,1,2022,0,0
Bureau,National Labor Relations Board,National Labor Relations Board,null,0.0,0.0,0,0,0,0,31,12,4,2021,2021-12-31,1,2022,0,0
Bureau,Other Agencies,Advisory Council on Hist. Preservation,null,0.0,0.0,0,0,0,0,31,12,4,2021,2021-12-31,1,2022,0,0
Agency,Agency for International Development,null,CFO,100.0,100.0,0,0,39929663,54,31,12,4,2021,2021-12-31,1,2022,39929663,54
Agency,Social Security Administration,null,CFO,60.688062278458496,34.6154828896424,1739704923,870043,2685680911,460613,31,12,4,2021,2021-12-31,1,2022,4425385834,1330656
Agency,Legislative Branch-GPO,null,Non-CFO,100.0,100.0,0,0,75651,9,31,12,4,2021,2021-12-31,1,2022,75651,9
Agency,Presidio Trust Corporation,null,Non-CFO,100.0,100.0,0,0,1469218,66,31,12,4,2021,2021-12-31,1,2022,1469218,66
Agency,Pension Benefit Guaranty Corp,null,Non-CFO,100.0,100.0,0,0,2595015,745,31,12,4,2021,2021-12-31,1,2022,2595015,745
Agency,Federal Trade Commission,null,Non-CFO,100.0,100.0,0,0,482181306,54,31,12,4,2021,2021-12-31,1,2022,482181306,54
Agency,Commodity Futures Trading Commission,null,Non-CFO,100.0,100.0,0,0,661847583,365,31,12,4,2021,2021-12-31,1,2022,661847583,365
Agency,Securities & Exchange Commission,null,Non-CFO,100.0,100.0,0,0,2026158381,1078,31,12,4,2021,2021-12-31,1,2022,2026158381,1078
Bureau,Funds Appropriated to the President,Inter-American Foundation,null,0.0,0.0,0,0,0,0,31,12,4,2021,2021-12-31,1,2022,0,0
Bureau,Department of Commerce,Economic and Statistical Analysis,null,0.0,0.0,0,0,0,0,31,12,4,2021,2021-12-31,1,2022,0,0
Bureau,Department of Justice,U.S. Marshals Service,null,0.0,0.0,0,0,0,0,31,12,4,2021,2021-12-31,1,2022,0,0
Bureau,Department of Labor,Departmental Management,null,0.0,0.0,0,0,0,0,31,12,4,2021,2021-12-31,1,2022,0,0
Bureau,Department of State,Civil Monetary Penalties,null,0.0,0.0,0,0,0,0,31,12,4,2021,2021-12-31,1,2022,0,0
Bureau,Department of the Treasury,U.S. Treasury IG Office,null,0.0,0.0,0,0,0,0,31,12,4,2021,2021-12-31,1,2022,0,0
Bureau,Department of the Treasury,Treasury Forfeiture Fund,null,0.0,0.0,0,0,0,0,31,12,4,2021,2021-12-31,1,2022,0,0
Bureau,Office of Special Counsel,Office of Special Counsel,null,0.0,0.0,0,0,0,0,31,12,4,2021,2021-12-31,1,2022,0,0
Bureau,Federal Labor Relations Authority,Federal Labor Relations Authority,null,0.0,0.0,0,0,0,0,31,12,4,2021,2021-12-31,1,2022,0,0
Bureau,Department of Health & Human Services,Administration for Community Living,null,0.0,0.0,0,0,0,0,31,12,4,2021,2021-12-31,1,2022,0,0
Bureau,Export - Import  Bank,Export-Import Bank,null,0.0,0.0,0,0,0,0,31,12,4,2021,2021-12-31,1,2022,0,0
Bureau,Other Agencies,District of Columbia Government,null,0.0,0.0,0,0,0,0,31,12,4,2021,2021-12-31,1,2022,0,0
Bureau,Other Agencies,Archit.&Trans. Barriers Compliance Bd,null,0.0,0.0,0,0,0,0,31,12,4,2021,2021-12-31,1,2022,0,0
Bureau,Smithsonian Institution,Administrative Conference of the US,null,0.0,0.0,0,0,0,0,31,12,4,2021,2021-12-31,1,2022,0,0
Bureau,Other Agencies,National Mediation Board,null,0.0,0.0,0,0,0,0,31,12,4,2021,2021-12-31,1,2022,0,0
Agency,Department of the Treasury,null,CFO,97.56914063131545,97.80952380952381,1093076,115,43873573,5135,31,12,4,2021,2021-12-31,1,2022,44966649,5250
Agency,Department of Agriculture,null,CFO,98.74151368696083,91.18672809880336,22409873,5509,1758290701,56999,31,12,4,2021,2021-12-31,1,2022,1780700574,62508
Agency,Legislative Branch-Office of Tech.,null,Non-CFO,0.0,0.0,0,0,0,0,31,12,4,2021,2021-12-31,1,2022,0,0
Agency,Armed Forces Retirement Home,null,Non-CFO,67.25086856317292,85.12396694214875,38082,18,78202,103,31,12,4,2021,2021-12-31,1,2022,116284,121
Agency,National Archives & Records Admin,null,Non-CFO,100.0,100.0,0,0,119017,105,31,12,4,2021,2021-12-31,1,2022,119017,105
Agency,Legislative Branch - U.S. House/Senate,null,Non-CFO,0.0,0.0,218320,178,0,0,31,12,4,2021,2021-12-31,1,2022,218320,178
Agency,Federal Maritime Commission,null,Non-CFO,100.0,100.0,0,0,397461,6,31,12,4,2021,2021-12-31,1,2022,397461,6
Agency,Corp. for National and Community Service,null,Non-CFO,78.9373389078323,12.366912366912366,955531,1070,3581080,151,31,12,4,2021,2021-12-31,1,2022,4536611,1221
Agency,Railroad Retirement Board,null,Non-CFO,100.0,100.0,0,0,21563120,4161,31,12,4,2021,2021-12-31,1,2022,21563120,4161
Agency,U.S. Postal Service,null,Non-CFO,72.42396253935804,81.31377551020408,20314343,11720,53352307,51000,31,12,4,2021,2021-12-31,1,2022,73666650,62720
Agency,Federal Communications Commission,null,Non-CFO,100.0,100.0,0,0,222106532,13231,31,12,4,2021,2021-12-31,1,2022,222106532,13231
Bureau,Legislative Branch-GAO,Government Accountability Office,null,0.0,0.0,0,0,0,0,31,12,4,2021,2021-12-31,1,2022,0,0
Bureau,Legislative Branch-CBO,Congressional Budget Office,null,0.0,0.0,0,0,0,0,31,12,4,2021,2021-12-31,1,2022,0,0
Bureau,Funds Appropriated to the President,Defense Security Assistance Agency,null,0.0,0.0,0,0,0,0,31,12,4,2021,2021-12-31,1,2022,0,0
Bureau,Department of Justice,General Administration,null,0.0,0.0,0,0,0,0,31,12,4,2021,2021-12-31,1,2022,0,0
Bureau,Smithsonian Institution,Smithsonian Institution,null,0.0,0.0,0,0,0,0,31,12,4,2021,2021-12-31,1,2022,0,0
Bureau,Department of Homeland Security,U.S. Secret Service,null,0.0,0.0,0,0,0,0,31,12,4,2021,2021-12-31,1,2022,0,0
Bureau,Other Agencies,U.S. Holocaust Memorial Council,null,0.0,0.0,0,0,0,0,31,12,4,2021,2021-12-31,1,2022,0,0
Bureau,Other Agencies,National Transportation Safety Board,null,0.0,0.0,0,0,0,0,31,12,4,2021,2021-12-31,1,2022,0,0
Bureau,Other Agencies,Comm. for Purchase from Blind/Handic.,null,0.0,0.0,0,0,0,0,31,12,4,2021,2021-12-31,1,2022,0,0
Bureau,Other Agencies,National Capital Planning Commission,null,0.0,0.0,0,0,0,0,31,12,4,2021,2021-12-31,1,2022,0,0
Bureau,Department of Homeland Security,Office of Biometric Identity Management,null,0.0,0.0,0,0,0,0,31,12,4,2021,2021-12-31,1,2022,0,0
Bureau,Other Agencies,Surface Transportation Board,null,0.0,0.0,0,0,0,0,31,12,4,2021,2021-12-31,1,2022,0,0
Bureau,Department of Commerce,National Technical Information Service,null,0.0,0.0,0,0,0,0,31,12,4,2021,2021-12-31,1,2022,0,0
Bureau,Department of the Treasury,Bureau of Engraving and Printing,null,0.0,0.0,0,0,0,0,31,12,4,2021,2021-12-31,1,2022,0,0
Bureau,Other Agencies/Boards/Commissions,Nuclear Waste Technical Review Board,null,0.0,0.0,0,0,0,0,31,12,4,2021,2021-12-31,1,2022,0,0
Bureau,Tennessee Valley Authority,Tennessee Valley Authority,null,0.0,0.0,0,0,0,0,31,12,4,2021,2021-12-31,1,2022,0,0
Bureau,Department of Education,Office of Postsecondary Education,null,0.0,0.0,0,0,0,0,31,12,4,2021,2021-12-31,1,2022,0,0
Bureau,Federal Mediation/Conciliation Service,Federal Mediation/Conciliation Service,null,0.0,0.0,0,0,0,0,31,12,4,2021,2021-12-31,1,2022,0,0
Bureau,Other Agencies,Morris K. Udall Scholarship,null,0.0,0.0,0,0,0,0,31,12,4,2021,2021-12-31,1,2022,0,0
Bureau,Other Agencies,Millennium Challenge Corporation,null,0.0,0.0,0,0,0,0,31,12,4,2021,2021-12-31,1,2022,0,0
Bureau,Office of Government Ethics,Office of Government Ethics,null,0.0,0.0,0,0,0,0,31,12,4,2021,2021-12-31,1,2022,0,0
Bureau,Department of the Interior,"Bureau of Ocean Energy Mgmt., Reg & Enf",null,0.0,0.0,932,1,0,0,31,12,4,2021,2021-12-31,1,2022,932,1
Bureau,Legislative Branch-Office of Tech.,Open World Leadership,null,0.0,0.0,0,0,0,0,31,12,4,2021,2021-12-31,1,2022,0,0
Bureau,Department of the Treasury,Treasury IG for Tax Admin,null,100.0,100.0,0,0,182,1,31,12,4,2021,2021-12-31,1,2022,182,1
Bureau,Consumer Product Safety Commission,Consumer Product Safety Commission,null,100.0,100.0,0,0,2500,1,31,12,4,2021,2021-12-31,1,2022,2500,1
Bureau,Department of Commerce,General Administration,null,100.0,100.0,0,0,4660,1,31,12,4,2021,2021-12-31,1,2022,4660,1
Bureau,Other Agencies,U.S.  Agency of Global Media,null,100.0,100.0,0,0,4930,2,31,12,4,2021,2021-12-31,1,2022,4930,2
Bureau,Other Agencies,U.S. Inst. for Env. Conflict Resolution,null,0.0,0.0,5003,2,0,0,31,12,4,2021,2021-12-31,1,2022,5003,2
Bureau,Department of Transportation,Maritime Administration,null,100.0,100.0,0,0,5310,6,31,12,4,2021,2021-12-31,1,2022,5310,6
Bureau,Other Agencies,Election Assistance Commission,null,0.0,0.0,5576,1,0,0,31,12,4,2021,2021-12-31,1,2022,5576,1
Bureau,Department of Justice,Bureau of ATF and Explosives,null,100.0,100.0,0,0,20422,4,31,12,4,2021,2021-12-31,1,2022,20422,4
Bureau,Department of the Interior,Office of the Secretary,null,100.0,100.0,0,0,27415,22,31,12,4,2021,2021-12-31,1,2022,27415,22
Bureau,Other Agencies,Architect of the Capitol,null,0.0,0.0,27483,20,0,0,31,12,4,2021,2021-12-31,1,2022,27483,20
Bureau,Department of Homeland Security,Domestic Nuclear Detection Office,null,0.0,0.0,28599,24,0,0,31,12,4,2021,2021-12-31,1,2022,28599,24
Bureau,Department of Transportation,National Highway Traffic Safety Admin.,null,100.0,100.0,0,0,39414,9,31,12,4,2021,2021-12-31,1,2022,39414,9
Bureau,Department of the Treasury,U.S. Mint,null,88.67138138204713,89.65517241379311,5110,3,39997,26,31,12,4,2021,2021-12-31,1,2022,45107,29
Bureau,Legislative Branch-GPO,Government Publishing Office,null,100.0,100.0,0,0,75651,9,31,12,4,2021,2021-12-31,1,2022,75651,9
Bureau,Department of the Interior,Bureau of Reclamation,null,100.0,100.0,0,0,78251,60,31,12,4,2021,2021-12-31,1,2022,78251,60
Bureau,Armed Forces Retirement Home,Armed Forces Retirement Home,null,67.25086856317292,85.12396694214875,38082,18,78202,103,31,12,4,2021,2021-12-31,1,2022,116284,121
Bureau,National Archives & Records Admin,Nat'l Archives & Records Administration,null,100.0,100.0,0,0,119017,105,31,12,4,2021,2021-12-31,1,2022,119017,105
Bureau,Other Agencies,Consumer Financial Protection Bureau,null,5.345305577809059,7.142857142857143,374542,13,21151,1,31,12,4,2021,2021-12-31,1,2022,395693,14
Bureau,Department of Housing and Urban Development,Public and Indian Housing Programs,null,0.0,0.0,607254,11,0,0,31,12,4,2021,2021-12-31,1,2022,607254,11
Bureau,Department of the Treasury,Treasury Franchise Fund,null,0.0,0.0,0,0,0,0,31,12,4,2021,2021-12-31,1,2022,0,0
Bureau,Merit Systems Protection Board,Merit Systems Protection Board,null,100.0,100.0,0,0,144,1,31,12,4,2021,2021-12-31,1,2022,144,1
Bureau,Other Agencies,John C. Stennis,null,0.0,0.0,2934,2,0,0,31,12,4,2021,2021-12-31,1,2022,2934,2
Bureau,National Credit Union Administration,National Credit Union Administration,null,0.0,0.0,2996,8,0,0,31,12,4,2021,2021-12-31,1,2022,2996,8
Bureau,Department of Transportation,St. Lawrence Seaway Development Corp.,null,100.0,100.0,0,0,3576,2,31,12,4,2021,2021-12-31,1,2022,3576,2
Bureau,Department of the Treasury,Spec Insp Gen-Troubled Asset Rel Prog,null,100.0,100.0,0,0,3916,1,31,12,4,2021,2021-12-31,1,2022,3916,1
Bureau,Department of Transportation,Federal Highway Administration,null,100.0,100.0,0,0,6048,7,31,12,4,2021,2021-12-31,1,2022,6048,7
Bureau,Other Agencies,Council of Insps. Gen. of Intg. & Effy.,null,0.0,0.0,6750,12,0,0,31,12,4,2021,2021-12-31,1,2022,6750,12
Bureau,Department of Health & Human Services,Office of the Secretary,null,100.0,100.0,0,0,7226,7,31,12,4,2021,2021-12-31,1,2022,7226,7
Bureau,Department of Agriculture,Federal Crop Insurance Corporation,null,13.726064869089488,97.82608695652173,8831,9,1405,405,31,12,4,2021,2021-12-31,1,2022,10236,414
Bureau,Department of Justice,Federal Prison Industries,null,0.0,0.0,22733,8,0,0,31,12,4,2021,2021-12-31,1,2022,22733,8
Bureau,Department of Transportation,Federal Railroad Administration,null,100.0,100.0,0,0,130497,13,31,12,4,2021,2021-12-31,1,2022,130497,13
Bureau,Department of Housing and Urban Development,Community Planning and Development,null,100.0,100.0,0,0,234529,2,31,12,4,2021,2021-12-31,1,2022,234529,2
Bureau,Securities & Exchange Commission,Securities and Exchange Commission,null,100.0,100.0,0,0,278678,51,31,12,4,2021,2021-12-31,1,2022,278678,51
Bureau,Department of Commerce,Nat'l Telecomm & Information Admin.,null,100.0,100.0,0,0,296092,1,31,12,4,2021,2021-12-31,1,2022,296092,1
Bureau,Department of the Treasury,Pandemic Receivables,null,0.0,0.0,304917,1,0,0,31,12,4,2021,2021-12-31,1,2022,304917,1
Bureau,Department of Justice,Drug Enforcement Administration,null,100.0,100.0,0,0,313028,21,31,12,4,2021,2021-12-31,1,2022,313028,21
Bureau,Department of Justice,Federal Bureau of Investigation,null,100.0,100.0,0,0,338605,76,31,12,4,2021,2021-12-31,1,2022,338605,76
Bureau,Department of Housing and Urban Development,Management and Administration,null,1.2148138307384944,25.0,386663,6,4755,2,31,12,4,2021,2021-12-31,1,2022,391418,8
Bureau,Federal Maritime Commission,Salaries and Expenses,null,100.0,100.0,0,0,397461,6,31,12,4,2021,2021-12-31,1,2022,397461,6
Bureau,National Science Foundation,National Science Foundation,null,100.0,100.0,0,0,595663,68,31,12,4,2021,2021-12-31,1,2022,595663,68
Bureau,Department of Labor,Bureau of Labor Statistics,null,100.0,100.0,0,0,12209,1,31,12,4,2021,2021-12-31,1,2022,12209,1
Bureau,Equal Employment Opportunity Commission,Equal Employment Opportunity Commission,null,100.0,100.0,0,0,17338,14,31,12,4,2021,2021-12-31,1,2022,17338,14
Bureau,Department of the Interior,Geological Survey,null,100.0,100.0,0,0,119371,283,31,12,4,2021,2021-12-31,1,2022,119371,283
Bureau,Other Agencies,James Madison Memorial Fellowship,null,0.0,0.0,198966,24,0,0,31,12,4,2021,2021-12-31,1,2022,198966,24
Bureau,Department of the Treasury,Internal Revenue Service,null,0.0,0.0,209716,80,0,0,31,12,4,2021,2021-12-31,1,2022,209716,80
Bureau,Legislative Branch - U.S. House/Senate,U.S. House of Representatives,null,0.0,0.0,218320,178,0,0,31,12,4,2021,2021-12-31,1,2022,218320,178
Bureau,Department of Transportation,Pipeline Hazardous Material Safety Admin,null,100.0,100.0,0,0,400389,24,31,12,4,2021,2021-12-31,1,2022,400389,24
Bureau,Department of Commerce,Patent and Trademark Office,null,100.0,100.0,0,0,589452,822,31,12,4,2021,2021-12-31,1,2022,589452,822
Bureau,Department of Commerce,Nat'l Institute of Standards& Technology,null,100.0,100.0,0,0,673322,5,31,12,4,2021,2021-12-31,1,2022,673322,5
Bureau,Department of the Interior,Fish and Wildlife Service,null,100.0,100.0,0,0,753384,69,31,12,4,2021,2021-12-31,1,2022,753384,69
Bureau,Department of Transportation,Federal Transit Administration,null,100.0,100.0,0,0,783404,1,31,12,4,2021,2021-12-31,1,2022,783404,1
Bureau,Department of Veterans Affairs,Life Insurance,null,100.0,100.0,0,0,917965,181,31,12,4,2021,2021-12-31,1,2022,917965,181
Bureau,Department of Justice,Office of Justice Assistance Programs,null,100.0,100.0,0,0,937770,3,31,12,4,2021,2021-12-31,1,2022,937770,3
Bureau,Department of Veterans Affairs,Housing Credit Assistance,null,0.0,0.0,945487,25,0,0,31,12,4,2021,2021-12-31,1,2022,945487,25
Bureau,Department of Agriculture,Food Safety and Inspection Service,null,90.5942558034126,88.33570412517781,96494,82,929411,621,31,12,4,2021,2021-12-31,1,2022,1025905,703
Bureau,Department of Homeland Security,Citizenship and Immigration Services,null,100.0,100.0,0,0,1029212,1234,31,12,4,2021,2021-12-31,1,2022,1029212,1234
Bureau,The Judiciary,Administrative Office of the U.S. Courts,null,98.86456052846096,57.525083612040135,11965,127,1041812,172,31,12,4,2021,2021-12-31,1,2022,1053777,299
Bureau,Department of Transportation,Office of the Secretary,null,100.0,100.0,0,0,1073204,17,31,12,4,2021,2021-12-31,1,2022,1073204,17
Bureau,Department of the Treasury,Community Dev Financial Inst Fund,null,100.0,100.0,0,0,4766457,10,31,12,4,2021,2021-12-31,1,2022,4766457,10
Bureau,Department of Agriculture,Agricultural Marketing Service,null,86.88781428873385,19.801223241590215,741931,2098,4916401,518,31,12,4,2021,2021-12-31,1,2022,5658332,2616
Bureau,Department of the Treasury,D.C. Pension Program,null,100.0,100.0,0,0,477970,22,31,12,4,2021,2021-12-31,1,2022,477970,22
Bureau,Department of Health & Human Services,Substance Abuse & Mental Health Admin.,null,100.0,100.0,0,0,1012840,14,31,12,4,2021,2021-12-31,1,2022,1012840,14
Bureau,Department of Labor,Employment and Training Administration,null,100.0,100.0,0,0,1122042,10,31,12,4,2021,2021-12-31,1,2022,1122042,10
Bureau,Federal Election Commission,Federal Election Commission,null,100.0,100.0,0,0,1149832,173,31,12,4,2021,2021-12-31,1,2022,1149832,173
Bureau,Funds Appropriated to the President,Trade and Development Agency,null,0.0,0.0,1236060,7,0,0,31,12,4,2021,2021-12-31,1,2022,1236060,7
Bureau,Department of Veterans Affairs,Administration and Cemeteries,null,3.1722871539181727,3.329065300896287,1229680,755,40287,26,31,12,4,2021,2021-12-31,1,2022,1269967,781
Bureau,Department of Veterans Affairs,Veterans Benefits,null,0.0,0.0,1295538,1702,0,0,31,12,4,2021,2021-12-31,1,2022,1295538,1702
Bureau,Presidio Trust Corporation,Presidio Trust Corporation,null,100.0,100.0,0,0,1469218,66,31,12,4,2021,2021-12-31,1,2022,1469218,66
Bureau,Department of the Treasury,Financial Crimes Enforcement Network,null,100.0,100.0,0,0,1544945,3,31,12,4,2021,2021-12-31,1,2022,1544945,3
Bureau,National Aeronautics and Space Administration,National Aeronautics and Space Admin,null,100.0,100.0,0,0,1558326,126,31,12,4,2021,2021-12-31,1,2022,1558326,126
Bureau,Department of Transportation,Federal Aviation Administration,null,98.50725850843108,94.09282700421942,27498,14,1814616,223,31,12,4,2021,2021-12-31,1,2022,1842114,237
Bureau,Department of Commerce,Bureau of the Census,null,100.0,100.0,0,0,2058507,4290,31,12,4,2021,2021-12-31,1,2022,2058507,4290
Bureau,Department of State,Passport NSF,null,100.0,100.0,0,0,2072724,13361,31,12,4,2021,2021-12-31,1,2022,2072724,13361
Bureau,Pension Benefit Guaranty Corp,Pension Benefit Guaranty Corporation,null,100.0,100.0,0,0,2595015,745,31,12,4,2021,2021-12-31,1,2022,2595015,745
Bureau,Nuclear Regulatory Commission,Nuclear Regulatory Commission,null,100.0,100.0,0,0,2936862,375,31,12,4,2021,2021-12-31,1,2022,2936862,375
Bureau,Corp. for National and Community Service,Corp. for National and Community Service,null,78.9373389078323,12.366912366912366,955531,1070,3581080,151,31,12,4,2021,2021-12-31,1,2022,4536611,1221
Bureau,Department of Commerce,Economic Development Administration,null,100.0,100.0,0,0,5120584,11,31,12,4,2021,2021-12-31,1,2022,5120584,11
Bureau,Department of the Interior,Office of Natural Resources Revenue,null,100.0,100.0,0,0,6469279,534,31,12,4,2021,2021-12-31,1,2022,6469279,534
Bureau,Department of the Interior,Office of Surface Mining,null,100.0,100.0,0,0,7568479,367,31,12,4,2021,2021-12-31,1,2022,7568479,367
Bureau,Department of the Interior,National Park Service,null,100.0,100.0,0,0,8243675,2172,31,12,4,2021,2021-12-31,1,2022,8243675,2172
Bureau,Department of Homeland Security,Transportation Safety Administration,null,100.0,100.0,0,0,8549083,5919,31,12,4,2021,2021-12-31,1,2022,8549083,5919
Bureau,Department of Homeland Security,Bureau of Customs & Border Protection,null,100.0,100.0,0,0,8919482,664,31,12,4,2021,2021-12-31,1,2022,8919482,664
Bureau,Department of the Interior,Bureau of Land Management,null,100.0,100.0,0,0,9048182,302,31,12,4,2021,2021-12-31,1,2022,9048182,302
Bureau,General Services Administration,General Services Administration,null,71.57393339243401,40.28722600151172,2961856,790,7457651,533,31,12,4,2021,2021-12-31,1,2022,10419507,1323
Bureau,Department of Agriculture,Food and Nutrition Service,null,0.462292119515526,1.5037593984962405,10532703,262,48918,4,31,12,4,2021,2021-12-31,1,2022,10581621,266
Bureau,Department of Commerce,NOAA,null,100.0,100.0,0,0,12690388,1272,31,12,4,2021,2021-12-31,1,2022,12690388,1272
Bureau,Department of Energy,Energy Consolidated Reports,null,100.0,100.0,0,0,12739078,68,31,12,4,2021,2021-12-31,1,2022,12739078,68
Bureau,Department of Health & Human Services,Centers for Disease Control,null,1.1978778965970092,15.454545454545455,13060613,93,158347,17,31,12,4,2021,2021-12-31,1,2022,13218960,110
Bureau,Department of the Treasury,Bureau of the Fiscal Service,null,100.0,100.0,0,0,14005030,3735,31,12,4,2021,2021-12-31,1,2022,14005030,3735
Bureau,Department of Homeland Security,Immigration and Customs Enforcement,null,100.0,100.0,0,0,14006209,608,31,12,4,2021,2021-12-31,1,2022,14006209,608
Bureau,Department of Health & Human Services,National Institutes of Health,null,33.83271162342563,20.916334661354583,12474061,397,6378247,105,31,12,4,2021,2021-12-31,1,2022,18852308,502
Bureau,Department of Labor,Employee Benefit Security Administration,null,100.0,100.0,0,0,20001180,456,31,12,4,2021,2021-12-31,1,2022,20001180,456
Bureau,Railroad Retirement Board,Railroad Retirement Board,null,100.0,100.0,0,0,21563120,4161,31,12,4,2021,2021-12-31,1,2022,21563120,4161
Bureau,Department of Agriculture,U.S. Department of Agriculture,null,76.66651919684243,49.171270718232044,5100134,2116,16757445,2047,31,12,4,2021,2021-12-31,1,2022,21857579,4163
Bureau,Department of Labor,Mine Safety and Health Administration,null,77.6225367813239,68.45831527235948,4918971,2183,17062837,4738,31,12,4,2021,2021-12-31,1,2022,21981808,6921
Bureau,Office of Personnel Management,Office of Personnel Management,null,99.33565605054038,98.62012987012987,146408,17,21891574,1215,31,12,4,2021,2021-12-31,1,2022,22037982,1232
Bureau,Department of the Treasury,Departmental Offices,null,97.64853114642993,98.05970149253731,522933,26,21715635,1314,31,12,4,2021,2021-12-31,1,2022,22238568,1340
Bureau,Environmental Protection Agency,Environmental Protection Agency,null,99.28438082529762,99.2156862745098,182201,2,25278408,253,31,12,4,2021,2021-12-31,1,2022,25460609,255
Bureau,Department of State,Department of State,null,57.49133744830413,98.89396844123286,11637367,75,15739093,6706,31,12,4,2021,2021-12-31,1,2022,27376460,6781
Bureau,Department of Health & Human Services,Administration for Children and Families,null,100.0,100.0,0,0,32668440,1744,31,12,4,2021,2021-12-31,1,2022,32668440,1744
Bureau,Department of Commerce,Bureau of Industry and Security,null,100.0,100.0,0,0,36366405,27,31,12,4,2021,2021-12-31,1,2022,36366405,27
Bureau,Department of the Interior,Bureau of Indian Affairs,null,99.94552876523761,99.88488104374521,21256,36,39001175,31236,31,12,4,2021,2021-12-31,1,2022,39022431,31272
Bureau,Agency for International Development,Agency for International Development,null,100.0,100.0,0,0,39929663,54,31,12,4,2021,2021-12-31,1,2022,39929663,54
Bureau,Department of Health & Human Services,Indian Health Services,null,100.0,100.0,0,0,46087108,4053,31,12,4,2021,2021-12-31,1,2022,46087108,4053
Bureau,Department of Labor,Occupational Safety and Health Admin,null,95.99227321648155,74.51042827575228,2481883,1601,59445567,4680,31,12,4,2021,2021-12-31,1,2022,61927450,6281
Bureau,Department of Transportation,Federal Motor Carrier Safety Admin,null,99.99959841097997,99.94301994301995,255,4,63497497,7016,31,12,4,2021,2021-12-31,1,2022,63497752,7020
Bureau,Department of Agriculture,Forest Service,null,91.72623786470056,30.464135021097047,5841841,824,64764987,361,31,12,4,2021,2021-12-31,1,2022,70606828,1185
Bureau,U.S. Postal Service,U.S. Postal Service,null,72.42396253935804,81.31377551020408,20314343,11720,53352307,51000,31,12,4,2021,2021-12-31,1,2022,73666650,62720
Bureau,Department of Justice,Legal Activities,null,96.49549505237138,99.20380922644603,3216889,306,88576076,38127,31,12,4,2021,2021-12-31,1,2022,91792965,38433
Bureau,Department of Labor,Employment Standards Administration,null,72.79635678926314,22.69019405804568,25224465,18007,67500119,5285,31,12,4,2021,2021-12-31,1,2022,92724584,23292
Bureau,Department of Health & Human Services,Health Resources and Services Admin,null,100.0,100.0,0,0,109257481,657,31,12,4,2021,2021-12-31,1,2022,109257481,657
Bureau,Department of Health & Human Services,Food and Drug Administration,null,25.396181344864377,6.823253082795068,90057188,15868,30656724,1162,31,12,4,2021,2021-12-31,1,2022,120713912,17030
Bureau,Department of Agriculture,Commodity Credit Corporation,null,100.0,100.0,0,0,138047795,10581,31,12,4,2021,2021-12-31,1,2022,138047795,10581
Bureau,Department of Housing and Urban Development,Housing Programs,null,99.98808201217152,99.93627867459644,16902,3,141802340,4705,31,12,4,2021,2021-12-31,1,2022,141819242,4708
Bureau,Department of Veterans Affairs,Medical and Construction,null,99.6620765122972,99.90576397760351,662415,2123,195362728,2250731,31,12,4,2021,2021-12-31,1,2022,196025143,2252854
Bureau,Federal Communications Commission,Federal Communications Commission,null,100.0,100.0,0,0,222106532,13231,31,12,4,2021,2021-12-31,1,2022,222106532,13231
Bureau,Department of Homeland Security,Emergency Preparedness & Resp,null,100.0,100.0,0,0,249930801,42449,31,12,4,2021,2021-12-31,1,2022,249930801,42449
Bureau,Federal Trade Commission,Federal Trade Commission,null,100.0,100.0,0,0,482181306,54,31,12,4,2021,2021-12-31,1,2022,482181306,54
Bureau,Commodity Futures Trading Commission,Commodity Futures Trading Commission,null,100.0,100.0,0,0,661847583,365,31,12,4,2021,2021-12-31,1,2022,661847583,365
Bureau,Department of Agriculture,Rural Development,null,99.98804873133163,99.59373386124979,87939,118,735725157,28927,31,12,4,2021,2021-12-31,1,2022,735813096,29045
Bureau,Department of Agriculture,Farm Service Agency,null,100.0,100.0,0,0,797099182,13535,31,12,4,2021,2021-12-31,1,2022,797099182,13535
Bureau,Small Business Administration,Small Business Administration,null,100.0,100.0,0,0,12469486128,117869,31,12,4,2021,2021-12-31,1,2022,12469486128,117869
Bureau,Department of Education,Federal Student Aid,null,100.0,100.0,0,0,129332894157,22308195,31,12,4,2021,2021-12-31,1,2022,129332894157,22308195
Bureau,Department of Education,Departmental Management,null,94.06864737662416,90.09345794392523,79749725,212,1264795610,1928,31,12,4,2021,2021-12-31,1,2022,1344545335,2140
Bureau,Securities & Exchange Commission,SEC Enforcement,null,100.0,100.0,0,0,2025879703,1027,31,12,4,2021,2021-12-31,1,2022,2025879703,1027
Bureau,Department of Defense,Consolidated Report,null,34.5676328440524,17.704632416696167,1924174584,1215826,1016533001,261567,31,12,4,2021,2021-12-31,1,2022,2940707585,1477393
Bureau,Social Security Administration,Social Security Administration,null,60.688062278458496,34.6154828896424,1739704923,870043,2685680911,460613,31,12,4,2021,2021-12-31,1,2022,4425385834,1330656
Bureau,Department of Health & Human Services,Centers for Medicare & Medicaid Services,null,99.26362186692161,99.2729003297354,68885924,8128,9285808479,1109738,31,12,4,2021,2021-12-31,1,2022,9354694403,1117866
Bureau,Other Agencies,Federal Housing Finance Agency,null,0.0,0.0,0,0,0,0,31,03,1,2022,2022-03-31,2,2022,0,0
Bureau,National Archives & Records Admin,Nat'l Archives & Records Administration,null,100.0,100.0,0,0,118077,100,31,03,1,2022,2022-03-31,2,2022,118077,100
Bureau,Pension Benefit Guaranty Corp,Pension Benefit Guaranty Corporation,null,100.0,100.0,0,0,3066618,893,31,03,1,2022,2022-03-31,2,2022,3066618,893
Bureau,Department of Housing and Urban Development,Public and Indian Housing Programs,null,0.0,0.0,1464637,10,0,0,31,03,1,2022,2022-03-31,2,2022,1464637,10
Bureau,Legislative Branch-CBO,Congressional Budget Office,null,0.0,0.0,0,0,0,0,31,03,1,2022,2022-03-31,2,2022,0,0
Bureau,Other Agencies,Commission On Fine Arts,null,0.0,0.0,0,0,0,0,31,03,1,2022,2022-03-31,2,2022,0,0
Bureau,Department of Transportation,Research Innovative Technology Admin,null,100.0,100.0,0,0,131,1,31,03,1,2022,2022-03-31,2,2022,131,1
Bureau,Small Business Administration,Small Business Administration,null,100.0,100.0,0,0,12433141154,127057,31,03,1,2022,2022-03-31,2,2022,12433141154,127057
Bureau,Department of Labor,Occupational Safety and Health Admin,null,90.81397144450189,85.37671896184389,5408490,755,53468858,4408,31,03,1,2022,2022-03-31,2,2022,58877348,5163
Bureau,National Labor Relations Board,National Labor Relations Board,null,0.0,0.0,0,0,0,0,31,03,1,2022,2022-03-31,2,2022,0,0
Bureau,Department of Health & Human Services,Administration for Children and Families,null,100.0,100.0,0,0,34085876,1765,31,03,1,2022,2022-03-31,2,2022,34085876,1765
Bureau,Department of Health & Human Services,Substance Abuse & Mental Health Admin.,null,100.0,100.0,0,0,1025337,13,31,03,1,2022,2022-03-31,2,2022,1025337,13
Bureau,Department of Homeland Security,U.S. Coast Guard,null,0.0,0.0,4632141,13593,0,0,31,03,1,2022,2022-03-31,2,2022,4632141,13593
Bureau,Department of the Treasury,Office of the Secretary,null,0.0,0.0,0,0,0,0,31,03,1,2022,2022-03-31,2,2022,0,0
Bureau,U.S. Postal Service,U.S. Postal Service,null,75.9948018521975,81.7685095376657,17633852,11278,55824621,50582,31,03,1,2022,2022-03-31,2,2022,73458473,61860
Bureau,Department of Justice,Legal Activities,null,96.41816772377261,99.08409658617819,3265635,352,87906557,38080,31,03,1,2022,2022-03-31,2,2022,91172192,38432
Bureau,Department of Commerce,Economic Development Administration,null,100.0,100.0,0,0,5120584,11,31,03,1,2022,2022-03-31,2,2022,5120584,11
Bureau,Department of Veterans Affairs,Veterans Benefits,null,0.0,0.0,1262607,1655,0,0,31,03,1,2022,2022-03-31,2,2022,1262607,1655
Bureau,Department of State,Passport NSF,null,100.0,100.0,0,0,2024638,13065,31,03,1,2022,2022-03-31,2,2022,2024638,13065
Bureau,U.S. Court of Appeals / Veterans Claims,U.S. Court of Appeals / Veterans Claims,null,0.0,0.0,511,1,0,0,31,03,1,2022,2022-03-31,2,2022,511,1
Bureau,Farm Credit Administration,Farm Credit Administration,null,100.0,100.0,0,0,630,1,31,03,1,2022,2022-03-31,2,2022,630,1
Bureau,Merit Systems Protection Board,Merit Systems Protection Board,null,100.0,100.0,0,0,144,1,31,03,1,2022,2022-03-31,2,2022,144,1
Bureau,Department of the Treasury,Treasury IG for Tax Admin,null,100.0,100.0,0,0,185,1,31,03,1,2022,2022-03-31,2,2022,185,1
Bureau,Department of Homeland Security,Office of the Inspector General DHS,null,100.0,100.0,0,0,100,1,31,03,1,2022,2022-03-31,2,2022,100,1
Bureau,Department of the Interior,Office of the Secretary,null,100.0,100.0,0,0,31504,20,31,03,1,2022,2022-03-31,2,2022,31504,20
Bureau,Department of Homeland Security,Domestic Nuclear Detection Office,null,0.0,0.0,371,3,0,0,31,03,1,2022,2022-03-31,2,2022,371,3
Agency,Nuclear Regulatory Commission,null,CFO,100.0,100.0,0,0,2780487,353,31,03,1,2022,2022-03-31,2,2022,2780487,353
Agency,Office of Personnel Management,null,CFO,93.3594015008753,87.73333333333333,803619,92,11297986,658,31,03,1,2022,2022-03-31,2,2022,12101605,750
Agency,Federal Labor Relations Authority,null,Non-CFO,0.0,0.0,0,0,0,0,31,03,1,2022,2022-03-31,2,2022,0,0
Agency,Merit Systems Protection Board,null,Non-CFO,100.0,100.0,0,0,144,1,31,03,1,2022,2022-03-31,2,2022,144,1
Agency,Federal Communications Commission,null,Non-CFO,100.0,100.0,0,0,224360279,13425,31,03,1,2022,2022-03-31,2,2022,224360279,13425
Agency,Federal Trade Commission,null,Non-CFO,100.0,100.0,0,0,482197221,73,31,03,1,2022,2022-03-31,2,2022,482197221,73
Agency,Commodity Futures Trading Commission,null,Non-CFO,100.0,100.0,0,0,662771313,362,31,03,1,2022,2022-03-31,2,2022,662771313,362
Agency,Securities & Exchange Commission,null,Non-CFO,100.0,100.0,0,0,2139047801,1183,31,03,1,2022,2022-03-31,2,2022,2139047801,1183
Bureau,Department of the Treasury,U.S. Treasury IG Office,null,0.0,0.0,0,0,0,0,31,03,1,2022,2022-03-31,2,2022,0,0
Bureau,Department of the Treasury,Treasury Forfeiture Fund,null,0.0,0.0,0,0,0,0,31,03,1,2022,2022-03-31,2,2022,0,0
Bureau,Other Agencies/Boards/Commissions,U.S.-China Security Review Commission,null,0.0,0.0,0,0,0,0,31,03,1,2022,2022-03-31,2,2022,0,0
Bureau,Department of Transportation,Office of the Inspector General,null,0.0,0.0,0,0,0,0,31,03,1,2022,2022-03-31,2,2022,0,0
Bureau,Department of Housing and Urban Development,"Policy, Development and Research",null,0.0,0.0,0,0,0,0,31,03,1,2022,2022-03-31,2,2022,0,0
Bureau,Other Agencies,Denali Commission,null,0.0,0.0,0,0,0,0,31,03,1,2022,2022-03-31,2,2022,0,0
Bureau,Other Agencies,National Mediation Board,null,0.0,0.0,0,0,0,0,31,03,1,2022,2022-03-31,2,2022,0,0
Bureau,Other Agencies,Surface Transportation Board,null,0.0,0.0,0,0,0,0,31,03,1,2022,2022-03-31,2,2022,0,0
Agency,National Aeronautics and Space Administration,null,CFO,100.0,100.0,0,0,1558415,128,31,03,1,2022,2022-03-31,2,2022,1558415,128
Agency,Department of Energy,null,CFO,100.0,100.0,0,0,13733445,103,31,03,1,2022,2022-03-31,2,2022,13733445,103
Agency,Department of State,null,CFO,99.818978518215,99.8315001170138,36258,36,19993409,21329,31,03,1,2022,2022-03-31,2,2022,20029667,21365
Agency,Environmental Protection Agency,null,CFO,99.93794293155732,99.3103448275862,16146,2,26001841,288,31,03,1,2022,2022-03-31,2,2022,26017987,290
Agency,Agency for International Development,null,CFO,100.0,100.0,0,0,38827209,54,31,03,1,2022,2022-03-31,2,2022,38827209,54
Agency,Department of the Treasury,null,CFO,98.67666470918253,99.44122929554979,589596,28,43964192,4983,31,03,1,2022,2022-03-31,2,2022,44553788,5011
Agency,Department of the Interior,null,CFO,99.97764867483666,99.9450867933738,10835,18,48465038,32761,31,03,1,2022,2022-03-31,2,2022,48475873,32779
Agency,Department of Commerce,null,CFO,100.0,100.0,0,0,60792935,19666,31,03,1,2022,2022-03-31,2,2022,60792935,19666
Agency,Department of Transportation,null,CFO,99.975824058751,99.86943465204335,16906,10,69912119,7649,31,03,1,2022,2022-03-31,2,2022,69929025,7659
Agency,Department of Justice,null,CFO,96.34733304634163,99.03546981953951,3398224,372,89635826,38196,31,03,1,2022,2022-03-31,2,2022,93034050,38568
Agency,Department of Housing and Urban Development,null,CFO,98.35412402836022,99.53198127925117,2312104,21,138166525,4466,31,03,1,2022,2022-03-31,2,2022,140478629,4487
Agency,Department of Labor,null,CFO,82.96823939646958,43.91274411617426,31541197,17921,153649270,14031,31,03,1,2022,2022-03-31,2,2022,185190467,31952
Agency,Department of Veterans Affairs,null,CFO,98.10467565696683,99.85973523189682,4658064,4681,241107998,3332579,31,03,1,2022,2022-03-31,2,2022,245766062,3337260
Agency,Department of Homeland Security,null,CFO,98.35144574648517,78.48972423940387,4632512,13596,276372010,49611,31,03,1,2022,2022-03-31,2,2022,281004522,63207
Agency,Department of Agriculture,null,CFO,98.74888447138713,90.16168722852565,22549349,5957,1779790122,54592,31,03,1,2022,2022-03-31,2,2022,1802339471,60549
Agency,Presidio Trust Corporation,null,Non-CFO,89.98204100032355,81.48148148148148,165339,15,1485087,66,31,03,1,2022,2022-03-31,2,2022,1650426,81
Agency,Pension Benefit Guaranty Corp,null,Non-CFO,100.0,100.0,0,0,3066618,893,31,03,1,2022,2022-03-31,2,2022,3066618,893
Bureau,Legislative Branch-GAO,Government Accountability Office,null,0.0,0.0,0,0,0,0,31,03,1,2022,2022-03-31,2,2022,0,0
Bureau,Department of Housing and Urban Development,Community Planning and Development,null,0.0,0.0,0,0,0,0,31,03,1,2022,2022-03-31,2,2022,0,0
Bureau,Other Agencies,National Capital Planning Commission,null,0.0,0.0,0,0,0,0,31,03,1,2022,2022-03-31,2,2022,0,0
Bureau,Other Agencies,National Council on Disability,null,0.0,0.0,1579,2,0,0,31,03,1,2022,2022-03-31,2,2022,1579,2
Agency,Federal Deposit Insurance Corporation,null,Non-CFO,0.0,0.0,0,0,0,0,31,03,1,2022,2022-03-31,2,2022,0,0
Agency,Legislative Branch-CBO,null,Non-CFO,0.0,0.0,0,0,0,0,31,03,1,2022,2022-03-31,2,2022,0,0
Agency,Legis Branch-Library of Congress,null,Non-CFO,0.0,0.0,0,0,0,0,31,03,1,2022,2022-03-31,2,2022,0,0
Agency,Office of Government Ethics,null,Non-CFO,0.0,0.0,0,0,0,0,31,03,1,2022,2022-03-31,2,2022,0,0
Agency,Office of Compliance,null,Non-CFO,0.0,0.0,0,0,0,0,31,03,1,2022,2022-03-31,2,2022,0,0
Agency,U.S. Court of Appeals / Veterans Claims,null,Non-CFO,0.0,0.0,511,1,0,0,31,03,1,2022,2022-03-31,2,2022,511,1
Agency,Farm Credit Administration,null,Non-CFO,100.0,100.0,0,0,630,1,31,03,1,2022,2022-03-31,2,2022,630,1
Agency,Other Agencies/Boards/Commissions,null,Non-CFO,0.0,0.0,1024,1,0,0,31,03,1,2022,2022-03-31,2,2022,1024,1
Agency,Consumer Product Safety Commission,null,Non-CFO,100.0,100.0,0,0,2500,1,31,03,1,2022,2022-03-31,2,2022,2500,1
Agency,National Credit Union Administration,null,Non-CFO,0.0,0.0,4885,10,0,0,31,03,1,2022,2022-03-31,2,2022,4885,10
Agency,Equal Employment Opportunity Commission,null,Non-CFO,100.0,100.0,0,0,15976,18,31,03,1,2022,2022-03-31,2,2022,15976,18
Agency,Legislative Branch-GPO,null,Non-CFO,100.0,100.0,0,0,75651,9,31,03,1,2022,2022-03-31,2,2022,75651,9
Agency,Armed Forces Retirement Home,null,Non-CFO,66.10393398184844,82.92682926829268,39514,21,77060,102,31,03,1,2022,2022-03-31,2,2022,116574,123
Agency,National Archives & Records Admin,null,Non-CFO,100.0,100.0,0,0,118077,100,31,03,1,2022,2022-03-31,2,2022,118077,100
Agency,Legislative Branch - U.S. House/Senate,null,Non-CFO,0.0,0.0,276073,203,0,0,31,03,1,2022,2022-03-31,2,2022,276073,203
Agency,Federal Maritime Commission,null,Non-CFO,100.0,100.0,0,0,397583,6,31,03,1,2022,2022-03-31,2,2022,397583,6
Agency,Other Agencies,null,Non-CFO,6.395149578233507,6.8493150684931505,873981,68,59711,5,31,03,1,2022,2022-03-31,2,2022,933692,73
Agency,The Judiciary,null,Non-CFO,98.81284736070351,56.50684931506849,11966,127,995992,165,31,03,1,2022,2022-03-31,2,2022,1007958,292
Agency,Funds Appropriated to the President,null,Non-CFO,0.0,0.0,1236060,7,0,0,31,03,1,2022,2022-03-31,2,2022,1236060,7
Agency,Federal Election Commission,null,Non-CFO,100.0,100.0,0,0,1357375,209,31,03,1,2022,2022-03-31,2,2022,1357375,209
Bureau,Department of the Treasury,Interest on Tax/Deposit of Earnings,null,0.0,0.0,0,0,0,0,31,03,1,2022,2022-03-31,2,2022,0,0
Bureau,Smithsonian Institution,National Gallery of Art,null,0.0,0.0,0,0,0,0,31,03,1,2022,2022-03-31,2,2022,0,0
Bureau,Other Agencies,District of Columbia Government,null,0.0,0.0,0,0,0,0,31,03,1,2022,2022-03-31,2,2022,0,0
Agency,Corp. for National and Community Service,null,Non-CFO,91.95825495950929,39.01808785529716,313124,236,3580608,151,31,03,1,2022,2022-03-31,2,2022,3893732,387
Agency,Railroad Retirement Board,null,Non-CFO,100.0,100.0,0,0,21404640,4106,31,03,1,2022,2022-03-31,2,2022,21404640,4106
Bureau,Legis Branch-Library of Congress,Library of Congress,null,0.0,0.0,0,0,0,0,31,03,1,2022,2022-03-31,2,2022,0,0
Bureau,Department of Commerce,Office of the Inspector General,null,0.0,0.0,0,0,0,0,31,03,1,2022,2022-03-31,2,2022,0,0
Bureau,Department of Labor,Departmental Management,null,0.0,0.0,0,0,0,0,31,03,1,2022,2022-03-31,2,2022,0,0
Bureau,Department of State,International Commissions,null,0.0,0.0,0,0,0,0,31,03,1,2022,2022-03-31,2,2022,0,0
Bureau,Smithsonian Institution,JFK Center for the Performing Arts,null,0.0,0.0,0,0,0,0,31,03,1,2022,2022-03-31,2,2022,0,0
Bureau,Department of Homeland Security,Management Headquarters,null,0.0,0.0,0,0,0,0,31,03,1,2022,2022-03-31,2,2022,0,0
Bureau,Department of Homeland Security,U.S. Secret Service,null,0.0,0.0,0,0,0,0,31,03,1,2022,2022-03-31,2,2022,0,0
Bureau,Export - Import  Bank,Export-Import Bank,null,0.0,0.0,0,0,0,0,31,03,1,2022,2022-03-31,2,2022,0,0
Bureau,Department of Housing and Urban Development,Government National Mortgage Association,null,0.0,0.0,0,0,0,0,31,03,1,2022,2022-03-31,2,2022,0,0
Bureau,Selective Service System,Selective Service System,null,0.0,0.0,0,0,0,0,31,03,1,2022,2022-03-31,2,2022,0,0
Bureau,Other Agencies,Federal Mine Safety & Health Review Comm,null,0.0,0.0,0,0,0,0,31,03,1,2022,2022-03-31,2,2022,0,0
Bureau,Other Agencies,National Transportation Safety Board,null,0.0,0.0,0,0,0,0,31,03,1,2022,2022-03-31,2,2022,0,0
Bureau,Other Agencies,Advisory Council on Hist. Preservation,null,0.0,0.0,0,0,0,0,31,03,1,2022,2022-03-31,2,2022,0,0
Bureau,Other Agencies,Archit.&Trans. Barriers Compliance Bd,null,0.0,0.0,0,0,0,0,31,03,1,2022,2022-03-31,2,2022,0,0
Bureau,Other Agencies,Millennium Challenge Corporation,null,0.0,0.0,0,0,0,0,31,03,1,2022,2022-03-31,2,2022,0,0
Bureau,Office of Government Ethics,Office of Government Ethics,null,0.0,0.0,0,0,0,0,31,03,1,2022,2022-03-31,2,2022,0,0
Bureau,Smithsonian Institution,Administrative Conference of the US,null,0.0,0.0,0,0,0,0,31,03,1,2022,2022-03-31,2,2022,0,0
Bureau,Department of Homeland Security,Office of Health Affairs,null,0.0,0.0,0,0,0,0,31,03,1,2022,2022-03-31,2,2022,0,0
Bureau,Other Agencies,Delta Regional Authority,null,0.0,0.0,0,0,0,0,31,03,1,2022,2022-03-31,2,2022,0,0
Agency,Smithsonian Institution,null,Non-CFO,0.0,0.0,0,0,0,0,31,03,1,2022,2022-03-31,2,2022,0,0
Agency,Office of Special Counsel,null,Non-CFO,0.0,0.0,0,0,0,0,31,03,1,2022,2022-03-31,2,2022,0,0
Agency,US International Development Fin. Corp.,null,Non-CFO,0.0,0.0,0,0,0,0,31,03,1,2022,2022-03-31,2,2022,0,0
Agency,Federal Mediation/Conciliation Service,null,Non-CFO,0.0,0.0,0,0,0,0,31,03,1,2022,2022-03-31,2,2022,0,0
Agency,Selective Service System,null,Non-CFO,0.0,0.0,0,0,0,0,31,03,1,2022,2022-03-31,2,2022,0,0
Agency,National Foundation  Arts & Humanities,null,Non-CFO,0.0,0.0,0,0,0,0,31,03,1,2022,2022-03-31,2,2022,0,0
Bureau,U.S. Tax Court,U.S. Tax Court,null,0.0,0.0,0,0,0,0,31,03,1,2022,2022-03-31,2,2022,0,0
Bureau,Funds Appropriated to the President,Defense Security Assistance Agency,null,0.0,0.0,0,0,0,0,31,03,1,2022,2022-03-31,2,2022,0,0
Bureau,Department of Commerce,Minority Business Development Agency,null,0.0,0.0,0,0,0,0,31,03,1,2022,2022-03-31,2,2022,0,0
Bureau,Department of Commerce,Economic and Statistical Analysis,null,0.0,0.0,0,0,0,0,31,03,1,2022,2022-03-31,2,2022,0,0
Bureau,Department of Commerce,National Technical Information Service,null,0.0,0.0,0,0,0,0,31,03,1,2022,2022-03-31,2,2022,0,0
Bureau,Department of Justice,General Administration,null,0.0,0.0,0,0,0,0,31,03,1,2022,2022-03-31,2,2022,0,0
Bureau,Department of Justice,Federal Prison System,null,0.0,0.0,0,0,0,0,31,03,1,2022,2022-03-31,2,2022,0,0
Bureau,Department of State,Civil Monetary Penalties,null,0.0,0.0,0,0,0,0,31,03,1,2022,2022-03-31,2,2022,0,0
Bureau,Department of Homeland Security,Science and Technology,null,0.0,0.0,0,0,0,0,31,03,1,2022,2022-03-31,2,2022,0,0
Bureau,American Battle Monuments Commission,American Battle Monuments Commission,null,0.0,0.0,0,0,0,0,31,03,1,2022,2022-03-31,2,2022,0,0
Bureau,Department of Health & Human Services,Administration for Community Living,null,0.0,0.0,0,0,0,0,31,03,1,2022,2022-03-31,2,2022,0,0
Bureau,Department of Education,Office of Postsecondary Education,null,0.0,0.0,0,0,0,0,31,03,1,2022,2022-03-31,2,2022,0,0
Bureau,Legislative Branch-Office of Tech.,Medicaid & CHIP Payment & Access Comm.,null,0.0,0.0,0,0,0,0,31,03,1,2022,2022-03-31,2,2022,0,0
Bureau,US International Development Fin. Corp.,US International Development Fin. Corp.,null,0.0,0.0,0,0,0,0,31,03,1,2022,2022-03-31,2,2022,0,0
Bureau,Other Agencies,Privacy & Civil Liberties Oversight Bd,null,0.0,0.0,0,0,0,0,31,03,1,2022,2022-03-31,2,2022,0,0
Bureau,Department of Transportation,Federal Railroad Administration,null,100.0,100.0,0,0,132114,13,31,03,1,2022,2022-03-31,2,2022,132114,13
Agency,National Science Foundation,null,CFO,100.0,100.0,0,0,561973,58,31,03,1,2022,2022-03-31,2,2022,561973,58
Agency,Department of Defense,null,CFO,34.86689722308553,18.175632617296408,1918941338,1232635,1027243100,273805,31,03,1,2022,2022-03-31,2,2022,2946184438,1506440
Agency,Export - Import  Bank,null,Non-CFO,0.0,0.0,0,0,0,0,31,03,1,2022,2022-03-31,2,2022,0,0
Agency,Legislative Branch-Office of Tech.,null,Non-CFO,0.0,0.0,0,0,0,0,31,03,1,2022,2022-03-31,2,2022,0,0
Agency,American Battle Monuments Commission,null,Non-CFO,0.0,0.0,0,0,0,0,31,03,1,2022,2022-03-31,2,2022,0,0
Agency,Legislative Branch-GAO,null,Non-CFO,0.0,0.0,0,0,0,0,31,03,1,2022,2022-03-31,2,2022,0,0
Agency,National Labor Relations Board,null,Non-CFO,0.0,0.0,0,0,0,0,31,03,1,2022,2022-03-31,2,2022,0,0
Agency,Neighborhood Reinvestment Corporation,null,Non-CFO,0.0,0.0,0,0,0,0,31,03,1,2022,2022-03-31,2,2022,0,0
Agency,U.S. Postal Service,null,Non-CFO,75.9948018521975,81.7685095376657,17633852,11278,55824621,50582,31,03,1,2022,2022-03-31,2,2022,73458473,61860
Bureau,Office of Compliance,Office of Compliance,null,0.0,0.0,0,0,0,0,31,03,1,2022,2022-03-31,2,2022,0,0
Bureau,Legislative Branch-Office of Tech.,Open World Leadership,null,0.0,0.0,0,0,0,0,31,03,1,2022,2022-03-31,2,2022,0,0
Bureau,Funds Appropriated to the President,Executive Branch,null,0.0,0.0,0,0,0,0,31,03,1,2022,2022-03-31,2,2022,0,0
Bureau,Funds Appropriated to the President,African Development Foundation,null,0.0,0.0,0,0,0,0,31,03,1,2022,2022-03-31,2,2022,0,0
Bureau,Department of Justice,U.S. Marshals Service,null,0.0,0.0,0,0,0,0,31,03,1,2022,2022-03-31,2,2022,0,0
Bureau,Other Agencies/Boards/Commissions,Nuclear Waste Technical Review Board,null,0.0,0.0,0,0,0,0,31,03,1,2022,2022-03-31,2,2022,0,0
Bureau,Federal Labor Relations Authority,Federal Labor Relations Authority,null,0.0,0.0,0,0,0,0,31,03,1,2022,2022-03-31,2,2022,0,0
Bureau,Tennessee Valley Authority,Tennessee Valley Authority,null,0.0,0.0,0,0,0,0,31,03,1,2022,2022-03-31,2,2022,0,0
Bureau,Neighborhood Reinvestment Corporation,Neighborhood Reinvestment Corporation,null,0.0,0.0,0,0,0,0,31,03,1,2022,2022-03-31,2,2022,0,0
Bureau,Other Agencies,Federal Housing Finance Agency OIG,null,0.0,0.0,0,0,0,0,31,03,1,2022,2022-03-31,2,2022,0,0
Bureau,Department of the Treasury,International Monetary Funds,null,0.0,0.0,0,0,0,0,31,03,1,2022,2022-03-31,2,2022,0,0
Bureau,Department of Homeland Security,Office of Biometric Identity Management,null,0.0,0.0,0,0,0,0,31,03,1,2022,2022-03-31,2,2022,0,0
Bureau,Department of Health & Human Services,Office of the Inspector General,null,0.0,0.0,0,0,0,0,31,03,1,2022,2022-03-31,2,2022,0,0
Bureau,Department of the Treasury,Treasury Franchise Fund,null,0.0,0.0,0,0,0,0,31,03,1,2022,2022-03-31,2,2022,0,0
Bureau,Department of the Treasury,Community Dev Financial Inst Fund,null,100.0,100.0,0,0,4736083,10,31,03,1,2022,2022-03-31,2,2022,4736083,10
Agency,General Services Administration,null,CFO,90.90873747273501,75.05175983436853,1398368,482,13983082,1450,31,03,1,2022,2022-03-31,2,2022,15381450,1932
Agency,Social Security Administration,null,CFO,60.07402872383431,34.137587493938305,1756574978,873302,2643004849,452647,31,03,1,2022,2022-03-31,2,2022,4399579827,1325949
Agency,Department of Health & Human Services,null,CFO,97.88077812393404,97.528853170446,201209110,28141,9293271495,1110642,31,03,1,2022,2022-03-31,2,2022,9494480605,1138783
Agency,Small Business Administration,null,CFO,100.0,100.0,0,0,12433141154,127057,31,03,1,2022,2022-03-31,2,2022,12433141154,127057
Agency,Department of Education,null,CFO,99.91985186899507,99.99876698199448,101871233,267,127001820048,21653918,31,03,1,2022,2022-03-31,2,2022,127103691281,21654185
Agency,Tennessee Valley Authority,null,Non-CFO,0.0,0.0,0,0,0,0,31,03,1,2022,2022-03-31,2,2022,0,0
Agency,U.S. Tax Court,null,Non-CFO,0.0,0.0,0,0,0,0,31,03,1,2022,2022-03-31,2,2022,0,0
Bureau,Federal Deposit Insurance Corporation,Federal Deposit Insurance Corporation,null,0.0,0.0,0,0,0,0,31,03,1,2022,2022-03-31,2,2022,0,0
Bureau,Farm Credit Administration,Farm Credit System Insurance Corporation,null,0.0,0.0,0,0,0,0,31,03,1,2022,2022-03-31,2,2022,0,0
Bureau,Other Agencies,U.S. Holocaust Memorial Council,null,0.0,0.0,0,0,0,0,31,03,1,2022,2022-03-31,2,2022,0,0
Bureau,Department of the Interior,Bureau of Safety and Environmental Enf.,null,0.0,0.0,0,0,0,0,31,03,1,2022,2022-03-31,2,2022,0,0
Bureau,Other Agencies,Gulf Coast Ecosystem Restoration Council,null,0.0,0.0,0,0,0,0,31,03,1,2022,2022-03-31,2,2022,0,0
Bureau,Department of the Treasury,Pandemic Receivables,null,0.0,0.0,0,0,0,0,31,03,1,2022,2022-03-31,2,2022,0,0
Bureau,Consumer Product Safety Commission,Consumer Product Safety Commission,null,100.0,100.0,0,0,2500,1,31,03,1,2022,2022-03-31,2,2022,2500,1
Bureau,Funds Appropriated to the President,Peace Corps,null,0.0,0.0,0,0,0,0,31,03,1,2022,2022-03-31,2,2022,0,0
Bureau,Department of the Treasury,Office of Sec International Affairs,null,0.0,0.0,0,0,0,0,31,03,1,2022,2022-03-31,2,2022,0,0
Bureau,Smithsonian Institution,Smithsonian Institution,null,0.0,0.0,0,0,0,0,31,03,1,2022,2022-03-31,2,2022,0,0
Bureau,Office of Special Counsel,Office of Special Counsel,null,0.0,0.0,0,0,0,0,31,03,1,2022,2022-03-31,2,2022,0,0
Bureau,National Foundation  Arts & Humanities,National Endowment for the Humanities,null,0.0,0.0,0,0,0,0,31,03,1,2022,2022-03-31,2,2022,0,0
Bureau,Occupational Safety & Health Rev Comm,Occupational Safety & Health Rev Comm,null,0.0,0.0,0,0,0,0,31,03,1,2022,2022-03-31,2,2022,0,0
Bureau,Federal Mediation/Conciliation Service,Federal Mediation/Conciliation Service,null,0.0,0.0,0,0,0,0,31,03,1,2022,2022-03-31,2,2022,0,0
Bureau,Other Agencies,U.S. Institute of Peace,null,0.0,0.0,0,0,0,0,31,03,1,2022,2022-03-31,2,2022,0,0
Bureau,Other Agencies,Comm. for Purchase from Blind/Handic.,null,0.0,0.0,0,0,0,0,31,03,1,2022,2022-03-31,2,2022,0,0
Bureau,Other Agencies,Defense Nuclear Facilities Safety Board,null,0.0,0.0,0,0,0,0,31,03,1,2022,2022-03-31,2,2022,0,0
Bureau,Department of the Interior,"Bureau of Ocean Energy Mgmt., Reg & Enf",null,100.0,100.0,0,0,2656,2,31,03,1,2022,2022-03-31,2,2022,2656,2
Bureau,Other Agencies,John C. Stennis,null,0.0,0.0,2934,2,0,0,31,03,1,2022,2022-03-31,2,2022,2934,2
Bureau,Other Agencies,Council of Insps. Gen. of Intg. & Effy.,null,0.0,0.0,3032,6,0,0,31,03,1,2022,2022-03-31,2,2022,3032,6
Bureau,Department of Transportation,St. Lawrence Seaway Development Corp.,null,100.0,100.0,0,0,3385,1,31,03,1,2022,2022-03-31,2,2022,3385,1
Bureau,Department of the Treasury,Spec Insp Gen-Troubled Asset Rel Prog,null,100.0,100.0,0,0,3916,1,31,03,1,2022,2022-03-31,2,2022,3916,1
Bureau,Other Agencies,U.S. Inst. for Env. Conflict Resolution,null,0.0,0.0,4178,1,0,0,31,03,1,2022,2022-03-31,2,2022,4178,1
Bureau,Department of the Treasury,Comptroller of the Currency,null,97.26032088491635,91.30434782608695,40000,2,1420025,21,31,03,1,2022,2022-03-31,2,2022,1460025,23
Bureau,Railroad Retirement Board,Railroad Retirement Board,null,100.0,100.0,0,0,21404640,4106,31,03,1,2022,2022-03-31,2,2022,21404640,4106
Bureau,Department of the Treasury,Departmental Offices,null,97.7139154867686,98.26283987915407,510251,23,21809615,1301,31,03,1,2022,2022-03-31,2,2022,22319866,1324
Agency,Occupational Safety & Health Rev Comm,null,Non-CFO,0.0,0.0,0,0,0,0,31,03,1,2022,2022-03-31,2,2022,0,0
Bureau,Department of Commerce,International Trade Administration,null,0.0,0.0,0,0,0,0,31,03,1,2022,2022-03-31,2,2022,0,0
Bureau,National Foundation  Arts & Humanities,National Endowment for the Arts,null,0.0,0.0,0,0,0,0,31,03,1,2022,2022-03-31,2,2022,0,0
Bureau,Department of Homeland Security,Info Analysis Infrastructure Prot-NPPD,null,0.0,0.0,0,0,0,0,31,03,1,2022,2022-03-31,2,2022,0,0
Bureau,Other Agencies/Boards/Commissions,Medicare Payment Advisory Commission,null,0.0,0.0,0,0,0,0,31,03,1,2022,2022-03-31,2,2022,0,0
Bureau,Department of Commerce,General Administration,null,100.0,100.0,0,0,4660,1,31,03,1,2022,2022-03-31,2,2022,4660,1
Bureau,National Credit Union Administration,National Credit Union Administration,null,0.0,0.0,4885,10,0,0,31,03,1,2022,2022-03-31,2,2022,4885,10
Bureau,Other Agencies,U.S.  Agency of Global Media,null,100.0,100.0,0,0,4930,2,31,03,1,2022,2022-03-31,2,2022,4930,2
Bureau,Armed Forces Retirement Home,Armed Forces Retirement Home,null,66.10393398184844,82.92682926829268,39514,21,77060,102,31,03,1,2022,2022-03-31,2,2022,116574,123
Bureau,Other Agencies,Election Assistance Commission,null,0.0,0.0,5576,1,0,0,31,03,1,2022,2022-03-31,2,2022,5576,1
Bureau,Department of Transportation,Maritime Administration,null,100.0,100.0,0,0,5622,7,31,03,1,2022,2022-03-31,2,2022,5622,7
Bureau,Department of Transportation,Federal Highway Administration,null,100.0,100.0,0,0,5719,6,31,03,1,2022,2022-03-31,2,2022,5719,6
Bureau,Department of Labor,Bureau of Labor Statistics,null,100.0,100.0,0,0,10260,1,31,03,1,2022,2022-03-31,2,2022,10260,1
Bureau,Department of Agriculture,Federal Crop Insurance Corporation,null,45.51728464771943,98.06295399515739,8684,8,7255,405,31,03,1,2022,2022-03-31,2,2022,15939,413
Bureau,Equal Employment Opportunity Commission,Equal Employment Opportunity Commission,null,100.0,100.0,0,0,15976,18,31,03,1,2022,2022-03-31,2,2022,15976,18
Bureau,Department of Homeland Security,Federal Law Enforcement Training Ctr.,null,100.0,100.0,0,0,16318,2,31,03,1,2022,2022-03-31,2,2022,16318,2
Bureau,Department of Justice,Bureau of ATF and Explosives,null,100.0,100.0,0,0,20422,4,31,03,1,2022,2022-03-31,2,2022,20422,4
Bureau,Department of the Treasury,U.S. Mint,null,96.62697743447903,95.45454545454545,1000,1,28647,21,31,03,1,2022,2022-03-31,2,2022,29647,22
Bureau,Department of Justice,Federal Prison Industries,null,0.0,0.0,132589,20,0,0,31,03,1,2022,2022-03-31,2,2022,132589,20
Bureau,Department of the Interior,Geological Survey,null,100.0,100.0,0,0,139195,391,31,03,1,2022,2022-03-31,2,2022,139195,391
Bureau,Other Agencies,James Madison Memorial Fellowship,null,0.0,0.0,193379,24,0,0,31,03,1,2022,2022-03-31,2,2022,193379,24
Bureau,Department of the Treasury,Internal Revenue Service,null,100.0,100.0,0,0,209894,68,31,03,1,2022,2022-03-31,2,2022,209894,68
Bureau,Securities & Exchange Commission,Securities and Exchange Commission,null,100.0,100.0,0,0,241264,48,31,03,1,2022,2022-03-31,2,2022,241264,48
Bureau,Legislative Branch - U.S. House/Senate,U.S. House of Representatives,null,0.0,0.0,276073,203,0,0,31,03,1,2022,2022-03-31,2,2022,276073,203
Bureau,Department of Health & Human Services,Office of the Secretary,null,100.0,100.0,0,0,279897,8,31,03,1,2022,2022-03-31,2,2022,279897,8
Bureau,Department of Commerce,Nat'l Telecomm & Information Admin.,null,100.0,100.0,0,0,296094,1,31,03,1,2022,2022-03-31,2,2022,296094,1
Bureau,Department of Justice,Drug Enforcement Administration,null,100.0,100.0,0,0,364925,23,31,03,1,2022,2022-03-31,2,2022,364925,23
Bureau,Federal Maritime Commission,Salaries and Expenses,null,100.0,100.0,0,0,397583,6,31,03,1,2022,2022-03-31,2,2022,397583,6
Bureau,Department of Justice,Federal Bureau of Investigation,null,100.0,100.0,0,0,406152,86,31,03,1,2022,2022-03-31,2,2022,406152,86
Bureau,Other Agencies,Chemical Safety Board,null,100.0,100.0,0,0,33630,2,31,03,1,2022,2022-03-31,2,2022,33630,2
Bureau,Department of the Treasury,Bureau of Engraving and Printing,null,0.0,0.0,38345,2,0,0,31,03,1,2022,2022-03-31,2,2022,38345,2
Bureau,Department of Transportation,National Highway Traffic Safety Admin.,null,100.0,100.0,0,0,38855,7,31,03,1,2022,2022-03-31,2,2022,38855,7
Bureau,Other Agencies,Architect of the Capitol,null,0.0,0.0,38896,17,0,0,31,03,1,2022,2022-03-31,2,2022,38896,17
Bureau,Department of the Interior,Bureau of Reclamation,null,100.0,100.0,0,0,77076,58,31,03,1,2022,2022-03-31,2,2022,77076,58
Bureau,Department of Transportation,Pipeline Hazardous Material Safety Admin,null,100.0,100.0,0,0,476876,38,31,03,1,2022,2022-03-31,2,2022,476876,38
Bureau,Department of the Treasury,D.C. Pension Program,null,100.0,100.0,0,0,477970,22,31,03,1,2022,2022-03-31,2,2022,477970,22
Bureau,National Science Foundation,National Science Foundation,null,100.0,100.0,0,0,561973,58,31,03,1,2022,2022-03-31,2,2022,561973,58
Bureau,Department of Commerce,Patent and Trademark Office,null,100.0,100.0,0,0,624529,865,31,03,1,2022,2022-03-31,2,2022,624529,865
Bureau,Other Agencies,Consumer Financial Protection Bureau,null,3.276390347575276,6.25,624407,15,21151,1,31,03,1,2022,2022-03-31,2,2022,645558,16
Bureau,Department of Commerce,Nat'l Institute of Standards& Technology,null,100.0,100.0,0,0,673322,5,31,03,1,2022,2022-03-31,2,2022,673322,5
Bureau,Department of the Interior,Fish and Wildlife Service,null,100.0,100.0,0,0,752603,65,31,03,1,2022,2022-03-31,2,2022,752603,65
Bureau,Department of Transportation,Federal Transit Administration,null,100.0,100.0,0,0,783404,1,31,03,1,2022,2022-03-31,2,2022,783404,1
Bureau,Department of Housing and Urban Development,Management and Administration,null,0.557953209375022,15.384615384615385,847467,11,4755,2,31,03,1,2022,2022-03-31,2,2022,852222,13
Bureau,Department of Veterans Affairs,Housing Credit Assistance,null,0.0,0.0,909154,28,0,0,31,03,1,2022,2022-03-31,2,2022,909154,28
Bureau,Department of Transportation,Federal Aviation Administration,null,99.28008077267185,97.21448467966574,16906,10,2331413,349,31,03,1,2022,2022-03-31,2,2022,2348319,359
Bureau,Nuclear Regulatory Commission,Nuclear Regulatory Commission,null,100.0,100.0,0,0,2780487,353,31,03,1,2022,2022-03-31,2,2022,2780487,353
Bureau,Department of Commerce,Bureau of the Census,null,100.0,100.0,0,0,4364808,17782,31,03,1,2022,2022-03-31,2,2022,4364808,17782
Bureau,Legislative Branch-GPO,Government Publishing Office,null,100.0,100.0,0,0,75651,9,31,03,1,2022,2022-03-31,2,2022,75651,9
Bureau,Department of Labor,Employment and Training Administration,null,100.0,100.0,0,0,925026,10,31,03,1,2022,2022-03-31,2,2022,925026,10
Bureau,Department of Justice,Office of Justice Assistance Programs,null,100.0,100.0,0,0,937770,3,31,03,1,2022,2022-03-31,2,2022,937770,3
Bureau,The Judiciary,Administrative Office of the U.S. Courts,null,98.81284736070351,56.50684931506849,11966,127,995992,165,31,03,1,2022,2022-03-31,2,2022,1007958,292
Bureau,Department of Agriculture,Food Safety and Inspection Service,null,96.30401813978827,97.30200174064404,37653,31,981102,1118,31,03,1,2022,2022-03-31,2,2022,1018755,1149
Bureau,Department of Homeland Security,Citizenship and Immigration Services,null,100.0,100.0,0,0,1053467,1252,31,03,1,2022,2022-03-31,2,2022,1053467,1252
Bureau,Department of Energy,Bonneville Power Administration,null,100.0,100.0,0,0,1063505,28,31,03,1,2022,2022-03-31,2,2022,1063505,28
Bureau,Department of Veterans Affairs,Life Insurance,null,100.0,100.0,0,0,1076110,198,31,03,1,2022,2022-03-31,2,2022,1076110,198
Bureau,Department of Transportation,Office of the Secretary,null,100.0,100.0,0,0,1081949,15,31,03,1,2022,2022-03-31,2,2022,1081949,15
Bureau,Funds Appropriated to the President,Trade and Development Agency,null,0.0,0.0,1236060,7,0,0,31,03,1,2022,2022-03-31,2,2022,1236060,7
Bureau,Federal Election Commission,Federal Election Commission,null,100.0,100.0,0,0,1357375,209,31,03,1,2022,2022-03-31,2,2022,1357375,209
Bureau,Corp. for National and Community Service,Corp. for National and Community Service,null,91.95825495950929,39.01808785529716,313124,236,3580608,151,31,03,1,2022,2022-03-31,2,2022,3893732,387
Bureau,Department of the Interior,Office of Natural Resources Revenue,null,100.0,100.0,0,0,5558073,522,31,03,1,2022,2022-03-31,2,2022,5558073,522
Bureau,Department of Agriculture,Agricultural Marketing Service,null,88.41132281201102,21.26111560226354,654700,1948,4994780,526,31,03,1,2022,2022-03-31,2,2022,5649480,2474
Bureau,Department of Health & Human Services,Program Support Center,null,100.0,100.0,0,0,5985418,329,31,03,1,2022,2022-03-31,2,2022,5985418,329
Bureau,Department of the Interior,Office of Surface Mining,null,100.0,100.0,0,0,7742208,370,31,03,1,2022,2022-03-31,2,2022,7742208,370
Bureau,Department of the Interior,National Park Service,null,100.0,100.0,0,0,8308465,2194,31,03,1,2022,2022-03-31,2,2022,8308465,2194
Bureau,Department of the Treasury,Financial Crimes Enforcement Network,null,100.0,100.0,0,0,1544945,3,31,03,1,2022,2022-03-31,2,2022,1544945,3
Bureau,National Aeronautics and Space Administration,National Aeronautics and Space Admin,null,100.0,100.0,0,0,1558415,128,31,03,1,2022,2022-03-31,2,2022,1558415,128
Bureau,Presidio Trust Corporation,Presidio Trust Corporation,null,89.98204100032355,81.48148148148148,165339,15,1485087,66,31,03,1,2022,2022-03-31,2,2022,1650426,81
Bureau,Department of Veterans Affairs,Administration and Cemeteries,null,1.914715462763237,3.3112582781456954,1823889,876,35604,30,31,03,1,2022,2022-03-31,2,2022,1859493,906
Bureau,Department of the Interior,Bureau of Land Management,null,100.0,100.0,0,0,9049748,380,31,03,1,2022,2022-03-31,2,2022,9049748,380
Bureau,Department of Homeland Security,Bureau of Customs & Border Protection,null,100.0,100.0,0,0,9483551,666,31,03,1,2022,2022-03-31,2,2022,9483551,666
Bureau,Department of Homeland Security,Transportation Safety Administration,null,100.0,100.0,0,0,9730261,7021,31,03,1,2022,2022-03-31,2,2022,9730261,7021
Bureau,Department of Agriculture,Food and Nutrition Service,null,0.4617926051322905,1.092896174863388,10555573,362,48971,4,31,03,1,2022,2022-03-31,2,2022,10604544,366
Bureau,Department of Health & Human Services,Centers for Disease Control,null,1.339140285094161,17.0,11832832,83,160609,17,31,03,1,2022,2022-03-31,2,2022,11993441,100
Bureau,Office of Personnel Management,Office of Personnel Management,null,93.3594015008753,87.73333333333333,803619,92,11297986,658,31,03,1,2022,2022-03-31,2,2022,12101605,750
Bureau,Department of Commerce,NOAA,null,100.0,100.0,0,0,12654849,973,31,03,1,2022,2022-03-31,2,2022,12654849,973
Bureau,Department of Energy,Energy Consolidated Reports,null,100.0,100.0,0,0,12669940,75,31,03,1,2022,2022-03-31,2,2022,12669940,75
Bureau,Department of the Treasury,Bureau of the Fiscal Service,null,100.0,100.0,0,0,13731644,3533,31,03,1,2022,2022-03-31,2,2022,13731644,3533
Bureau,Department of Homeland Security,Immigration and Customs Enforcement,null,100.0,100.0,0,0,14685613,625,31,03,1,2022,2022-03-31,2,2022,14685613,625
Bureau,General Services Administration,General Services Administration,null,90.90873747273501,75.05175983436853,1398368,482,13983082,1450,31,03,1,2022,2022-03-31,2,2022,15381450,1932
Bureau,Department of the Interior,Bureau of Indian Affairs,null,99.93556097486997,99.93745004691246,10835,18,16803510,28759,31,03,1,2022,2022-03-31,2,2022,16814345,28777
Bureau,Department of State,Department of State,null,99.79862292918273,99.56626506024097,36258,36,17968771,8264,31,03,1,2022,2022-03-31,2,2022,18005029,8300
Bureau,Department of Labor,Mine Safety and Health Administration,null,69.27138147409353,62.49187784275504,5726267,2309,12908697,3847,31,03,1,2022,2022-03-31,2,2022,18634964,6156
Bureau,Department of Labor,Employee Benefit Security Administration,null,100.0,100.0,0,0,19896566,473,31,03,1,2022,2022-03-31,2,2022,19896566,473
Bureau,Department of Agriculture,U.S. Department of Agriculture,null,77.09030984848499,38.45975948196115,4998263,2661,16818981,1663,31,03,1,2022,2022-03-31,2,2022,21817244,4324
Bureau,Department of Health & Human Services,National Institutes of Health,null,26.673890843154023,11.791907514450868,17399977,763,6329602,102,31,03,1,2022,2022-03-31,2,2022,23729579,865
Bureau,Environmental Protection Agency,Environmental Protection Agency,null,99.93794293155732,99.3103448275862,16146,2,26001841,288,31,03,1,2022,2022-03-31,2,2022,26017987,290
Bureau,Department of Commerce,Bureau of Industry and Security,null,100.0,100.0,0,0,37054089,28,31,03,1,2022,2022-03-31,2,2022,37054089,28
Bureau,Agency for International Development,Agency for International Development,null,100.0,100.0,0,0,38827209,54,31,03,1,2022,2022-03-31,2,2022,38827209,54
Bureau,Department of Health & Human Services,Indian Health Services,null,99.9999984246789,100.0,1,0,63479121,3875,31,03,1,2022,2022-03-31,2,2022,63479122,3875
Bureau,Department of Transportation,Federal Motor Carrier Safety Admin,null,100.0,100.0,0,0,65052651,7211,31,03,1,2022,2022-03-31,2,2022,65052651,7211
Bureau,Department of Agriculture,Forest Service,null,91.33611338303488,30.21459227467811,6210005,813,65466891,352,31,03,1,2022,2022-03-31,2,2022,71676896,1165
Bureau,Department of Education,Federal Student Aid,null,100.0,100.0,0,0,125715039385,21652019,31,03,1,2022,2022-03-31,2,2022,125715039385,21652019
Bureau,Department of Labor,Employment Standards Administration,null,76.50281094867101,26.264330736016674,20406440,14857,66439863,5292,31,03,1,2022,2022-03-31,2,2022,86846303,20149
Bureau,Department of Health & Human Services,Health Resources and Services Admin,null,100.0,100.0,0,0,112301111,662,31,03,1,2022,2022-03-31,2,2022,112301111,662
Bureau,Department of Health & Human Services,Food and Drug Administration,null,28.530759601960774,8.210515313055295,89773254,17563,35837783,1571,31,03,1,2022,2022-03-31,2,2022,125611037,19134
Bureau,Department of Housing and Urban Development,Housing Programs,null,100.0,100.0,0,0,138161770,4464,31,03,1,2022,2022-03-31,2,2022,138161770,4464
Bureau,Department of Agriculture,Commodity Credit Corporation,null,100.0,100.0,0,0,140519765,10506,31,03,1,2022,2022-03-31,2,2022,140519765,10506
Bureau,Federal Communications Commission,Federal Communications Commission,null,100.0,100.0,0,0,224360279,13425,31,03,1,2022,2022-03-31,2,2022,224360279,13425
Bureau,Department of Veterans Affairs,Medical and Construction,null,99.72474961200031,99.93636175791497,662414,2122,239996284,3332351,31,03,1,2022,2022-03-31,2,2022,240658698,3334473
Bureau,Department of Homeland Security,Emergency Preparedness & Resp,null,100.0,100.0,0,0,241402700,40044,31,03,1,2022,2022-03-31,2,2022,241402700,40044
Bureau,Federal Trade Commission,Federal Trade Commission,null,100.0,100.0,0,0,482197221,73,31,03,1,2022,2022-03-31,2,2022,482197221,73
Bureau,Commodity Futures Trading Commission,Commodity Futures Trading Commission,null,100.0,100.0,0,0,662771313,362,31,03,1,2022,2022-03-31,2,2022,662771313,362
Bureau,Department of Agriculture,Rural Development,null,99.98868836951614,99.49867185454,84471,134,746677900,26595,31,03,1,2022,2022-03-31,2,2022,746762371,26729
Bureau,Department of Agriculture,Farm Service Agency,null,100.0,100.0,0,0,804274477,13423,31,03,1,2022,2022-03-31,2,2022,804274477,13423
Bureau,Department of Education,Departmental Management,null,92.66401944983915,87.67313019390582,101871233,267,1286780663,1899,31,03,1,2022,2022-03-31,2,2022,1388651896,2166
Bureau,Securities & Exchange Commission,SEC Enforcement,null,100.0,100.0,0,0,2138806537,1135,31,03,1,2022,2022-03-31,2,2022,2138806537,1135
Bureau,Department of Defense,Consolidated Report,null,34.86689722308553,18.175632617296408,1918941338,1232635,1027243100,273805,31,03,1,2022,2022-03-31,2,2022,2946184438,1506440
Bureau,Social Security Administration,Social Security Administration,null,60.07402872383431,34.137587493938305,1756574978,873302,2643004849,452647,31,03,1,2022,2022-03-31,2,2022,4399579827,1325949
Bureau,Department of Health & Human Services,Centers for Medicare & Medicaid Services,null,99.09825429908635,99.124845328192,82203046,9732,9033786741,1102300,31,03,1,2022,2022-03-31,2,2022,9115989787,1112032
Bureau,Department of the Treasury,Tobacco Tax and Trade,null,100.0,100.0,0,0,1000,1,31,03,1,2022,2022-03-31,2,2022,1000,1
Bureau,Department of the Treasury,Office of Financial Research,null,100.0,100.0,0,0,268,1,31,03,1,2022,2022-03-31,2,2022,268,1
Bureau,Other Agencies,Morris K. Udall Scholarship,null,0.0,0.0,0,0,0,0,31,03,1,2022,2022-03-31,2,2022,0,0
Bureau,Funds Appropriated to the President,Inter-American Foundation,null,0.0,0.0,0,0,0,0,31,03,1,2022,2022-03-31,2,2022,0,0
Bureau,Other Agencies/Boards/Commissions,U.S. Comm. on Int. Religious Freedom,null,0.0,0.0,1024,1,0,0,31,03,1,2022,2022-03-31,2,2022,1024,1
Bureau,Other Agencies,Federal Mine Safety & Health Review Comm,null,0.0,0.0,0,0,0,0,30,06,2,2022,2022-06-30,3,2022,0,0
Bureau,Other Agencies,Consumer Financial Protection Bureau,null,6.607198763690855,26.666666666666668,2989031,11,211463,4,30,06,2,2022,2022-06-30,3,2022,3200494,15
Bureau,Department of Commerce,Bureau of the Census,null,100.0,100.0,0,0,3992122,16598,30,06,2,2022,2022-06-30,3,2022,3992122,16598
Bureau,Department of the Interior,Bureau of Land Management,null,100.0,100.0,0,0,9020207,334,30,06,2,2022,2022-06-30,3,2022,9020207,334
Bureau,Department of Homeland Security,Transportation Safety Administration,null,100.0,100.0,0,0,9369625,4200,30,06,2,2022,2022-06-30,3,2022,9369625,4200
Bureau,Department of the Treasury,Financial Crimes Enforcement Network,null,100.0,100.0,0,0,1544945,3,30,06,2,2022,2022-06-30,3,2022,1544945,3
Bureau,Department of Homeland Security,Bureau of Customs & Border Protection,null,100.0,100.0,0,0,9406446,644,30,06,2,2022,2022-06-30,3,2022,9406446,644
Bureau,Department of Energy,Energy Consolidated Reports,null,100.0,100.0,0,0,12636589,57,30,06,2,2022,2022-06-30,3,2022,12636589,57
Bureau,Department of Transportation,Federal Motor Carrier Safety Admin,null,100.0,100.0,0,0,66296225,7367,30,06,2,2022,2022-06-30,3,2022,66296225,7367
Bureau,Federal Communications Commission,Federal Communications Commission,null,100.0,100.0,0,0,235032516,13186,30,06,2,2022,2022-06-30,3,2022,235032516,13186
Bureau,Funds Appropriated to the President,Defense Security Assistance Agency,null,0.0,0.0,0,0,0,0,30,06,2,2022,2022-06-30,3,2022,0,0
Bureau,Department of Justice,Federal Prison System,null,0.0,0.0,0,0,0,0,30,06,2,2022,2022-06-30,3,2022,0,0
Bureau,Tennessee Valley Authority,Tennessee Valley Authority,null,0.0,0.0,0,0,0,0,30,06,2,2022,2022-06-30,3,2022,0,0
Bureau,Department of Homeland Security,Management Headquarters,null,0.0,0.0,0,0,0,0,30,06,2,2022,2022-06-30,3,2022,0,0
Bureau,Other Agencies,Federal Housing Finance Agency OIG,null,0.0,0.0,0,0,0,0,30,06,2,2022,2022-06-30,3,2022,0,0
Bureau,Department of Homeland Security,Emergency Preparedness & Resp,null,100.0,100.0,0,0,240249408,39539,30,06,2,2022,2022-06-30,3,2022,240249408,39539
Bureau,Department of Commerce,National Technical Information Service,null,0.0,0.0,0,0,0,0,30,06,2,2022,2022-06-30,3,2022,0,0
Bureau,Other Agencies,Surface Transportation Board,null,0.0,0.0,0,0,0,0,30,06,2,2022,2022-06-30,3,2022,0,0
Bureau,Department of the Interior,Office of the Secretary,null,100.0,100.0,0,0,35272,16,30,06,2,2022,2022-06-30,3,2022,35272,16
Agency,U.S. Tax Court,null,Non-CFO,0.0,0.0,0,0,0,0,30,06,2,2022,2022-06-30,3,2022,0,0
Bureau,Department of Health & Human Services,Substance Abuse & Mental Health Admin.,null,100.0,100.0,0,0,1038389,12,30,06,2,2022,2022-06-30,3,2022,1038389,12
Bureau,Department of Homeland Security,Citizenship and Immigration Services,null,100.0,100.0,0,0,1055753,1241,30,06,2,2022,2022-06-30,3,2022,1055753,1241
Bureau,Department of Energy,Bonneville Power Administration,null,100.0,100.0,0,0,1061842,25,30,06,2,2022,2022-06-30,3,2022,1061842,25
Bureau,Department of Transportation,Office of the Secretary,null,100.0,100.0,0,0,1091474,15,30,06,2,2022,2022-06-30,3,2022,1091474,15
Bureau,Department of Agriculture,Food Safety and Inspection Service,null,95.91366533878674,96.85714285714286,46078,33,1081534,1017,30,06,2,2022,2022-06-30,3,2022,1127612,1050
Bureau,Department of Veterans Affairs,Life Insurance,null,100.0,100.0,0,0,1150403,213,30,06,2,2022,2022-06-30,3,2022,1150403,213
Bureau,Funds Appropriated to the President,Trade and Development Agency,null,0.0,0.0,1236060,7,0,0,30,06,2,2022,2022-06-30,3,2022,1236060,7
Bureau,Department of Veterans Affairs,Veterans Benefits,null,0.0,0.0,1251121,1649,0,0,30,06,2,2022,2022-06-30,3,2022,1251121,1649
Bureau,Department of Veterans Affairs,Administration and Cemeteries,null,2.465531212929744,3.2402234636871508,1349246,866,34107,29,30,06,2,2022,2022-06-30,3,2022,1383353,895
Bureau,Department of the Treasury,Comptroller of the Currency,null,99.65589456058768,95.65217391304348,5000,1,1448043,22,30,06,2,2022,2022-06-30,3,2022,1453043,23
Agency,Department of Energy,null,CFO,100.0,100.0,0,0,13698431,82,30,06,2,2022,2022-06-30,3,2022,13698431,82
Bureau,National Aeronautics and Space Administration,National Aeronautics and Space Admin,null,100.0,100.0,0,0,1584125,130,30,06,2,2022,2022-06-30,3,2022,1584125,130
Bureau,Federal Election Commission,Federal Election Commission,null,100.0,100.0,0,0,1655281,256,30,06,2,2022,2022-06-30,3,2022,1655281,256
Bureau,Presidio Trust Corporation,Presidio Trust Corporation,null,90.39372932862318,81.0126582278481,159542,15,1501269,64,30,06,2,2022,2022-06-30,3,2022,1660811,79
Bureau,Department of State,Passport NSF,null,100.0,100.0,0,0,1956842,12611,30,06,2,2022,2022-06-30,3,2022,1956842,12611
Bureau,Department of Housing and Urban Development,Public and Indian Housing Programs,null,0.0,0.0,2370495,15,0,0,30,06,2,2022,2022-06-30,3,2022,2370495,15
Bureau,Department of Transportation,Federal Aviation Administration,null,95.66219291574602,88.28337874659401,106150,43,2340939,324,30,06,2,2022,2022-06-30,3,2022,2447089,367
Bureau,Department of Agriculture,Food and Nutrition Service,null,2.129685294651706,13.432835820895523,2635674,116,57353,18,30,06,2,2022,2022-06-30,3,2022,2693027,134
Bureau,Nuclear Regulatory Commission,Nuclear Regulatory Commission,null,100.0,100.0,0,0,2876643,346,30,06,2,2022,2022-06-30,3,2022,2876643,346
Bureau,Pension Benefit Guaranty Corp,Pension Benefit Guaranty Corporation,null,100.0,100.0,0,0,3115924,1173,30,06,2,2022,2022-06-30,3,2022,3115924,1173
Bureau,Department of the Treasury,Community Dev Financial Inst Fund,null,100.0,100.0,0,0,4559319,10,30,06,2,2022,2022-06-30,3,2022,4559319,10
Bureau,Department of the Interior,Office of Natural Resources Revenue,null,100.0,100.0,0,0,4667708,521,30,06,2,2022,2022-06-30,3,2022,4667708,521
Bureau,Department of Homeland Security,U.S. Coast Guard,null,0.0,0.0,4724124,13127,0,0,30,06,2,2022,2022-06-30,3,2022,4724124,13127
Bureau,Department of Commerce,Economic Development Administration,null,100.0,100.0,0,0,5137182,12,30,06,2,2022,2022-06-30,3,2022,5137182,12
Bureau,Department of Agriculture,Agricultural Marketing Service,null,82.55006659647492,24.567901234567902,1126838,1833,5330711,597,30,06,2,2022,2022-06-30,3,2022,6457549,2430
Bureau,Department of the Interior,Office of Surface Mining,null,100.0,100.0,0,0,8013807,374,30,06,2,2022,2022-06-30,3,2022,8013807,374
Bureau,Department of the Interior,National Park Service,null,100.0,100.0,0,0,8458241,2010,30,06,2,2022,2022-06-30,3,2022,8458241,2010
Bureau,Department of Health & Human Services,Centers for Disease Control,null,1.894354245663089,15.533980582524272,8364713,87,161517,16,30,06,2,2022,2022-06-30,3,2022,8526230,103
Bureau,Department of Labor,Mine Safety and Health Administration,null,82.46954037879006,71.32787630741247,2192198,1261,10312882,3137,30,06,2,2022,2022-06-30,3,2022,12505080,4398
Bureau,Department of Labor,Employee Benefit Security Administration,null,100.0,100.0,0,0,21535331,503,30,06,2,2022,2022-06-30,3,2022,21535331,503
Agency,Tennessee Valley Authority,null,Non-CFO,0.0,0.0,0,0,0,0,30,06,2,2022,2022-06-30,3,2022,0,0
Agency,Selective Service System,null,Non-CFO,0.0,0.0,0,0,0,0,30,06,2,2022,2022-06-30,3,2022,0,0
Bureau,Department of Housing and Urban Development,Housing Programs,null,100.0,100.0,0,0,99071843,3719,30,06,2,2022,2022-06-30,3,2022,99071843,3719
Agency,Smithsonian Institution,null,Non-CFO,0.0,0.0,0,0,0,0,30,06,2,2022,2022-06-30,3,2022,0,0
Bureau,Other Agencies,U.S. Inst. for Env. Conflict Resolution,null,0.0,0.0,4178,1,0,0,30,06,2,2022,2022-06-30,3,2022,4178,1
Bureau,Department of Health & Human Services,Administration for Children and Families,null,100.0,100.0,0,0,34567345,1741,30,06,2,2022,2022-06-30,3,2022,34567345,1741
Bureau,Department of Health & Human Services,Program Support Center,null,100.0,100.0,0,0,6056509,307,30,06,2,2022,2022-06-30,3,2022,6056509,307
Bureau,Department of State,Department of State,null,99.36225037795914,99.77415553809898,144433,23,22502856,10161,30,06,2,2022,2022-06-30,3,2022,22647289,10184
Bureau,Department of Health & Human Services,National Institutes of Health,null,25.836703099314725,11.542730299667037,18640783,797,6493999,104,30,06,2,2022,2022-06-30,3,2022,25134782,901
Bureau,Department of the Treasury,Spec Insp Gen-Troubled Asset Rel Prog,null,100.0,100.0,0,0,3916,1,30,06,2,2022,2022-06-30,3,2022,3916,1
Bureau,Department of the Interior,Bureau of Reclamation,null,100.0,100.0,0,0,7332125,67,30,06,2,2022,2022-06-30,3,2022,7332125,67
Bureau,Department of Commerce,NOAA,null,100.0,100.0,0,0,12822018,981,30,06,2,2022,2022-06-30,3,2022,12822018,981
Agency,Small Business Administration,null,CFO,100.0,100.0,0,0,13770704135,122724,30,06,2,2022,2022-06-30,3,2022,13770704135,122724
Agency,Department of Education,null,CFO,99.92446769888893,99.99895443696524,95094377,225,125803859582,21519281,30,06,2,2022,2022-06-30,3,2022,125898953959,21519506
Agency,Social Security Administration,null,CFO,59.703118468542996,33.81944934149517,1759716756,872803,2607163978,446018,30,06,2,2022,2022-06-30,3,2022,4366880734,1318821
Bureau,Environmental Protection Agency,Environmental Protection Agency,null,99.96248169891506,99.29328621908127,9798,2,26105457,281,30,06,2,2022,2022-06-30,3,2022,26115255,283
Agency,Department of Justice,null,CFO,96.01927725048635,98.77482589631158,3673360,475,88605360,38295,30,06,2,2022,2022-06-30,3,2022,92278720,38770
Bureau,Federal Trade Commission,Federal Trade Commission,null,100.0,100.0,0,0,482184354,68,30,06,2,2022,2022-06-30,3,2022,482184354,68
Agency,Department of Housing and Urban Development,null,CFO,96.87832758463212,99.35914552736983,3192509,24,99076678,3721,30,06,2,2022,2022-06-30,3,2022,102269187,3745
Agency,Department of Labor,null,CFO,86.9211720136525,51.53723778164194,24220511,13099,160968185,13930,30,06,2,2022,2022-06-30,3,2022,185188696,27029
Bureau,Export - Import  Bank,Export-Import Bank,null,0.0,0.0,0,0,0,0,30,06,2,2022,2022-06-30,3,2022,0,0
Agency,Department of Transportation,null,CFO,99.85114880449983,99.45040899795501,106150,43,71206680,7781,30,06,2,2022,2022-06-30,3,2022,71312830,7824
Agency,Department of Homeland Security,null,CFO,98.30924838573289,77.8736019404393,4725382,13136,274758722,46232,30,06,2,2022,2022-06-30,3,2022,279484104,59368
Bureau,Selective Service System,Selective Service System,null,0.0,0.0,0,0,0,0,30,06,2,2022,2022-06-30,3,2022,0,0
Agency,National Aeronautics and Space Administration,null,CFO,100.0,100.0,0,0,1584125,130,30,06,2,2022,2022-06-30,3,2022,1584125,130
Agency,Nuclear Regulatory Commission,null,CFO,100.0,100.0,0,0,2876643,346,30,06,2,2022,2022-06-30,3,2022,2876643,346
Agency,Office of Personnel Management,null,CFO,90.65517746423863,82.52873563218391,1205883,152,11698407,718,30,06,2,2022,2022-06-30,3,2022,12904290,870
Agency,Agency for International Development,null,CFO,100.0,100.0,0,0,38018886,56,30,06,2,2022,2022-06-30,3,2022,38018886,56
Agency,Department of the Treasury,null,CFO,98.82382800240816,99.47235120303925,516251,25,43376224,4713,30,06,2,2022,2022-06-30,3,2022,43892475,4738
Agency,Department of the Interior,null,CFO,99.97713222522074,99.54471747536485,12621,146,55178582,31922,30,06,2,2022,2022-06-30,3,2022,55191203,32068
Agency,Department of Commerce,null,CFO,100.0,100.0,0,0,61105615,18287,30,06,2,2022,2022-06-30,3,2022,61105615,18287
Agency,Department of Veterans Affairs,null,CFO,55.77361687755386,97.96396984827817,157023711,44389,198021626,2135785,30,06,2,2022,2022-06-30,3,2022,355045337,2180174
Agency,Department of Agriculture,null,CFO,99.24070494341962,91.87878003816424,14123069,5022,1845900762,56816,30,06,2,2022,2022-06-30,3,2022,1860023831,61838
Agency,National Science Foundation,null,CFO,100.0,100.0,0,0,561275,62,30,06,2,2022,2022-06-30,3,2022,561275,62
Agency,Department of Health & Human Services,null,CFO,97.83973525343715,97.43205083726016,210551126,29237,9535991576,1109298,30,06,2,2022,2022-06-30,3,2022,9746542702,1138535
Bureau,Department of Commerce,Bureau of Industry and Security,null,100.0,100.0,0,0,37692341,28,30,06,2,2022,2022-06-30,3,2022,37692341,28
Bureau,Agency for International Development,Agency for International Development,null,100.0,100.0,0,0,38018886,56,30,06,2,2022,2022-06-30,3,2022,38018886,56
Bureau,Department of Health & Human Services,Indian Health Services,null,100.0,100.0,0,0,65220527,4073,30,06,2,2022,2022-06-30,3,2022,65220527,4073
Bureau,Department of Labor,Occupational Safety and Health Admin,null,93.57698137085355,79.9450105126961,4275706,1240,62292776,4943,30,06,2,2022,2022-06-30,3,2022,66568482,6183
Bureau,U.S. Postal Service,U.S. Postal Service,null,83.23025289828072,78.78755149588804,11943324,13748,59276140,51063,30,06,2,2022,2022-06-30,3,2022,71219464,64811
Bureau,Department of Agriculture,Forest Service,null,91.18617694270266,30.887096774193548,6455571,857,66788139,383,30,06,2,2022,2022-06-30,3,2022,73243710,1240
Bureau,Department of Veterans Affairs,Medical and Construction,null,56.15992760404249,98.07806594133343,153655196,41848,196835092,2135542,30,06,2,2022,2022-06-30,3,2022,350490288,2177390
Bureau,Commodity Futures Trading Commission,Commodity Futures Trading Commission,null,100.0,100.0,0,0,665216746,362,30,06,2,2022,2022-06-30,3,2022,665216746,362
Bureau,Department of Agriculture,Farm Service Agency,null,100.0,100.0,0,0,804888406,13223,30,06,2,2022,2022-06-30,3,2022,804888406,13223
Bureau,Department of Agriculture,Rural Development,null,99.99184187213646,99.6437746189416,66214,104,811566076,29091,30,06,2,2022,2022-06-30,3,2022,811632290,29195
Agency,Equal Employment Opportunity Commission,null,Non-CFO,100.0,100.0,0,0,15191,15,30,06,2,2022,2022-06-30,3,2022,15191,15
Agency,The Judiciary,null,Non-CFO,98.81731429729236,57.0945945945946,11966,127,999799,169,30,06,2,2022,2022-06-30,3,2022,1011765,296
Agency,Funds Appropriated to the President,null,Non-CFO,0.0,0.0,1236060,7,0,0,30,06,2,2022,2022-06-30,3,2022,1236060,7
Agency,Federal Election Commission,null,Non-CFO,100.0,100.0,0,0,1655281,256,30,06,2,2022,2022-06-30,3,2022,1655281,256
Agency,Presidio Trust Corporation,null,Non-CFO,90.39372932862318,81.0126582278481,159542,15,1501269,64,30,06,2,2022,2022-06-30,3,2022,1660811,79
Agency,Pension Benefit Guaranty Corp,null,Non-CFO,100.0,100.0,0,0,3115924,1173,30,06,2,2022,2022-06-30,3,2022,3115924,1173
Agency,Other Agencies,null,Non-CFO,7.178560953925962,11.11111111111111,3240790,64,250634,8,30,06,2,2022,2022-06-30,3,2022,3491424,72
Agency,Railroad Retirement Board,null,Non-CFO,100.0,100.0,0,0,21103690,3999,30,06,2,2022,2022-06-30,3,2022,21103690,3999
Agency,U.S. Postal Service,null,Non-CFO,83.23025289828072,78.78755149588804,11943324,13748,59276140,51063,30,06,2,2022,2022-06-30,3,2022,71219464,64811
Bureau,Legislative Branch-Office of Tech.,Open World Leadership,null,0.0,0.0,0,0,0,0,30,06,2,2022,2022-06-30,3,2022,0,0
Bureau,Department of Commerce,Office of the Inspector General,null,0.0,0.0,0,0,0,0,30,06,2,2022,2022-06-30,3,2022,0,0
Bureau,Office of Special Counsel,Office of Special Counsel,null,0.0,0.0,0,0,0,0,30,06,2,2022,2022-06-30,3,2022,0,0
Bureau,Other Agencies/Boards/Commissions,U.S.-China Security Review Commission,null,0.0,0.0,0,0,0,0,30,06,2,2022,2022-06-30,3,2022,0,0
Bureau,American Battle Monuments Commission,American Battle Monuments Commission,null,0.0,0.0,0,0,0,0,30,06,2,2022,2022-06-30,3,2022,0,0
Bureau,Other Agencies,National Capital Planning Commission,null,0.0,0.0,0,0,0,0,30,06,2,2022,2022-06-30,3,2022,0,0
Bureau,Other Agencies,Denali Commission,null,0.0,0.0,0,0,0,0,30,06,2,2022,2022-06-30,3,2022,0,0
Bureau,Department of Labor,Employment Standards Administration,null,78.77706542948553,33.488138571607884,17752607,10598,65895613,5336,30,06,2,2022,2022-06-30,3,2022,83648220,15934
Bureau,Department of Justice,Legal Activities,null,96.08075151452033,98.80425498874136,3543437,462,86867697,38175,30,06,2,2022,2022-06-30,3,2022,90411134,38637
Bureau,Department of Health & Human Services,Health Resources and Services Admin,null,100.0,100.0,0,0,117758457,664,30,06,2,2022,2022-06-30,3,2022,117758457,664
Bureau,Department of Health & Human Services,Food and Drug Administration,null,29.25996390362438,8.346425765907306,93701352,18668,38757376,1700,30,06,2,2022,2022-06-30,3,2022,132458728,20368
Agency,Department of Defense,null,CFO,36.17002164226635,18.785530582649333,1883012801,1283027,1067031754,296774,30,06,2,2022,2022-06-30,3,2022,2950044555,1579801
Agency,Corp. for National and Community Service,null,Non-CFO,0.0,0.0,98618,8,0,0,30,06,2,2022,2022-06-30,3,2022,98618,8
Agency,Armed Forces Retirement Home,null,Non-CFO,74.20174864229865,95.32710280373831,26792,5,77060,102,30,06,2,2022,2022-06-30,3,2022,103852,107
Agency,National Archives & Records Admin,null,Non-CFO,100.0,100.0,0,0,120327,115,30,06,2,2022,2022-06-30,3,2022,120327,115
Agency,Legislative Branch - U.S. House/Senate,null,Non-CFO,0.0,0.0,274765,203,0,0,30,06,2,2022,2022-06-30,3,2022,274765,203
Agency,Federal Maritime Commission,null,Non-CFO,100.0,100.0,0,0,397704,6,30,06,2,2022,2022-06-30,3,2022,397704,6
Bureau,Funds Appropriated to the President,Inter-American Foundation,null,0.0,0.0,0,0,0,0,30,06,2,2022,2022-06-30,3,2022,0,0
Bureau,Funds Appropriated to the President,African Development Foundation,null,0.0,0.0,0,0,0,0,30,06,2,2022,2022-06-30,3,2022,0,0
Bureau,Department of Labor,Departmental Management,null,0.0,0.0,0,0,0,0,30,06,2,2022,2022-06-30,3,2022,0,0
Bureau,Department of State,Civil Monetary Penalties,null,0.0,0.0,0,0,0,0,30,06,2,2022,2022-06-30,3,2022,0,0
Bureau,Smithsonian Institution,National Gallery of Art,null,0.0,0.0,0,0,0,0,30,06,2,2022,2022-06-30,3,2022,0,0
Bureau,Other Agencies/Boards/Commissions,Nuclear Waste Technical Review Board,null,0.0,0.0,0,0,0,0,30,06,2,2022,2022-06-30,3,2022,0,0
Bureau,Department of Homeland Security,Info Analysis Infrastructure Prot-NPPD,null,0.0,0.0,0,0,0,0,30,06,2,2022,2022-06-30,3,2022,0,0
Bureau,Department of Housing and Urban Development,Community Planning and Development,null,0.0,0.0,0,0,0,0,30,06,2,2022,2022-06-30,3,2022,0,0
Bureau,Other Agencies,U.S. Holocaust Memorial Council,null,0.0,0.0,0,0,0,0,30,06,2,2022,2022-06-30,3,2022,0,0
Bureau,Other Agencies,U.S. Institute of Peace,null,0.0,0.0,0,0,0,0,30,06,2,2022,2022-06-30,3,2022,0,0
Bureau,Other Agencies,District of Columbia Government,null,0.0,0.0,0,0,0,0,30,06,2,2022,2022-06-30,3,2022,0,0
Bureau,Other Agencies,Archit.&Trans. Barriers Compliance Bd,null,0.0,0.0,0,0,0,0,30,06,2,2022,2022-06-30,3,2022,0,0
Bureau,Other Agencies,Federal Housing Finance Agency,null,0.0,0.0,0,0,0,0,30,06,2,2022,2022-06-30,3,2022,0,0
Bureau,Office of Government Ethics,Office of Government Ethics,null,0.0,0.0,0,0,0,0,30,06,2,2022,2022-06-30,3,2022,0,0
Bureau,Department of the Treasury,International Monetary Funds,null,0.0,0.0,0,0,0,0,30,06,2,2022,2022-06-30,3,2022,0,0
Bureau,Department of Homeland Security,Office of Biometric Identity Management,null,0.0,0.0,0,0,0,0,30,06,2,2022,2022-06-30,3,2022,0,0
Bureau,Department of Agriculture,Commodity Credit Corporation,null,100.0,100.0,0,0,139310515,10087,30,06,2,2022,2022-06-30,3,2022,139310515,10087
Agency,General Services Administration,null,CFO,92.36423120936473,69.47431302270012,1077757,511,13036827,1163,30,06,2,2022,2022-06-30,3,2022,14114584,1674
Agency,Department of State,null,CFO,99.4129725613963,99.89910067997369,144433,23,24459698,22772,30,06,2,2022,2022-06-30,3,2022,24604131,22795
Agency,Environmental Protection Agency,null,CFO,99.96248169891506,99.29328621908127,9798,2,26105457,281,30,06,2,2022,2022-06-30,3,2022,26115255,283
Agency,Other Agencies/Boards/Commissions,null,Non-CFO,0.0,0.0,1024,1,0,0,30,06,2,2022,2022-06-30,3,2022,1024,1
Agency,Consumer Product Safety Commission,null,Non-CFO,100.0,100.0,0,0,2500,1,30,06,2,2022,2022-06-30,3,2022,2500,1
Agency,Legislative Branch-GPO,null,Non-CFO,100.0,100.0,0,0,75651,9,30,06,2,2022,2022-06-30,3,2022,75651,9
Agency,Federal Communications Commission,null,Non-CFO,100.0,100.0,0,0,235032516,13186,30,06,2,2022,2022-06-30,3,2022,235032516,13186
Bureau,Funds Appropriated to the President,Executive Branch,null,0.0,0.0,0,0,0,0,30,06,2,2022,2022-06-30,3,2022,0,0
Bureau,Department of the Treasury,Treasury Forfeiture Fund,null,0.0,0.0,0,0,0,0,30,06,2,2022,2022-06-30,3,2022,0,0
Bureau,Other Agencies/Boards/Commissions,Medicare Payment Advisory Commission,null,0.0,0.0,0,0,0,0,30,06,2,2022,2022-06-30,3,2022,0,0
Bureau,Other Agencies,National Mediation Board,null,0.0,0.0,0,0,0,0,30,06,2,2022,2022-06-30,3,2022,0,0
Agency,Export - Import  Bank,null,Non-CFO,0.0,0.0,0,0,0,0,30,06,2,2022,2022-06-30,3,2022,0,0
Agency,Legislative Branch-Office of Tech.,null,Non-CFO,0.0,0.0,0,0,0,0,30,06,2,2022,2022-06-30,3,2022,0,0
Agency,Federal Deposit Insurance Corporation,null,Non-CFO,0.0,0.0,0,0,0,0,30,06,2,2022,2022-06-30,3,2022,0,0
Agency,Legislative Branch-CBO,null,Non-CFO,0.0,0.0,0,0,0,0,30,06,2,2022,2022-06-30,3,2022,0,0
Agency,American Battle Monuments Commission,null,Non-CFO,0.0,0.0,0,0,0,0,30,06,2,2022,2022-06-30,3,2022,0,0
Agency,Office of Special Counsel,null,Non-CFO,0.0,0.0,0,0,0,0,30,06,2,2022,2022-06-30,3,2022,0,0
Agency,Legislative Branch-GAO,null,Non-CFO,0.0,0.0,0,0,0,0,30,06,2,2022,2022-06-30,3,2022,0,0
Agency,US International Development Fin. Corp.,null,Non-CFO,0.0,0.0,0,0,0,0,30,06,2,2022,2022-06-30,3,2022,0,0
Agency,Office of Government Ethics,null,Non-CFO,0.0,0.0,0,0,0,0,30,06,2,2022,2022-06-30,3,2022,0,0
Agency,Federal Mediation/Conciliation Service,null,Non-CFO,0.0,0.0,0,0,0,0,30,06,2,2022,2022-06-30,3,2022,0,0
Agency,National Labor Relations Board,null,Non-CFO,0.0,0.0,0,0,0,0,30,06,2,2022,2022-06-30,3,2022,0,0
Agency,Federal Labor Relations Authority,null,Non-CFO,0.0,0.0,0,0,0,0,30,06,2,2022,2022-06-30,3,2022,0,0
Agency,National Foundation  Arts & Humanities,null,Non-CFO,0.0,0.0,0,0,0,0,30,06,2,2022,2022-06-30,3,2022,0,0
Agency,Office of Compliance,null,Non-CFO,0.0,0.0,0,0,0,0,30,06,2,2022,2022-06-30,3,2022,0,0
Agency,Merit Systems Protection Board,null,Non-CFO,100.0,100.0,0,0,144,1,30,06,2,2022,2022-06-30,3,2022,144,1
Agency,U.S. Court of Appeals / Veterans Claims,null,Non-CFO,0.0,0.0,337,1,0,0,30,06,2,2022,2022-06-30,3,2022,337,1
Agency,National Credit Union Administration,null,Non-CFO,100.0,100.0,0,0,500,2,30,06,2,2022,2022-06-30,3,2022,500,2
Agency,Farm Credit Administration,null,Non-CFO,100.0,100.0,0,0,630,1,30,06,2,2022,2022-06-30,3,2022,630,1
Agency,Federal Trade Commission,null,Non-CFO,100.0,100.0,0,0,482184354,68,30,06,2,2022,2022-06-30,3,2022,482184354,68
Agency,Commodity Futures Trading Commission,null,Non-CFO,100.0,100.0,0,0,665216746,362,30,06,2,2022,2022-06-30,3,2022,665216746,362
Agency,Securities & Exchange Commission,null,Non-CFO,100.0,100.0,0,0,2156970541,1169,30,06,2,2022,2022-06-30,3,2022,2156970541,1169
Agency,Legis Branch-Library of Congress,null,Non-CFO,0.0,0.0,0,0,0,0,30,06,2,2022,2022-06-30,3,2022,0,0
Bureau,Funds Appropriated to the President,Peace Corps,null,0.0,0.0,0,0,0,0,30,06,2,2022,2022-06-30,3,2022,0,0
Bureau,Department of Commerce,Minority Business Development Agency,null,0.0,0.0,0,0,0,0,30,06,2,2022,2022-06-30,3,2022,0,0
Bureau,Department of Justice,General Administration,null,0.0,0.0,0,0,0,0,30,06,2,2022,2022-06-30,3,2022,0,0
Bureau,Department of the Treasury,U.S. Treasury IG Office,null,0.0,0.0,0,0,0,0,30,06,2,2022,2022-06-30,3,2022,0,0
Bureau,Department of the Treasury,Interest on Tax/Deposit of Earnings,null,0.0,0.0,0,0,0,0,30,06,2,2022,2022-06-30,3,2022,0,0
Bureau,Smithsonian Institution,JFK Center for the Performing Arts,null,0.0,0.0,0,0,0,0,30,06,2,2022,2022-06-30,3,2022,0,0
Bureau,Federal Deposit Insurance Corporation,Federal Deposit Insurance Corporation,null,0.0,0.0,0,0,0,0,30,06,2,2022,2022-06-30,3,2022,0,0
Bureau,Federal Labor Relations Authority,Federal Labor Relations Authority,null,0.0,0.0,0,0,0,0,30,06,2,2022,2022-06-30,3,2022,0,0
Bureau,Department of Education,Office of Postsecondary Education,null,0.0,0.0,0,0,0,0,30,06,2,2022,2022-06-30,3,2022,0,0
Bureau,Federal Mediation/Conciliation Service,Federal Mediation/Conciliation Service,null,0.0,0.0,0,0,0,0,30,06,2,2022,2022-06-30,3,2022,0,0
Bureau,Other Agencies,National Transportation Safety Board,null,0.0,0.0,0,0,0,0,30,06,2,2022,2022-06-30,3,2022,0,0
Bureau,Other Agencies,Millennium Challenge Corporation,null,0.0,0.0,0,0,0,0,30,06,2,2022,2022-06-30,3,2022,0,0
Bureau,Smithsonian Institution,Administrative Conference of the US,null,0.0,0.0,0,0,0,0,30,06,2,2022,2022-06-30,3,2022,0,0
Bureau,Other Agencies,Gulf Coast Ecosystem Restoration Council,null,0.0,0.0,0,0,0,0,30,06,2,2022,2022-06-30,3,2022,0,0
Bureau,Other Agencies,Delta Regional Authority,null,0.0,0.0,0,0,0,0,30,06,2,2022,2022-06-30,3,2022,0,0
Bureau,Other Agencies,Privacy & Civil Liberties Oversight Bd,null,0.0,0.0,0,0,0,0,30,06,2,2022,2022-06-30,3,2022,0,0
Bureau,Office of Compliance,Office of Compliance,null,0.0,0.0,0,0,0,0,30,06,2,2022,2022-06-30,3,2022,0,0
Bureau,Legis Branch-Library of Congress,Library of Congress,null,0.0,0.0,0,0,0,0,30,06,2,2022,2022-06-30,3,2022,0,0
Bureau,Legislative Branch-GAO,Government Accountability Office,null,0.0,0.0,0,0,0,0,30,06,2,2022,2022-06-30,3,2022,0,0
Bureau,Department of Commerce,International Trade Administration,null,0.0,0.0,0,0,0,0,30,06,2,2022,2022-06-30,3,2022,0,0
Bureau,Department of the Treasury,Office of Sec International Affairs,null,0.0,0.0,0,0,0,0,30,06,2,2022,2022-06-30,3,2022,0,0
Bureau,National Foundation  Arts & Humanities,National Endowment for the Arts,null,0.0,0.0,0,0,0,0,30,06,2,2022,2022-06-30,3,2022,0,0
Bureau,National Labor Relations Board,National Labor Relations Board,null,0.0,0.0,0,0,0,0,30,06,2,2022,2022-06-30,3,2022,0,0
Bureau,Department of Homeland Security,U.S. Secret Service,null,0.0,0.0,0,0,0,0,30,06,2,2022,2022-06-30,3,2022,0,0
Bureau,Department of Homeland Security,Science and Technology,null,0.0,0.0,0,0,0,0,30,06,2,2022,2022-06-30,3,2022,0,0
Bureau,Department of Health & Human Services,Administration for Community Living,null,0.0,0.0,0,0,0,0,30,06,2,2022,2022-06-30,3,2022,0,0
Bureau,Farm Credit Administration,Farm Credit System Insurance Corporation,null,0.0,0.0,0,0,0,0,30,06,2,2022,2022-06-30,3,2022,0,0
Bureau,Department of Housing and Urban Development,"Policy, Development and Research",null,0.0,0.0,0,0,0,0,30,06,2,2022,2022-06-30,3,2022,0,0
Bureau,Other Agencies,Morris K. Udall Scholarship,null,0.0,0.0,0,0,0,0,30,06,2,2022,2022-06-30,3,2022,0,0
Bureau,Other Agencies,Commission On Fine Arts,null,0.0,0.0,0,0,0,0,30,06,2,2022,2022-06-30,3,2022,0,0
Bureau,Other Agencies,Defense Nuclear Facilities Safety Board,null,0.0,0.0,0,0,0,0,30,06,2,2022,2022-06-30,3,2022,0,0
Bureau,Other Agencies/Boards/Commissions,U.S. Comm. on Int. Religious Freedom,null,0.0,0.0,1024,1,0,0,30,06,2,2022,2022-06-30,3,2022,1024,1
Bureau,Department of Education,Departmental Management,null,93.00097937986108,89.29081389814374,95094377,225,1263586818,1876,30,06,2,2022,2022-06-30,3,2022,1358681195,2101
Bureau,Securities & Exchange Commission,SEC Enforcement,null,100.0,100.0,0,0,2156723501,1122,30,06,2,2022,2022-06-30,3,2022,2156723501,1122
Bureau,Department of Defense,Consolidated Report,null,36.17002164226635,18.785530582649333,1883012801,1283027,1067031754,296774,30,06,2,2022,2022-06-30,3,2022,2950044555,1579801
Bureau,Social Security Administration,Social Security Administration,null,59.703118468542996,33.81944934149517,1759716756,872803,2607163978,446018,30,06,2,2022,2022-06-30,3,2022,4366880734,1318821
Bureau,Legislative Branch-CBO,Congressional Budget Office,null,0.0,0.0,0,0,0,0,30,06,2,2022,2022-06-30,3,2022,0,0
Bureau,Department of the Treasury,Office of the Secretary,null,0.0,0.0,0,0,0,0,30,06,2,2022,2022-06-30,3,2022,0,0
Bureau,Smithsonian Institution,Smithsonian Institution,null,0.0,0.0,0,0,0,0,30,06,2,2022,2022-06-30,3,2022,0,0
Bureau,Other Agencies,Advisory Council on Hist. Preservation,null,0.0,0.0,0,0,0,0,30,06,2,2022,2022-06-30,3,2022,0,0
Bureau,Department of Homeland Security,Office of Health Affairs,null,0.0,0.0,0,0,0,0,30,06,2,2022,2022-06-30,3,2022,0,0
Bureau,US International Development Fin. Corp.,US International Development Fin. Corp.,null,0.0,0.0,0,0,0,0,30,06,2,2022,2022-06-30,3,2022,0,0
Bureau,Department of the Treasury,Pandemic Receivables,null,0.0,0.0,0,0,0,0,30,06,2,2022,2022-06-30,3,2022,0,0
Bureau,Department of Homeland Security,Office of the Inspector General DHS,null,100.0,100.0,0,0,100,1,30,06,2,2022,2022-06-30,3,2022,100,1
Bureau,Other Agencies,National Council on Disability,null,0.0,0.0,137,2,0,0,30,06,2,2022,2022-06-30,3,2022,137,2
Bureau,Merit Systems Protection Board,Merit Systems Protection Board,null,100.0,100.0,0,0,144,1,30,06,2,2022,2022-06-30,3,2022,144,1
Bureau,Department of the Treasury,Treasury IG for Tax Admin,null,100.0,100.0,0,0,187,1,30,06,2,2022,2022-06-30,3,2022,187,1
Bureau,U.S. Court of Appeals / Veterans Claims,U.S. Court of Appeals / Veterans Claims,null,0.0,0.0,337,1,0,0,30,06,2,2022,2022-06-30,3,2022,337,1
Bureau,National Credit Union Administration,National Credit Union Administration,null,100.0,100.0,0,0,500,2,30,06,2,2022,2022-06-30,3,2022,500,2
Bureau,Department of the Interior,Bureau of Safety and Environmental Enf.,null,100.0,100.0,0,0,508,2,30,06,2,2022,2022-06-30,3,2022,508,2
Bureau,Farm Credit Administration,Farm Credit Administration,null,100.0,100.0,0,0,630,1,30,06,2,2022,2022-06-30,3,2022,630,1
Bureau,Department of the Treasury,Tobacco Tax and Trade,null,100.0,100.0,0,0,1000,1,30,06,2,2022,2022-06-30,3,2022,1000,1
Bureau,Department of Homeland Security,Domestic Nuclear Detection Office,null,0.0,0.0,1258,9,0,0,30,06,2,2022,2022-06-30,3,2022,1258,9
Bureau,Department of Health & Human Services,Centers for Medicare & Medicaid Services,null,99.03966474012684,99.12776036600742,89844278,9685,9265667464,1100675,30,06,2,2022,2022-06-30,3,2022,9355511742,1110360
Bureau,Small Business Administration,Small Business Administration,null,100.0,100.0,0,0,13770704135,122724,30,06,2,2022,2022-06-30,3,2022,13770704135,122724
Bureau,Department of Education,Federal Student Aid,null,100.0,100.0,0,0,124540272764,21517405,30,06,2,2022,2022-06-30,3,2022,124540272764,21517405
Bureau,Department of the Interior,"Bureau of Ocean Energy Mgmt., Reg & Enf",null,100.0,100.0,0,0,1724,1,30,06,2,2022,2022-06-30,3,2022,1724,1
Bureau,Consumer Product Safety Commission,Consumer Product Safety Commission,null,100.0,100.0,0,0,2500,1,30,06,2,2022,2022-06-30,3,2022,2500,1
Bureau,Other Agencies,John C. Stennis,null,0.0,0.0,2934,2,0,0,30,06,2,2022,2022-06-30,3,2022,2934,2
Bureau,Other Agencies,Council of Insps. Gen. of Intg. & Effy.,null,0.0,0.0,3032,6,0,0,30,06,2,2022,2022-06-30,3,2022,3032,6
Bureau,Department of Commerce,General Administration,null,100.0,100.0,0,0,4660,1,30,06,2,2022,2022-06-30,3,2022,4660,1
Bureau,Other Agencies,U.S.  Agency of Global Media,null,100.0,100.0,0,0,4930,2,30,06,2,2022,2022-06-30,3,2022,4930,2
Bureau,Department of Transportation,Federal Highway Administration,null,100.0,100.0,0,0,5040,6,30,06,2,2022,2022-06-30,3,2022,5040,6
Bureau,Other Agencies,Election Assistance Commission,null,0.0,0.0,5576,1,0,0,30,06,2,2022,2022-06-30,3,2022,5576,1
Bureau,Department of Transportation,Maritime Administration,null,100.0,100.0,0,0,5859,7,30,06,2,2022,2022-06-30,3,2022,5859,7
Bureau,Department of Labor,Bureau of Labor Statistics,null,100.0,100.0,0,0,6558,1,30,06,2,2022,2022-06-30,3,2022,6558,1
Bureau,Department of Transportation,St. Lawrence Seaway Development Corp.,null,100.0,100.0,0,0,7728,2,30,06,2,2022,2022-06-30,3,2022,7728,2
Bureau,Equal Employment Opportunity Commission,Equal Employment Opportunity Commission,null,100.0,100.0,0,0,15191,15,30,06,2,2022,2022-06-30,3,2022,15191,15
Bureau,Department of Agriculture,Federal Crop Insurance Corporation,null,69.12650602409639,97.60765550239235,4715,10,10557,408,30,06,2,2022,2022-06-30,3,2022,15272,418
Bureau,Department of Homeland Security,Federal Law Enforcement Training Ctr.,null,100.0,100.0,0,0,16218,2,30,06,2,2022,2022-06-30,3,2022,16218,2
Bureau,Department of Transportation,National Highway Traffic Safety Admin.,null,100.0,100.0,0,0,19297,3,30,06,2,2022,2022-06-30,3,2022,19297,3
Bureau,Department of Justice,Bureau of ATF and Explosives,null,100.0,100.0,0,0,20422,4,30,06,2,2022,2022-06-30,3,2022,20422,4
Bureau,Department of the Treasury,U.S. Mint,null,95.91953319459746,95.23809523809524,1000,1,23507,20,30,06,2,2022,2022-06-30,3,2022,24507,21
Bureau,Other Agencies,Architect of the Capitol,null,0.0,0.0,25144,17,0,0,30,06,2,2022,2022-06-30,3,2022,25144,17
Bureau,Other Agencies,Chemical Safety Board,null,100.0,100.0,0,0,34241,2,30,06,2,2022,2022-06-30,3,2022,34241,2
Bureau,Department of the Treasury,Bureau of Engraving and Printing,null,100.0,100.0,0,0,38345,2,30,06,2,2022,2022-06-30,3,2022,38345,2
Bureau,Legislative Branch-GPO,Government Publishing Office,null,100.0,100.0,0,0,75651,9,30,06,2,2022,2022-06-30,3,2022,75651,9
Bureau,Corp. for National and Community Service,Corp. for National and Community Service,null,0.0,0.0,98618,8,0,0,30,06,2,2022,2022-06-30,3,2022,98618,8
Bureau,Armed Forces Retirement Home,Armed Forces Retirement Home,null,74.20174864229865,95.32710280373831,26792,5,77060,102,30,06,2,2022,2022-06-30,3,2022,103852,107
Bureau,National Archives & Records Admin,Nat'l Archives & Records Administration,null,100.0,100.0,0,0,120327,115,30,06,2,2022,2022-06-30,3,2022,120327,115
Bureau,Department of Justice,Federal Prison Industries,null,0.0,0.0,129923,13,0,0,30,06,2,2022,2022-06-30,3,2022,129923,13
Bureau,Department of Transportation,Federal Railroad Administration,null,100.0,100.0,0,0,133249,12,30,06,2,2022,2022-06-30,3,2022,133249,12
Bureau,Department of the Treasury,Internal Revenue Service,null,100.0,100.0,0,0,137543,46,30,06,2,2022,2022-06-30,3,2022,137543,46
Bureau,Other Agencies,James Madison Memorial Fellowship,null,0.0,0.0,210758,24,0,0,30,06,2,2022,2022-06-30,3,2022,210758,24
Bureau,Department of the Interior,Geological Survey,null,100.0,100.0,0,0,243146,503,30,06,2,2022,2022-06-30,3,2022,243146,503
Bureau,Securities & Exchange Commission,Securities and Exchange Commission,null,100.0,100.0,0,0,247040,47,30,06,2,2022,2022-06-30,3,2022,247040,47
Bureau,Department of Health & Human Services,Office of the Secretary,null,100.0,100.0,0,0,269993,6,30,06,2,2022,2022-06-30,3,2022,269993,6
Bureau,Legislative Branch - U.S. House/Senate,U.S. House of Representatives,null,0.0,0.0,274765,203,0,0,30,06,2,2022,2022-06-30,3,2022,274765,203
Bureau,Department of Commerce,Nat'l Telecomm & Information Admin.,null,100.0,100.0,0,0,296092,1,30,06,2,2022,2022-06-30,3,2022,296092,1
Bureau,Department of Justice,Drug Enforcement Administration,null,100.0,100.0,0,0,363550,22,30,06,2,2022,2022-06-30,3,2022,363550,22
Bureau,Federal Maritime Commission,Salaries and Expenses,null,100.0,100.0,0,0,397704,6,30,06,2,2022,2022-06-30,3,2022,397704,6
Bureau,Department of Justice,Federal Bureau of Investigation,null,100.0,100.0,0,0,415921,91,30,06,2,2022,2022-06-30,3,2022,415921,91
Bureau,Department of the Treasury,D.C. Pension Program,null,100.0,100.0,0,0,455729,21,30,06,2,2022,2022-06-30,3,2022,455729,21
Bureau,Department of Commerce,Patent and Trademark Office,null,100.0,100.0,0,0,487878,661,30,06,2,2022,2022-06-30,3,2022,487878,661
Bureau,Department of Transportation,Pipeline Hazardous Material Safety Admin,null,100.0,100.0,0,0,523391,43,30,06,2,2022,2022-06-30,3,2022,523391,43
Bureau,National Science Foundation,National Science Foundation,null,100.0,100.0,0,0,561275,62,30,06,2,2022,2022-06-30,3,2022,561275,62
Bureau,Department of Commerce,Nat'l Institute of Standards& Technology,null,100.0,100.0,0,0,673322,5,30,06,2,2022,2022-06-30,3,2022,673322,5
Bureau,Department of the Interior,Fish and Wildlife Service,null,100.0,100.0,0,0,746100,63,30,06,2,2022,2022-06-30,3,2022,746100,63
Bureau,Department of Veterans Affairs,Housing Credit Assistance,null,0.26279843982902523,3.7037037037037037,768148,26,2024,1,30,06,2,2022,2022-06-30,3,2022,770172,27
Bureau,Department of Transportation,Federal Transit Administration,null,100.0,100.0,0,0,783405,1,30,06,2,2022,2022-06-30,3,2022,783405,1
Bureau,Department of Housing and Urban Development,Management and Administration,null,0.584750057144654,18.181818181818183,822014,9,4835,2,30,06,2,2022,2022-06-30,3,2022,826849,11
Bureau,Department of Labor,Employment and Training Administration,null,100.0,100.0,0,0,925025,10,30,06,2,2022,2022-06-30,3,2022,925025,10
Bureau,Department of Justice,Office of Justice Assistance Programs,null,100.0,100.0,0,0,937770,3,30,06,2,2022,2022-06-30,3,2022,937770,3
Bureau,The Judiciary,Administrative Office of the U.S. Courts,null,98.81731429729236,57.0945945945946,11966,127,999799,169,30,06,2,2022,2022-06-30,3,2022,1011765,296
Bureau,Railroad Retirement Board,Railroad Retirement Board,null,100.0,100.0,0,0,21103690,3999,30,06,2,2022,2022-06-30,3,2022,21103690,3999
Bureau,Department of the Treasury,Departmental Offices,null,97.70743865394181,98.2874162323157,510251,23,21746558,1320,30,06,2,2022,2022-06-30,3,2022,22256809,1343
Agency,Occupational Safety & Health Rev Comm,null,Non-CFO,0.0,0.0,0,0,0,0,30,06,2,2022,2022-06-30,3,2022,0,0
Agency,Neighborhood Reinvestment Corporation,null,Non-CFO,0.0,0.0,0,0,0,0,30,06,2,2022,2022-06-30,3,2022,0,0
Bureau,U.S. Tax Court,U.S. Tax Court,null,0.0,0.0,0,0,0,0,30,06,2,2022,2022-06-30,3,2022,0,0
Bureau,Department of Justice,U.S. Marshals Service,null,0.0,0.0,0,0,0,0,30,06,2,2022,2022-06-30,3,2022,0,0
Bureau,National Foundation  Arts & Humanities,National Endowment for the Humanities,null,0.0,0.0,0,0,0,0,30,06,2,2022,2022-06-30,3,2022,0,0
Bureau,Department of Transportation,Office of the Inspector General,null,0.0,0.0,0,0,0,0,30,06,2,2022,2022-06-30,3,2022,0,0
Bureau,Neighborhood Reinvestment Corporation,Neighborhood Reinvestment Corporation,null,0.0,0.0,0,0,0,0,30,06,2,2022,2022-06-30,3,2022,0,0
Bureau,Occupational Safety & Health Rev Comm,Occupational Safety & Health Rev Comm,null,0.0,0.0,0,0,0,0,30,06,2,2022,2022-06-30,3,2022,0,0
Bureau,Department of Health & Human Services,Office of the Inspector General,null,0.0,0.0,0,0,0,0,30,06,2,2022,2022-06-30,3,2022,0,0
Bureau,Department of Transportation,Research Innovative Technology Admin,null,100.0,100.0,0,0,73,1,30,06,2,2022,2022-06-30,3,2022,73,1
Bureau,Department of the Treasury,Office of Financial Research,null,100.0,100.0,0,0,268,1,30,06,2,2022,2022-06-30,3,2022,268,1
Bureau,Department of Commerce,Economic and Statistical Analysis,null,0.0,0.0,0,0,0,0,30,06,2,2022,2022-06-30,3,2022,0,0
Bureau,Department of State,International Commissions,null,0.0,0.0,0,0,0,0,30,06,2,2022,2022-06-30,3,2022,0,0
Bureau,Department of Housing and Urban Development,Government National Mortgage Association,null,0.0,0.0,0,0,0,0,30,06,2,2022,2022-06-30,3,2022,0,0
Bureau,Other Agencies,Comm. for Purchase from Blind/Handic.,null,0.0,0.0,0,0,0,0,30,06,2,2022,2022-06-30,3,2022,0,0
Bureau,Legislative Branch-Office of Tech.,Medicaid & CHIP Payment & Access Comm.,null,0.0,0.0,0,0,0,0,30,06,2,2022,2022-06-30,3,2022,0,0
Bureau,Department of the Treasury,Treasury Franchise Fund,null,0.0,0.0,0,0,0,0,30,06,2,2022,2022-06-30,3,2022,0,0
Bureau,Office of Personnel Management,Office of Personnel Management,null,90.65517746423863,82.52873563218391,1205883,152,11698407,718,30,06,2,2022,2022-06-30,3,2022,12904290,870
Bureau,Department of the Treasury,Bureau of the Fiscal Service,null,100.0,100.0,0,0,13416864,3265,30,06,2,2022,2022-06-30,3,2022,13416864,3265
Bureau,General Services Administration,General Services Administration,null,92.36423120936473,69.47431302270012,1077757,511,13036827,1163,30,06,2,2022,2022-06-30,3,2022,14114584,1674
Bureau,Department of Homeland Security,Immigration and Customs Enforcement,null,100.0,100.0,0,0,14661172,605,30,06,2,2022,2022-06-30,3,2022,14661172,605
Bureau,Department of the Interior,Bureau of Indian Affairs,null,99.92429988187038,99.48184689640487,12621,146,16659744,28031,30,06,2,2022,2022-06-30,3,2022,16672365,28177
Bureau,Department of Agriculture,U.S. Department of Agriculture,null,81.66111607348182,49.051957645900025,3787979,2069,16867471,1992,30,06,2,2022,2022-06-30,3,2022,20655450,4061
Agency,Federal Labor Relations Authority,null,Non-CFO,0.0,0.0,0,0,0,0,30,09,3,2022,2022-09-30,4,2022,0,0
Bureau,Other Agencies,Millennium Challenge Corporation,null,0.0,0.0,0,0,0,0,30,09,3,2022,2022-09-30,4,2022,0,0
Bureau,Smithsonian Institution,Smithsonian Institution,null,0.0,0.0,0,0,0,0,30,09,3,2022,2022-09-30,4,2022,0,0
Bureau,Department of Education,Office of Postsecondary Education,null,0.0,0.0,0,0,0,0,30,09,3,2022,2022-09-30,4,2022,0,0
Bureau,Department of Commerce,National Technical Information Service,null,0.0,0.0,0,0,0,0,30,09,3,2022,2022-09-30,4,2022,0,0
Bureau,Department of the Treasury,Interest on Tax/Deposit of Earnings,null,0.0,0.0,0,0,0,0,30,09,3,2022,2022-09-30,4,2022,0,0
Bureau,Other Agencies/Boards/Commissions,Nuclear Waste Technical Review Board,null,0.0,0.0,0,0,0,0,30,09,3,2022,2022-09-30,4,2022,0,0
Bureau,Department of Transportation,Office of the Inspector General,null,0.0,0.0,0,0,0,0,30,09,3,2022,2022-09-30,4,2022,0,0
Bureau,Department of Homeland Security,U.S. Secret Service,null,0.0,0.0,0,0,0,0,30,09,3,2022,2022-09-30,4,2022,0,0
Bureau,Federal Mediation/Conciliation Service,Federal Mediation/Conciliation Service,null,0.0,0.0,0,0,0,0,30,09,3,2022,2022-09-30,4,2022,0,0
Bureau,Other Agencies,U.S. Holocaust Memorial Council,null,0.0,0.0,0,0,0,0,30,09,3,2022,2022-09-30,4,2022,0,0
Bureau,Other Agencies,District of Columbia Government,null,0.0,0.0,0,0,0,0,30,09,3,2022,2022-09-30,4,2022,0,0
Bureau,Other Agencies,Federal Housing Finance Agency,null,0.0,0.0,0,0,0,0,30,09,3,2022,2022-09-30,4,2022,0,0
Bureau,Other Agencies,Gulf Coast Ecosystem Restoration Council,null,0.0,0.0,0,0,0,0,30,09,3,2022,2022-09-30,4,2022,0,0
Bureau,Department of Homeland Security,Office of Biometric Identity Management,null,0.0,0.0,0,0,0,0,30,09,3,2022,2022-09-30,4,2022,0,0
Bureau,Department of Housing and Urban Development,Community Planning and Development,null,0.0,0.0,0,0,0,0,30,09,3,2022,2022-09-30,4,2022,0,0
Bureau,Department of Transportation,Federal Highway Administration,null,100.0,100.0,0,0,13642,12,30,09,3,2022,2022-09-30,4,2022,13642,12
Bureau,Legislative Branch-GAO,Government Accountability Office,null,100.0,100.0,0,0,28645,8,30,09,3,2022,2022-09-30,4,2022,28645,8
Bureau,US International Development Fin. Corp.,US International Development Fin. Corp.,null,0.0,0.0,34492,1,0,0,30,09,3,2022,2022-09-30,4,2022,34492,1
Bureau,Legis Branch-Library of Congress,Library of Congress,null,0.0,0.0,98421,49,0,0,30,09,3,2022,2022-09-30,4,2022,98421,49
Bureau,Department of the Treasury,Internal Revenue Service,null,100.0,100.0,0,0,121490,33,30,09,3,2022,2022-09-30,4,2022,121490,33
Agency,U.S. Court of Appeals / Veterans Claims,null,Non-CFO,0.0,0.0,0,0,0,0,30,09,3,2022,2022-09-30,4,2022,0,0
Agency,National Foundation  Arts & Humanities,null,Non-CFO,0.0,0.0,0,0,0,0,30,09,3,2022,2022-09-30,4,2022,0,0
Bureau,Department of Commerce,Office of the Inspector General,null,0.0,0.0,0,0,0,0,30,09,3,2022,2022-09-30,4,2022,0,0
Bureau,Department of Commerce,Minority Business Development Agency,null,0.0,0.0,0,0,0,0,30,09,3,2022,2022-09-30,4,2022,0,0
Bureau,Farm Credit Administration,Farm Credit System Insurance Corporation,null,0.0,0.0,0,0,0,0,30,09,3,2022,2022-09-30,4,2022,0,0
Bureau,Other Agencies,Morris K. Udall Scholarship,null,0.0,0.0,0,0,0,0,30,09,3,2022,2022-09-30,4,2022,0,0
Bureau,Other Agencies,U.S. Institute of Peace,null,0.0,0.0,0,0,0,0,30,09,3,2022,2022-09-30,4,2022,0,0
Bureau,Department of Homeland Security,Federal Law Enforcement Training Ctr.,null,100.0,100.0,0,0,38302,4,30,09,3,2022,2022-09-30,4,2022,38302,4
Bureau,National Archives & Records Admin,Nat'l Archives & Records Administration,null,100.0,100.0,0,0,122954,128,30,09,3,2022,2022-09-30,4,2022,122954,128
Bureau,Department of Justice,Federal Prison Industries,null,0.0,0.0,178777,18,0,0,30,09,3,2022,2022-09-30,4,2022,178777,18
Bureau,Department of the Treasury,U.S. Treasury IG Office,null,0.0,0.0,0,0,0,0,30,09,3,2022,2022-09-30,4,2022,0,0
Bureau,Other Agencies,National Council on Disability,null,43.39622641509434,50.0,30,1,23,1,30,09,3,2022,2022-09-30,4,2022,53,2
Bureau,Merit Systems Protection Board,Merit Systems Protection Board,null,100.0,100.0,0,0,144,1,30,09,3,2022,2022-09-30,4,2022,144,1
Bureau,Department of the Treasury,Treasury IG for Tax Admin,null,100.0,100.0,0,0,190,1,30,09,3,2022,2022-09-30,4,2022,190,1
Bureau,Consumer Product Safety Commission,Consumer Product Safety Commission,null,100.0,100.0,0,0,262,2,30,09,3,2022,2022-09-30,4,2022,262,2
Bureau,Department of the Treasury,Office of Financial Research,null,100.0,100.0,0,0,268,1,30,09,3,2022,2022-09-30,4,2022,268,1
Bureau,Other Agencies/Boards/Commissions,U.S. Comm. on Int. Religious Freedom,null,0.0,0.0,1024,1,0,0,30,09,3,2022,2022-09-30,4,2022,1024,1
Bureau,Department of Homeland Security,Domestic Nuclear Detection Office,null,0.0,0.0,1348,16,0,0,30,09,3,2022,2022-09-30,4,2022,1348,16
Bureau,Department of the Interior,"Bureau of Ocean Energy Mgmt., Reg & Enf",null,100.0,100.0,0,0,1724,1,30,09,3,2022,2022-09-30,4,2022,1724,1
Bureau,Department of Transportation,St. Lawrence Seaway Development Corp.,null,100.0,100.0,0,0,7728,2,30,09,3,2022,2022-09-30,4,2022,7728,2
Agency,Department of Homeland Security,null,CFO,98.39555435859899,82.21237232607439,4477300,11999,274578586,55458,30,09,3,2022,2022-09-30,4,2022,279055886,67457
Bureau,Department of the Treasury,International Monetary Funds,null,0.0,0.0,0,0,0,0,30,09,3,2022,2022-09-30,4,2022,0,0
Bureau,Department of the Treasury,Tobacco Tax and Trade,null,100.0,100.0,0,0,1000,1,30,09,3,2022,2022-09-30,4,2022,1000,1
Bureau,Department of Transportation,Maritime Administration,null,100.0,100.0,0,0,6071,6,30,09,3,2022,2022-09-30,4,2022,6071,6
Bureau,Department of Agriculture,Federal Crop Insurance Corporation,null,100.0,100.0,0,0,13865,413,30,09,3,2022,2022-09-30,4,2022,13865,413
Bureau,Department of the Treasury,U.S. Mint,null,95.89103011874923,95.0,1000,1,23337,19,30,09,3,2022,2022-09-30,4,2022,24337,20
Bureau,Equal Employment Opportunity Commission,Equal Employment Opportunity Commission,null,100.0,100.0,0,0,24834,20,30,09,3,2022,2022-09-30,4,2022,24834,20
Bureau,Department of Commerce,General Administration,null,100.0,100.0,0,0,4660,1,30,09,3,2022,2022-09-30,4,2022,4660,1
Bureau,Department of the Treasury,Pandemic Receivables,null,0.0,0.0,0,0,0,0,30,09,3,2022,2022-09-30,4,2022,0,0
Bureau,Department of the Interior,Bureau of Safety and Environmental Enf.,null,100.0,100.0,0,0,202,1,30,09,3,2022,2022-09-30,4,2022,202,1
Bureau,Department of Justice,Bureau of ATF and Explosives,null,100.0,100.0,0,0,20073,3,30,09,3,2022,2022-09-30,4,2022,20073,3
Agency,Department of Labor,null,CFO,90.21687839493332,69.24697861791137,17865498,4962,164750018,11173,30,09,3,2022,2022-09-30,4,2022,182615516,16135
Bureau,Office of Special Counsel,Office of Special Counsel,null,0.0,0.0,0,0,0,0,30,09,3,2022,2022-09-30,4,2022,0,0
Bureau,Other Agencies,National Mediation Board,null,0.0,0.0,0,0,0,0,30,09,3,2022,2022-09-30,4,2022,0,0
Bureau,Department of the Treasury,Spec Insp Gen-Troubled Asset Rel Prog,null,100.0,100.0,0,0,3916,1,30,09,3,2022,2022-09-30,4,2022,3916,1
Agency,Department of Health & Human Services,null,CFO,98.00542362239162,97.3387250346415,200317403,30326,9842787752,1109203,30,09,3,2022,2022-09-30,4,2022,10043105155,1139529
Agency,Department of Education,null,CFO,99.9645431073069,99.99941358544761,45154598,128,127305536820,21827434,30,09,3,2022,2022-09-30,4,2022,127350691418,21827562
Agency,Legislative Branch-Office of Tech.,null,Non-CFO,0.0,0.0,0,0,0,0,30,09,3,2022,2022-09-30,4,2022,0,0
Bureau,Department of Homeland Security,Management Headquarters,null,0.0,0.0,0,0,0,0,30,09,3,2022,2022-09-30,4,2022,0,0
Agency,Federal Deposit Insurance Corporation,null,Non-CFO,0.0,0.0,0,0,0,0,30,09,3,2022,2022-09-30,4,2022,0,0
Agency,Occupational Safety & Health Rev Comm,null,Non-CFO,0.0,0.0,0,0,0,0,30,09,3,2022,2022-09-30,4,2022,0,0
Agency,Securities & Exchange Commission,null,Non-CFO,100.0,100.0,0,0,2161476048,1163,30,09,3,2022,2022-09-30,4,2022,2161476048,1163
Bureau,Office of Compliance,Office of Compliance,null,0.0,0.0,0,0,0,0,30,09,3,2022,2022-09-30,4,2022,0,0
Bureau,Legislative Branch-Office of Tech.,Open World Leadership,null,0.0,0.0,0,0,0,0,30,09,3,2022,2022-09-30,4,2022,0,0
Bureau,Funds Appropriated to the President,Peace Corps,null,0.0,0.0,0,0,0,0,30,09,3,2022,2022-09-30,4,2022,0,0
Bureau,Department of Commerce,International Trade Administration,null,0.0,0.0,0,0,0,0,30,09,3,2022,2022-09-30,4,2022,0,0
Bureau,Department of the Treasury,Office of the Secretary,null,0.0,0.0,0,0,0,0,30,09,3,2022,2022-09-30,4,2022,0,0
Bureau,Smithsonian Institution,JFK Center for the Performing Arts,null,0.0,0.0,0,0,0,0,30,09,3,2022,2022-09-30,4,2022,0,0
Bureau,Other Agencies/Boards/Commissions,U.S.-China Security Review Commission,null,0.0,0.0,0,0,0,0,30,09,3,2022,2022-09-30,4,2022,0,0
Bureau,National Foundation  Arts & Humanities,National Endowment for the Humanities,null,0.0,0.0,0,0,0,0,30,09,3,2022,2022-09-30,4,2022,0,0
Bureau,American Battle Monuments Commission,American Battle Monuments Commission,null,0.0,0.0,0,0,0,0,30,09,3,2022,2022-09-30,4,2022,0,0
Bureau,Department of Health & Human Services,Administration for Community Living,null,0.0,0.0,0,0,0,0,30,09,3,2022,2022-09-30,4,2022,0,0
Bureau,Neighborhood Reinvestment Corporation,Neighborhood Reinvestment Corporation,null,0.0,0.0,0,0,0,0,30,09,3,2022,2022-09-30,4,2022,0,0
Bureau,Department of Housing and Urban Development,Public and Indian Housing Programs,null,0.0,0.0,0,0,0,0,30,09,3,2022,2022-09-30,4,2022,0,0
Bureau,Department of Housing and Urban Development,Government National Mortgage Association,null,0.0,0.0,0,0,0,0,30,09,3,2022,2022-09-30,4,2022,0,0
Bureau,Occupational Safety & Health Rev Comm,Occupational Safety & Health Rev Comm,null,0.0,0.0,0,0,0,0,30,09,3,2022,2022-09-30,4,2022,0,0
Bureau,Other Agencies,Federal Mine Safety & Health Review Comm,null,0.0,0.0,0,0,0,0,30,09,3,2022,2022-09-30,4,2022,0,0
Bureau,Other Agencies,Commission On Fine Arts,null,0.0,0.0,0,0,0,0,30,09,3,2022,2022-09-30,4,2022,0,0
Bureau,Other Agencies/Boards/Commissions,Medicare Payment Advisory Commission,null,0.0,0.0,0,0,0,0,30,09,3,2022,2022-09-30,4,2022,0,0
Bureau,Legislative Branch-Office of Tech.,Medicaid & CHIP Payment & Access Comm.,null,0.0,0.0,0,0,0,0,30,09,3,2022,2022-09-30,4,2022,0,0
Bureau,Other Agencies,Delta Regional Authority,null,0.0,0.0,0,0,0,0,30,09,3,2022,2022-09-30,4,2022,0,0
Bureau,Legislative Branch-GPO,Government Publishing Office,null,0.0,0.0,0,0,0,0,30,09,3,2022,2022-09-30,4,2022,0,0
Bureau,Funds Appropriated to the President,Inter-American Foundation,null,0.0,0.0,0,0,0,0,30,09,3,2022,2022-09-30,4,2022,0,0
Bureau,Funds Appropriated to the President,Defense Security Assistance Agency,null,0.0,0.0,0,0,0,0,30,09,3,2022,2022-09-30,4,2022,0,0
Bureau,Department of Commerce,Economic and Statistical Analysis,null,0.0,0.0,0,0,0,0,30,09,3,2022,2022-09-30,4,2022,0,0
Bureau,Department of State,International Commissions,null,0.0,0.0,0,0,0,0,30,09,3,2022,2022-09-30,4,2022,0,0
Bureau,Department of the Treasury,Treasury Forfeiture Fund,null,0.0,0.0,0,0,0,0,30,09,3,2022,2022-09-30,4,2022,0,0
Bureau,Smithsonian Institution,National Gallery of Art,null,0.0,0.0,0,0,0,0,30,09,3,2022,2022-09-30,4,2022,0,0
Bureau,Federal Labor Relations Authority,Federal Labor Relations Authority,null,0.0,0.0,0,0,0,0,30,09,3,2022,2022-09-30,4,2022,0,0
Bureau,National Foundation  Arts & Humanities,National Endowment for the Arts,null,0.0,0.0,0,0,0,0,30,09,3,2022,2022-09-30,4,2022,0,0
Bureau,National Labor Relations Board,National Labor Relations Board,null,0.0,0.0,0,0,0,0,30,09,3,2022,2022-09-30,4,2022,0,0
Bureau,Department of Homeland Security,Science and Technology,null,0.0,0.0,0,0,0,0,30,09,3,2022,2022-09-30,4,2022,0,0
Bureau,Other Agencies,National Transportation Safety Board,null,0.0,0.0,0,0,0,0,30,09,3,2022,2022-09-30,4,2022,0,0
Bureau,Other Agencies,National Capital Planning Commission,null,0.0,0.0,0,0,0,0,30,09,3,2022,2022-09-30,4,2022,0,0
Bureau,U.S. Court of Appeals / Veterans Claims,U.S. Court of Appeals / Veterans Claims,null,0.0,0.0,0,0,0,0,30,09,3,2022,2022-09-30,4,2022,0,0
Bureau,Other Agencies,Surface Transportation Board,null,0.0,0.0,0,0,0,0,30,09,3,2022,2022-09-30,4,2022,0,0
Bureau,Department of the Treasury,Treasury Franchise Fund,null,0.0,0.0,0,0,0,0,30,09,3,2022,2022-09-30,4,2022,0,0
Bureau,Other Agencies,Privacy & Civil Liberties Oversight Bd,null,0.0,0.0,0,0,0,0,30,09,3,2022,2022-09-30,4,2022,0,0
Bureau,Other Agencies,James Madison Memorial Fellowship,null,0.0,0.0,210759,24,0,0,30,09,3,2022,2022-09-30,4,2022,210759,24
Bureau,Tennessee Valley Authority,Tennessee Valley Authority,null,0.0,0.0,237230,75,0,0,30,09,3,2022,2022-09-30,4,2022,237230,75
Bureau,Securities & Exchange Commission,Securities and Exchange Commission,null,100.0,100.0,0,0,247257,47,30,09,3,2022,2022-09-30,4,2022,247257,47
Bureau,Department of Transportation,Research Innovative Technology Admin,null,0.0,0.0,0,0,0,0,30,09,3,2022,2022-09-30,4,2022,0,0
Bureau,Department of Homeland Security,Info Analysis Infrastructure Prot-NPPD,null,0.0,0.0,0,0,0,0,30,09,3,2022,2022-09-30,4,2022,0,0
Bureau,Department of Homeland Security,Office of the Inspector General DHS,null,100.0,100.0,0,0,100,1,30,09,3,2022,2022-09-30,4,2022,100,1
Bureau,Legislative Branch - U.S. House/Senate,U.S. House of Representatives,null,0.0,0.0,268369,218,0,0,30,09,3,2022,2022-09-30,4,2022,268369,218
Bureau,Department of Justice,General Administration,null,0.0,0.0,0,0,0,0,30,09,3,2022,2022-09-30,4,2022,0,0
Bureau,Selective Service System,Selective Service System,null,0.0,0.0,4615,8,0,0,30,09,3,2022,2022-09-30,4,2022,4615,8
Bureau,Other Agencies,U.S.  Agency of Global Media,null,100.0,100.0,0,0,4930,2,30,09,3,2022,2022-09-30,4,2022,4930,2
Bureau,Department of Labor,Bureau of Labor Statistics,null,100.0,100.0,0,0,6048,1,30,09,3,2022,2022-09-30,4,2022,6048,1
Bureau,Smithsonian Institution,Administrative Conference of the US,null,0.0,0.0,0,0,0,0,30,09,3,2022,2022-09-30,4,2022,0,0
Bureau,Department of Housing and Urban Development,Management and Administration,null,100.0,100.0,0,0,4706,2,30,09,3,2022,2022-09-30,4,2022,4706,2
Bureau,Other Agencies,Election Assistance Commission,null,0.0,0.0,5576,1,0,0,30,09,3,2022,2022-09-30,4,2022,5576,1
Bureau,Other Agencies,Architect of the Capitol,null,0.0,0.0,22952,17,0,0,30,09,3,2022,2022-09-30,4,2022,22952,17
Bureau,Other Agencies,Chemical Safety Board,null,100.0,100.0,0,0,33381,2,30,09,3,2022,2022-09-30,4,2022,33381,2
Bureau,Export - Import  Bank,Export-Import Bank,null,0.0,0.0,0,0,0,0,30,09,3,2022,2022-09-30,4,2022,0,0
Bureau,Department of Transportation,National Highway Traffic Safety Admin.,null,100.0,100.0,0,0,36095,5,30,09,3,2022,2022-09-30,4,2022,36095,5
Bureau,Department of the Interior,Office of the Secretary,null,100.0,100.0,0,0,344586,25,30,09,3,2022,2022-09-30,4,2022,344586,25
Bureau,Department of Justice,Drug Enforcement Administration,null,100.0,100.0,0,0,358350,21,30,09,3,2022,2022-09-30,4,2022,358350,21
Bureau,Federal Maritime Commission,Salaries and Expenses,null,100.0,100.0,0,0,397826,6,30,09,3,2022,2022-09-30,4,2022,397826,6
Bureau,Department of Justice,Federal Bureau of Investigation,null,100.0,100.0,0,0,428355,96,30,09,3,2022,2022-09-30,4,2022,428355,96
Bureau,Department of the Treasury,D.C. Pension Program,null,100.0,100.0,0,0,470701,22,30,09,3,2022,2022-09-30,4,2022,470701,22
Bureau,Department of Agriculture,Food Safety and Inspection Service,null,95.59484223201528,95.25691699604744,56448,60,1224959,1205,30,09,3,2022,2022-09-30,4,2022,1281407,1265
Bureau,Department of the Treasury,Comptroller of the Currency,null,100.0,100.0,0,0,1442625,22,30,09,3,2022,2022-09-30,4,2022,1442625,22
Agency,Agency for International Development,null,CFO,99.99894484769322,98.0,272,1,25777997,49,30,09,3,2022,2022-09-30,4,2022,25778269,50
Agency,Environmental Protection Agency,null,CFO,99.79564477483538,99.27536231884058,53456,2,26104916,274,30,09,3,2022,2022-09-30,4,2022,26158372,276
Agency,Department of the Treasury,null,CFO,99.54250969797482,99.8730964467005,195592,6,42557664,4722,30,09,3,2022,2022-09-30,4,2022,42753256,4728
Agency,National Credit Union Administration,null,Non-CFO,100.0,100.0,0,0,445,1,30,09,3,2022,2022-09-30,4,2022,445,1
Agency,Farm Credit Administration,null,Non-CFO,100.0,100.0,0,0,630,1,30,09,3,2022,2022-09-30,4,2022,630,1
Agency,Other Agencies/Boards/Commissions,null,Non-CFO,0.0,0.0,1024,1,0,0,30,09,3,2022,2022-09-30,4,2022,1024,1
Agency,Selective Service System,null,Non-CFO,0.0,0.0,4615,8,0,0,30,09,3,2022,2022-09-30,4,2022,4615,8
Agency,Equal Employment Opportunity Commission,null,Non-CFO,100.0,100.0,0,0,24834,20,30,09,3,2022,2022-09-30,4,2022,24834,20
Agency,Legislative Branch-GAO,null,Non-CFO,100.0,100.0,0,0,28645,8,30,09,3,2022,2022-09-30,4,2022,28645,8
Agency,US International Development Fin. Corp.,null,Non-CFO,0.0,0.0,34492,1,0,0,30,09,3,2022,2022-09-30,4,2022,34492,1
Agency,Legis Branch-Library of Congress,null,Non-CFO,0.0,0.0,98421,49,0,0,30,09,3,2022,2022-09-30,4,2022,98421,49
Agency,National Archives & Records Admin,null,Non-CFO,100.0,100.0,0,0,122954,128,30,09,3,2022,2022-09-30,4,2022,122954,128
Agency,Tennessee Valley Authority,null,Non-CFO,0.0,0.0,237230,75,0,0,30,09,3,2022,2022-09-30,4,2022,237230,75
Agency,Legislative Branch - U.S. House/Senate,null,Non-CFO,0.0,0.0,268369,218,0,0,30,09,3,2022,2022-09-30,4,2022,268369,218
Agency,The Judiciary,null,Non-CFO,94.0876531158947,56.8561872909699,64446,129,1025578,170,30,09,3,2022,2022-09-30,4,2022,1090024,299
Agency,Funds Appropriated to the President,null,Non-CFO,0.0,0.0,1236060,7,0,0,30,09,3,2022,2022-09-30,4,2022,1236060,7
Agency,Presidio Trust Corporation,null,Non-CFO,100.0,100.0,0,0,1501343,62,30,09,3,2022,2022-09-30,4,2022,1501343,62
Bureau,U.S. Tax Court,U.S. Tax Court,null,0.0,0.0,0,0,0,0,30,09,3,2022,2022-09-30,4,2022,0,0
Bureau,Funds Appropriated to the President,Executive Branch,null,0.0,0.0,0,0,0,0,30,09,3,2022,2022-09-30,4,2022,0,0
Bureau,Other Agencies,Archit.&Trans. Barriers Compliance Bd,null,0.0,0.0,0,0,0,0,30,09,3,2022,2022-09-30,4,2022,0,0
Bureau,Office of Government Ethics,Office of Government Ethics,null,0.0,0.0,0,0,0,0,30,09,3,2022,2022-09-30,4,2022,0,0
Bureau,Department of Health & Human Services,Office of the Inspector General,null,0.0,0.0,0,0,0,0,30,09,3,2022,2022-09-30,4,2022,0,0
Bureau,Legislative Branch-CBO,Congressional Budget Office,null,0.0,0.0,0,0,0,0,30,09,3,2022,2022-09-30,4,2022,0,0
Bureau,Federal Deposit Insurance Corporation,Federal Deposit Insurance Corporation,null,0.0,0.0,0,0,0,0,30,09,3,2022,2022-09-30,4,2022,0,0
Bureau,Other Agencies,Comm. for Purchase from Blind/Handic.,null,0.0,0.0,0,0,0,0,30,09,3,2022,2022-09-30,4,2022,0,0
Bureau,Other Agencies,Defense Nuclear Facilities Safety Board,null,0.0,0.0,0,0,0,0,30,09,3,2022,2022-09-30,4,2022,0,0
Bureau,Department of Commerce,Nat'l Institute of Standards& Technology,null,100.0,100.0,0,0,673458,5,30,09,3,2022,2022-09-30,4,2022,673458,5
Bureau,Armed Forces Retirement Home,Armed Forces Retirement Home,null,10.347263064325977,98.07692307692308,667678,2,77060,102,30,09,3,2022,2022-09-30,4,2022,744738,104
Bureau,Department of Veterans Affairs,Housing Credit Assistance,null,0.1787684808406245,3.8461538461538463,749908,25,1343,1,30,09,3,2022,2022-09-30,4,2022,751251,26
Bureau,Department of the Interior,Fish and Wildlife Service,null,100.0,100.0,0,0,770993,108,30,09,3,2022,2022-09-30,4,2022,770993,108
Bureau,Department of Transportation,Federal Transit Administration,null,100.0,100.0,0,0,783403,1,30,09,3,2022,2022-09-30,4,2022,783403,1
Bureau,Department of Labor,Employment and Training Administration,null,100.0,100.0,0,0,925026,10,30,09,3,2022,2022-09-30,4,2022,925026,10
Bureau,Department of Justice,Office of Justice Assistance Programs,null,100.0,100.0,0,0,937770,3,30,09,3,2022,2022-09-30,4,2022,937770,3
Bureau,Department of Homeland Security,Citizenship and Immigration Services,null,100.0,100.0,0,0,1048328,1254,30,09,3,2022,2022-09-30,4,2022,1048328,1254
Bureau,Department of Health & Human Services,Substance Abuse & Mental Health Admin.,null,100.0,100.0,0,0,1051688,13,30,09,3,2022,2022-09-30,4,2022,1051688,13
Bureau,The Judiciary,Administrative Office of the U.S. Courts,null,94.0876531158947,56.8561872909699,64446,129,1025578,170,30,09,3,2022,2022-09-30,4,2022,1090024,299
Bureau,Department of Transportation,Office of the Secretary,null,100.0,100.0,0,0,1102895,18,30,09,3,2022,2022-09-30,4,2022,1102895,18
Bureau,Department of Homeland Security,Office of Health Affairs,null,0.0,0.0,0,0,0,0,30,09,3,2022,2022-09-30,4,2022,0,0
Agency,U.S. Tax Court,null,Non-CFO,0.0,0.0,0,0,0,0,30,09,3,2022,2022-09-30,4,2022,0,0
Bureau,Funds Appropriated to the President,African Development Foundation,null,0.0,0.0,0,0,0,0,30,09,3,2022,2022-09-30,4,2022,0,0
Bureau,Department of Justice,U.S. Marshals Service,null,0.0,0.0,0,0,0,0,30,09,3,2022,2022-09-30,4,2022,0,0
Bureau,Department of Labor,Departmental Management,null,0.0,0.0,0,0,0,0,30,09,3,2022,2022-09-30,4,2022,0,0
Bureau,Department of State,Civil Monetary Penalties,null,0.0,0.0,0,0,0,0,30,09,3,2022,2022-09-30,4,2022,0,0
Bureau,Department of the Treasury,Office of Sec International Affairs,null,0.0,0.0,0,0,0,0,30,09,3,2022,2022-09-30,4,2022,0,0
Bureau,Other Agencies,Denali Commission,null,0.0,0.0,0,0,0,0,30,09,3,2022,2022-09-30,4,2022,0,0
Bureau,Other Agencies,Federal Housing Finance Agency OIG,null,0.0,0.0,0,0,0,0,30,09,3,2022,2022-09-30,4,2022,0,0
Bureau,National Aeronautics and Space Administration,National Aeronautics and Space Admin,null,100.0,100.0,0,0,1581797,130,30,09,3,2022,2022-09-30,4,2022,1581797,130
Bureau,Department of State,Passport NSF,null,99.4550051229935,99.47660842257831,10468,65,1910284,12354,30,09,3,2022,2022-09-30,4,2022,1920752,12419
Bureau,Federal Election Commission,Federal Election Commission,null,100.0,100.0,0,0,2024763,293,30,09,3,2022,2022-09-30,4,2022,2024763,293
Bureau,Department of Energy,Bonneville Power Administration,null,52.08724946184419,92.3076923076923,976229,2,1061285,24,30,09,3,2022,2022-09-30,4,2022,2037514,26
Bureau,Department of Transportation,Federal Aviation Administration,null,100.0,100.0,0,0,2324083,305,30,09,3,2022,2022-09-30,4,2022,2324083,305
Bureau,Other Agencies,Consumer Financial Protection Bureau,null,6.607093479391791,28.571428571428573,2989082,10,211463,4,30,09,3,2022,2022-09-30,4,2022,3200545,14
Bureau,Nuclear Regulatory Commission,Nuclear Regulatory Commission,null,100.0,100.0,0,0,3238856,373,30,09,3,2022,2022-09-30,4,2022,3238856,373
Bureau,Other Agencies,Advisory Council on Hist. Preservation,null,0.0,0.0,0,0,0,0,30,09,3,2022,2022-09-30,4,2022,0,0
Bureau,Department of Homeland Security,Immigration and Customs Enforcement,null,100.0,100.0,0,0,14888235,614,30,09,3,2022,2022-09-30,4,2022,14888235,614
Bureau,Department of the Interior,Bureau of Indian Affairs,null,99.96594858307706,99.66962101718606,5702,104,16739563,31375,30,09,3,2022,2022-09-30,4,2022,16745265,31479
Bureau,Department of Labor,Employee Benefit Security Administration,null,100.0,100.0,0,0,20837935,469,30,09,3,2022,2022-09-30,4,2022,20837935,469
Bureau,Department of Agriculture,U.S. Department of Agriculture,null,82.7625099313607,57.536534446764094,3656173,2034,17554415,2756,30,09,3,2022,2022-09-30,4,2022,21210588,4790
Agency,National Science Foundation,null,CFO,100.0,100.0,0,0,556521,50,30,09,3,2022,2022-09-30,4,2022,556521,50
Agency,National Aeronautics and Space Administration,null,CFO,100.0,100.0,0,0,1581797,130,30,09,3,2022,2022-09-30,4,2022,1581797,130
Agency,Nuclear Regulatory Commission,null,CFO,100.0,100.0,0,0,3238856,373,30,09,3,2022,2022-09-30,4,2022,3238856,373
Agency,Office of Personnel Management,null,CFO,100.0,100.0,0,0,13793795,994,30,09,3,2022,2022-09-30,4,2022,13793795,994
Agency,General Services Administration,null,CFO,93.20673116182941,94.16909620991254,965826,100,13251571,1615,30,09,3,2022,2022-09-30,4,2022,14217397,1715
Agency,Department of Energy,null,CFO,93.33947059029013,97.89473684210526,976229,2,13680699,93,30,09,3,2022,2022-09-30,4,2022,14656928,95
Agency,Department of State,null,CFO,98.20892508257529,98.99189129958361,442388,230,24257193,22585,30,09,3,2022,2022-09-30,4,2022,24699581,22815
Agency,Department of Commerce,null,CFO,100.0,100.0,0,0,60527147,15036,30,09,3,2022,2022-09-30,4,2022,60527147,15036
Agency,Department of the Interior,null,CFO,99.76439160932549,99.7037947800816,145093,106,61437179,35680,30,09,3,2022,2022-09-30,4,2022,61582272,35786
Agency,Department of Transportation,null,CFO,99.99960419073723,99.98783306971652,295,1,74530553,8218,30,09,3,2022,2022-09-30,4,2022,74530848,8219
Agency,Department of Housing and Urban Development,null,CFO,99.96962516590636,99.86966438579341,24466,4,80522476,3065,30,09,3,2022,2022-09-30,4,2022,80546942,3069
Agency,Department of Justice,null,CFO,96.81204522816442,99.01191733293106,3758009,393,114123494,39381,30,09,3,2022,2022-09-30,4,2022,117881503,39774
Bureau,Department of Housing and Urban Development,"Policy, Development and Research",null,0.0,0.0,0,0,0,0,30,09,3,2022,2022-09-30,4,2022,0,0
Agency,Department of Veterans Affairs,null,CFO,40.01116151922148,98.80325553611463,312702468,44055,208565281,3637182,30,09,3,2022,2022-09-30,4,2022,521267749,3681237
Agency,Department of Agriculture,null,CFO,99.30329225580469,92.24145827608318,13187987,5082,1879712890,60420,30,09,3,2022,2022-09-30,4,2022,1892900877,65502
Agency,Department of Defense,null,CFO,34.809477754616964,18.783896801271467,2025138902,1315843,1081353932,304332,30,09,3,2022,2022-09-30,4,2022,3106492834,1620175
Agency,Social Security Administration,null,CFO,58.856659511962356,33.19557416539266,1794271497,883554,2566753825,439044,30,09,3,2022,2022-09-30,4,2022,4361025322,1322598
Agency,Small Business Administration,null,CFO,100.0,100.0,0,0,13846407520,122989,30,09,3,2022,2022-09-30,4,2022,13846407520,122989
Bureau,Other Agencies,U.S. Inst. for Env. Conflict Resolution,null,0.0,0.0,4178,1,0,0,30,09,3,2022,2022-09-30,4,2022,4178,1
Bureau,Department of Veterans Affairs,Administration and Cemeteries,null,2.114924744700097,2.0277481323372464,1457637,918,31494,19,30,09,3,2022,2022-09-30,4,2022,1489131,937
Bureau,Presidio Trust Corporation,Presidio Trust Corporation,null,100.0,100.0,0,0,1501343,62,30,09,3,2022,2022-09-30,4,2022,1501343,62
Bureau,Department of Commerce,Bureau of the Census,null,100.0,100.0,0,0,3340413,13279,30,09,3,2022,2022-09-30,4,2022,3340413,13279
Bureau,Corp. for National and Community Service,Corp. for National and Community Service,null,96.07891644175885,52.38095238095238,147406,150,3611912,165,30,09,3,2022,2022-09-30,4,2022,3759318,315
Bureau,Department of Commerce,Economic Development Administration,null,100.0,100.0,0,0,5137182,12,30,09,3,2022,2022-09-30,4,2022,5137182,12
Bureau,Department of Homeland Security,U.S. Coast Guard,null,21.325583222553433,10.474411654837505,4475952,11983,1213257,1402,30,09,3,2022,2022-09-30,4,2022,5689209,13385
Bureau,Department of Agriculture,Agricultural Marketing Service,null,65.98985419241913,45.01808615586978,2025831,1672,3930718,1369,30,09,3,2022,2022-09-30,4,2022,5956549,3041
Agency,Office of Compliance,null,Non-CFO,0.0,0.0,0,0,0,0,30,09,3,2022,2022-09-30,4,2022,0,0
Agency,National Labor Relations Board,null,Non-CFO,0.0,0.0,0,0,0,0,30,09,3,2022,2022-09-30,4,2022,0,0
Agency,Office of Special Counsel,null,Non-CFO,0.0,0.0,0,0,0,0,30,09,3,2022,2022-09-30,4,2022,0,0
Agency,American Battle Monuments Commission,null,Non-CFO,0.0,0.0,0,0,0,0,30,09,3,2022,2022-09-30,4,2022,0,0
Agency,Smithsonian Institution,null,Non-CFO,0.0,0.0,0,0,0,0,30,09,3,2022,2022-09-30,4,2022,0,0
Agency,Legislative Branch-CBO,null,Non-CFO,0.0,0.0,0,0,0,0,30,09,3,2022,2022-09-30,4,2022,0,0
Agency,Legislative Branch-GPO,null,Non-CFO,0.0,0.0,0,0,0,0,30,09,3,2022,2022-09-30,4,2022,0,0
Agency,Federal Mediation/Conciliation Service,null,Non-CFO,0.0,0.0,0,0,0,0,30,09,3,2022,2022-09-30,4,2022,0,0
Agency,Export - Import  Bank,null,Non-CFO,0.0,0.0,0,0,0,0,30,09,3,2022,2022-09-30,4,2022,0,0
Agency,Neighborhood Reinvestment Corporation,null,Non-CFO,0.0,0.0,0,0,0,0,30,09,3,2022,2022-09-30,4,2022,0,0
Agency,Merit Systems Protection Board,null,Non-CFO,100.0,100.0,0,0,144,1,30,09,3,2022,2022-09-30,4,2022,144,1
Agency,Consumer Product Safety Commission,null,Non-CFO,100.0,100.0,0,0,262,2,30,09,3,2022,2022-09-30,4,2022,262,2
Agency,Federal Maritime Commission,null,Non-CFO,100.0,100.0,0,0,397826,6,30,09,3,2022,2022-09-30,4,2022,397826,6
Agency,Armed Forces Retirement Home,null,Non-CFO,10.347263064325977,98.07692307692308,667678,2,77060,102,30,09,3,2022,2022-09-30,4,2022,744738,104
Agency,Federal Election Commission,null,Non-CFO,100.0,100.0,0,0,2024763,293,30,09,3,2022,2022-09-30,4,2022,2024763,293
Agency,Pension Benefit Guaranty Corp,null,Non-CFO,100.0,100.0,0,0,3270867,1060,30,09,3,2022,2022-09-30,4,2022,3270867,1060
Agency,Other Agencies,null,Non-CFO,7.165175338076709,13.235294117647058,3236468,59,249797,9,30,09,3,2022,2022-09-30,4,2022,3486265,68
Agency,Corp. for National and Community Service,null,Non-CFO,96.07891644175885,52.38095238095238,147406,150,3611912,165,30,09,3,2022,2022-09-30,4,2022,3759318,315
Agency,Railroad Retirement Board,null,Non-CFO,100.0,100.0,0,0,22349330,4052,30,09,3,2022,2022-09-30,4,2022,22349330,4052
Agency,U.S. Postal Service,null,Non-CFO,76.03448209997207,71.40286216130612,18192946,19863,57720064,49595,30,09,3,2022,2022-09-30,4,2022,75913010,69458
Agency,Federal Communications Commission,null,Non-CFO,100.0,100.0,0,0,237880836,12731,30,09,3,2022,2022-09-30,4,2022,237880836,12731
Agency,Federal Trade Commission,null,Non-CFO,100.0,100.0,0,0,482179661,66,30,09,3,2022,2022-09-30,4,2022,482179661,66
Agency,Commodity Futures Trading Commission,null,Non-CFO,100.0,100.0,0,0,649446964,361,30,09,3,2022,2022-09-30,4,2022,649446964,361
Bureau,Department of the Interior,Office of Surface Mining,null,100.0,100.0,0,0,8112307,369,30,09,3,2022,2022-09-30,4,2022,8112307,369
Bureau,Department of the Interior,National Park Service,null,100.0,100.0,0,0,8389555,2116,30,09,3,2022,2022-09-30,4,2022,8389555,2116
Bureau,Department of Health & Human Services,Centers for Disease Control,null,1.9336986204855944,16.0,8295704,84,163577,16,30,09,3,2022,2022-09-30,4,2022,8459281,100
Bureau,Department of Homeland Security,Bureau of Customs & Border Protection,null,100.0,100.0,0,0,8628827,652,30,09,3,2022,2022-09-30,4,2022,8628827,652
Bureau,Department of the Interior,Bureau of Land Management,null,100.0,100.0,0,0,9034010,379,30,09,3,2022,2022-09-30,4,2022,9034010,379
Bureau,Department of the Interior,Office of Natural Resources Revenue,null,100.0,100.0,0,0,10525108,551,30,09,3,2022,2022-09-30,4,2022,10525108,551
Bureau,Department of Homeland Security,Transportation Safety Administration,null,100.0,100.0,0,0,10964892,11808,30,09,3,2022,2022-09-30,4,2022,10964892,11808
Bureau,Department of Energy,Energy Consolidated Reports,null,100.0,100.0,0,0,12619414,69,30,09,3,2022,2022-09-30,4,2022,12619414,69
Bureau,Department of Labor,Mine Safety and Health Administration,null,76.22643305043574,61.85981120706969,3167567,1899,10156336,3080,30,09,3,2022,2022-09-30,4,2022,13323903,4979
Bureau,Department of the Treasury,Bureau of the Fiscal Service,null,100.0,100.0,0,0,13502993,3290,30,09,3,2022,2022-09-30,4,2022,13502993,3290
Bureau,Department of the Interior,Bureau of Reclamation,null,98.13727013879303,97.22222222222223,139391,2,7343766,70,30,09,3,2022,2022-09-30,4,2022,7483157,72
Bureau,Department of Health & Human Services,National Institutes of Health,null,31.869295331855916,10.953346855983773,14410542,878,6740776,108,30,09,3,2022,2022-09-30,4,2022,21151318,986
Bureau,Railroad Retirement Board,Railroad Retirement Board,null,100.0,100.0,0,0,22349330,4052,30,09,3,2022,2022-09-30,4,2022,22349330,4052
Bureau,Department of Justice,Federal Prison System,null,100.0,100.0,0,0,22540815,759,30,09,3,2022,2022-09-30,4,2022,22540815,759
Bureau,Department of State,Department of State,null,98.1038533631382,98.41285109657561,431920,165,22346909,10231,30,09,3,2022,2022-09-30,4,2022,22778829,10396
Bureau,Agency for International Development,Agency for International Development,null,99.99894484769322,98.0,272,1,25777997,49,30,09,3,2022,2022-09-30,4,2022,25778269,50
Bureau,Environmental Protection Agency,Environmental Protection Agency,null,99.79564477483538,99.27536231884058,53456,2,26104916,274,30,09,3,2022,2022-09-30,4,2022,26158372,276
Bureau,Department of Health & Human Services,Administration for Children and Families,null,100.0,100.0,0,0,35424713,1699,30,09,3,2022,2022-09-30,4,2022,35424713,1699
Bureau,Department of Commerce,Bureau of Industry and Security,null,100.0,100.0,0,0,37612463,29,30,09,3,2022,2022-09-30,4,2022,37612463,29
Bureau,Department of Defense,Consolidated Report,null,34.809477754616964,18.783896801271467,2025138902,1315843,1081353932,304332,30,09,3,2022,2022-09-30,4,2022,3106492834,1620175
Bureau,Social Security Administration,Social Security Administration,null,58.856659511962356,33.19557416539266,1794271497,883554,2566753825,439044,30,09,3,2022,2022-09-30,4,2022,4361025322,1322598
Bureau,Department of Health & Human Services,Centers for Medicare & Medicaid Services,null,99.0787600714212,99.12276119940636,88883286,9741,9559340075,1100675,30,09,3,2022,2022-09-30,4,2022,9648223361,1110416
Bureau,Small Business Administration,Small Business Administration,null,100.0,100.0,0,0,13846407520,122989,30,09,3,2022,2022-09-30,4,2022,13846407520,122989
Bureau,Other Agencies,Council of Insps. Gen. of Intg. & Effy.,null,0.0,0.0,957,3,0,0,30,09,3,2022,2022-09-30,4,2022,957,3
Bureau,Other Agencies,John C. Stennis,null,0.0,0.0,2934,2,0,0,30,09,3,2022,2022-09-30,4,2022,2934,2
Bureau,Department of Transportation,Pipeline Hazardous Material Safety Admin,null,100.0,100.0,0,0,503359,43,30,09,3,2022,2022-09-30,4,2022,503359,43
Bureau,Department of Health & Human Services,Program Support Center,null,100.0,100.0,0,0,6198404,299,30,09,3,2022,2022-09-30,4,2022,6198404,299
Bureau,Department of Transportation,Federal Railroad Administration,null,100.0,100.0,0,0,143621,17,30,09,3,2022,2022-09-30,4,2022,143621,17
Bureau,Department of the Interior,Geological Survey,null,100.0,100.0,0,0,175365,685,30,09,3,2022,2022-09-30,4,2022,175365,685
Bureau,National Credit Union Administration,National Credit Union Administration,null,100.0,100.0,0,0,445,1,30,09,3,2022,2022-09-30,4,2022,445,1
Bureau,Farm Credit Administration,Farm Credit Administration,null,100.0,100.0,0,0,630,1,30,09,3,2022,2022-09-30,4,2022,630,1
Bureau,Department of the Treasury,Bureau of Engraving and Printing,null,100.0,100.0,0,0,38345,2,30,09,3,2022,2022-09-30,4,2022,38345,2
Bureau,Department of Health & Human Services,Office of the Secretary,null,100.0,100.0,0,0,270127,7,30,09,3,2022,2022-09-30,4,2022,270127,7
Bureau,Department of Commerce,Nat'l Telecomm & Information Admin.,null,100.0,100.0,0,0,296093,1,30,09,3,2022,2022-09-30,4,2022,296093,1
Bureau,Department of Commerce,Patent and Trademark Office,null,100.0,100.0,0,0,509853,697,30,09,3,2022,2022-09-30,4,2022,509853,697
Bureau,Department of the Treasury,Financial Crimes Enforcement Network,null,100.0,100.0,0,0,1544945,3,30,09,3,2022,2022-09-30,4,2022,1544945,3
Bureau,National Science Foundation,National Science Foundation,null,100.0,100.0,0,0,556521,50,30,09,3,2022,2022-09-30,4,2022,556521,50
Bureau,Department of Veterans Affairs,Life Insurance,null,100.0,100.0,0,0,1205239,238,30,09,3,2022,2022-09-30,4,2022,1205239,238
Bureau,Funds Appropriated to the President,Trade and Development Agency,null,0.0,0.0,1236060,7,0,0,30,09,3,2022,2022-09-30,4,2022,1236060,7
Bureau,Department of Veterans Affairs,Veterans Benefits,null,0.0,0.0,1247304,1644,0,0,30,09,3,2022,2022-09-30,4,2022,1247304,1644
Bureau,Department of Agriculture,Food and Nutrition Service,null,2.640644978665609,21.374045801526716,2521102,103,68379,28,30,09,3,2022,2022-09-30,4,2022,2589481,131
Bureau,Pension Benefit Guaranty Corp,Pension Benefit Guaranty Corporation,null,100.0,100.0,0,0,3270867,1060,30,09,3,2022,2022-09-30,4,2022,3270867,1060
Bureau,Department of the Treasury,Community Dev Financial Inst Fund,null,100.0,100.0,0,0,3687238,7,30,09,3,2022,2022-09-30,4,2022,3687238,7
Bureau,Office of Personnel Management,Office of Personnel Management,null,100.0,100.0,0,0,13793795,994,30,09,3,2022,2022-09-30,4,2022,13793795,994
Bureau,General Services Administration,General Services Administration,null,93.20673116182941,94.16909620991254,965826,100,13251571,1615,30,09,3,2022,2022-09-30,4,2022,14217397,1715
Bureau,Department of the Treasury,Departmental Offices,null,99.1120686602655,99.62264150943396,194592,5,21720616,1320,30,09,3,2022,2022-09-30,4,2022,21915208,1325
Bureau,Department of Commerce,NOAA,null,100.0,100.0,0,0,12953025,1012,30,09,3,2022,2022-09-30,4,2022,12953025,1012
Bureau,Department of Veterans Affairs,Medical and Construction,null,40.13498052317006,98.87265957516219,309247619,41468,207327205,3636924,30,09,3,2022,2022-09-30,4,2022,516574824,3678392
Bureau,Commodity Futures Trading Commission,Commodity Futures Trading Commission,null,100.0,100.0,0,0,649446964,361,30,09,3,2022,2022-09-30,4,2022,649446964,361
Bureau,Department of Agriculture,Farm Service Agency,null,100.0,100.0,0,0,803161622,13057,30,09,3,2022,2022-09-30,4,2022,803161622,13057
Bureau,Department of Agriculture,Rural Development,null,99.99615182329566,99.65124758251166,32510,110,844783165,31431,30,09,3,2022,2022-09-30,4,2022,844815675,31541
Bureau,Department of Education,Departmental Management,null,96.79411377378372,93.92789373814041,45154598,128,1363335748,1980,30,09,3,2022,2022-09-30,4,2022,1408490346,2108
Bureau,Securities & Exchange Commission,SEC Enforcement,null,100.0,100.0,0,0,2161228791,1116,30,09,3,2022,2022-09-30,4,2022,2161228791,1116
Bureau,Department of Education,Federal Student Aid,null,100.0,100.0,0,0,125942201072,21825454,30,09,3,2022,2022-09-30,4,2022,125942201072,21825454
Agency,Office of Government Ethics,null,Non-CFO,0.0,0.0,0,0,0,0,30,09,3,2022,2022-09-30,4,2022,0,0
Bureau,Department of Agriculture,Forest Service,null,93.28723785127247,25.673854447439354,4895923,1103,68038629,381,30,09,3,2022,2022-09-30,4,2022,72934552,1484
Bureau,Department of Transportation,Federal Motor Carrier Safety Admin,null,99.9995762100163,99.98719590268887,295,1,69609656,7809,30,09,3,2022,2022-09-30,4,2022,69609951,7810
Bureau,Department of Labor,Occupational Safety and Health Admin,null,93.43420090759129,77.63340263340264,4631841,1291,65913129,4481,30,09,3,2022,2022-09-30,4,2022,70544970,5772
Bureau,U.S. Postal Service,U.S. Postal Service,null,76.03448209997207,71.40286216130612,18192946,19863,57720064,49595,30,09,3,2022,2022-09-30,4,2022,75913010,69458
Bureau,Department of Labor,Employment Standards Administration,null,86.92335750407709,63.866231647634585,10066090,1772,66911544,3132,30,09,3,2022,2022-09-30,4,2022,76977634,4904
Bureau,Department of Housing and Urban Development,Housing Programs,null,99.96962339113605,99.86957939354419,24466,4,80517770,3063,30,09,3,2022,2022-09-30,4,2022,80542236,3067
Bureau,Department of Health & Human Services,Indian Health Services,null,100.0,100.0,0,0,83985277,4171,30,09,3,2022,2022-09-30,4,2022,83985277,4171
Bureau,Department of Justice,Legal Activities,null,96.16855808700144,99.03534496064208,3579232,375,89838131,38499,30,09,3,2022,2022-09-30,4,2022,93417363,38874
Bureau,Department of Health & Human Services,Health Resources and Services Admin,null,100.0,100.0,0,0,108340423,629,30,09,3,2022,2022-09-30,4,2022,108340423,629
Bureau,Department of Health & Human Services,Food and Drug Administration,null,31.748087121745773,7.477957470885002,88727871,19623,41272692,1586,30,09,3,2022,2022-09-30,4,2022,130000563,21209
Bureau,Department of Agriculture,Commodity Credit Corporation,null,100.0,100.0,0,0,140937138,9780,30,09,3,2022,2022-09-30,4,2022,140937138,9780
Bureau,Department of Homeland Security,Emergency Preparedness & Resp,null,100.0,100.0,0,0,237796645,39723,30,09,3,2022,2022-09-30,4,2022,237796645,39723
Bureau,Federal Communications Commission,Federal Communications Commission,null,100.0,100.0,0,0,237880836,12731,30,09,3,2022,2022-09-30,4,2022,237880836,12731
Bureau,Federal Trade Commission,Federal Trade Commission,null,100.0,100.0,0,0,482179661,66,30,09,3,2022,2022-09-30,4,2022,482179661,66
Bureau,Other Agencies,Architect of the Capitol,null,0.0,0.0,0,0,0,0,31,12,4,2022,2022-12-31,1,2023,0,0
Bureau,Other Agencies,Archit.&Trans. Barriers Compliance Bd,null,0.0,0.0,0,0,0,0,31,12,4,2022,2022-12-31,1,2023,0,0
Bureau,Other Agencies,Federal Housing Finance Agency,null,0.0,0.0,0,0,0,0,31,12,4,2022,2022-12-31,1,2023,0,0
Bureau,Department of Justice,General Administration,null,0.0,0.0,0,0,0,0,31,12,4,2022,2022-12-31,1,2023,0,0
Bureau,Other Agencies,Defense Nuclear Facilities Safety Board,null,0.0,0.0,0,0,0,0,31,12,4,2022,2022-12-31,1,2023,0,0
Bureau,Other Agencies,Federal Mine Safety & Health Review Comm,null,0.0,0.0,0,0,0,0,31,12,4,2022,2022-12-31,1,2023,0,0
Bureau,Department of the Treasury,Office of the Secretary,null,0.0,0.0,0,0,0,0,31,12,4,2022,2022-12-31,1,2023,0,0
Bureau,Office of Special Counsel,Office of Special Counsel,null,0.0,0.0,0,0,0,0,31,12,4,2022,2022-12-31,1,2023,0,0
Bureau,Legislative Branch-Office of Tech.,Medicaid & CHIP Payment & Access Comm.,null,0.0,0.0,0,0,0,0,31,12,4,2022,2022-12-31,1,2023,0,0
Bureau,Other Agencies/Boards/Commissions,Medicare Payment Advisory Commission,null,0.0,0.0,0,0,0,0,31,12,4,2022,2022-12-31,1,2023,0,0
Bureau,Other Agencies,Morris K. Udall Scholarship,null,0.0,0.0,0,0,0,0,31,12,4,2022,2022-12-31,1,2023,0,0
Bureau,Neighborhood Reinvestment Corporation,Neighborhood Reinvestment Corporation,null,0.0,0.0,0,0,0,0,31,12,4,2022,2022-12-31,1,2023,0,0
Bureau,Other Agencies/Boards/Commissions,Nuclear Waste Technical Review Board,null,0.0,0.0,0,0,0,0,31,12,4,2022,2022-12-31,1,2023,0,0
Bureau,Department of the Treasury,Office of Sec International Affairs,null,0.0,0.0,0,0,0,0,31,12,4,2022,2022-12-31,1,2023,0,0
Agency,Social Security Administration,null,CFO,57.285101322008295,31.971962223189394,1888198215,920635,2532269288,432682,31,12,4,2022,2022-12-31,1,2023,4420467503,1353317
Agency,Department of Health & Human Services,null,CFO,96.5410383443517,97.22045203500723,356045922,31404,9937387699,1098420,31,12,4,2022,2022-12-31,1,2023,10293433621,1129824
Agency,Small Business Administration,null,CFO,100.0,100.0,0,0,13906655806,128786,31,12,4,2022,2022-12-31,1,2023,13906655806,128786
Bureau,Legislative Branch-Office of Tech.,Open World Leadership,null,0.0,0.0,0,0,0,0,31,12,4,2022,2022-12-31,1,2023,0,0
Bureau,Department of Health & Human Services,Office of the Inspector General,null,0.0,0.0,0,0,0,0,31,12,4,2022,2022-12-31,1,2023,0,0
Bureau,Other Agencies,Denali Commission,null,0.0,0.0,0,0,0,0,31,12,4,2022,2022-12-31,1,2023,0,0
Bureau,Other Agencies,U.S. Holocaust Memorial Council,null,0.0,0.0,0,0,0,0,31,12,4,2022,2022-12-31,1,2023,0,0
Bureau,Smithsonian Institution,National Gallery of Art,null,0.0,0.0,0,0,0,0,31,12,4,2022,2022-12-31,1,2023,0,0
Bureau,American Battle Monuments Commission,American Battle Monuments Commission,null,0.0,0.0,0,0,0,0,31,12,4,2022,2022-12-31,1,2023,0,0
Agency,National Aeronautics and Space Administration,null,CFO,100.0,100.0,0,0,1523852,128,31,12,4,2022,2022-12-31,1,2023,1523852,128
Agency,Nuclear Regulatory Commission,null,CFO,100.0,100.0,0,0,3380515,385,31,12,4,2022,2022-12-31,1,2023,3380515,385
Agency,General Services Administration,null,CFO,82.97738345063425,77.37520128824477,1948830,281,9499645,961,31,12,4,2022,2022-12-31,1,2023,11448475,1242
Agency,Department of Energy,null,CFO,96.1754125013941,94.0677966101695,545936,7,13728440,111,31,12,4,2022,2022-12-31,1,2023,14274376,118
Agency,Department of State,null,CFO,96.58771785209176,99.82196109850003,834331,40,23616490,22427,31,12,4,2022,2022-12-31,1,2023,24450821,22467
Agency,Agency for International Development,null,CFO,99.99892710223764,98.03921568627452,272,1,25351631,50,31,12,4,2022,2022-12-31,1,2023,25351903,51
Agency,Environmental Protection Agency,null,CFO,99.9985623894384,99.23371647509579,377,2,26223693,259,31,12,4,2022,2022-12-31,1,2023,26224070,261
Agency,Department of the Treasury,null,CFO,98.47191897366437,99.72950478568455,639090,13,41183954,4793,31,12,4,2022,2022-12-31,1,2023,41823044,4806
Agency,Office of Personnel Management,null,CFO,34.878107407796,90.00876424189308,34125251,114,18276867,1027,31,12,4,2022,2022-12-31,1,2023,52402118,1141
Agency,Department of Commerce,null,CFO,100.0,100.0,0,0,60359754,18226,31,12,4,2022,2022-12-31,1,2023,60359754,18226
Agency,Department of Agriculture,null,CFO,99.18498132042393,91.96410285054647,12552936,4316,1527649309,49393,31,12,4,2022,2022-12-31,1,2023,1540202245,53709
Agency,Railroad Retirement Board,null,Non-CFO,100.0,100.0,0,0,21396551,4083,31,12,4,2022,2022-12-31,1,2023,21396551,4083
Agency,U.S. Postal Service,null,Non-CFO,99.80060741758028,84.49687448138519,137592,11210,68867984,61098,31,12,4,2022,2022-12-31,1,2023,69005576,72308
Agency,Federal Communications Commission,null,Non-CFO,100.0,100.0,0,0,236974371,13124,31,12,4,2022,2022-12-31,1,2023,236974371,13124
Agency,US International Development Fin. Corp.,null,Non-CFO,0.0,0.0,265967767,72,0,0,31,12,4,2022,2022-12-31,1,2023,265967767,72
Agency,Federal Trade Commission,null,Non-CFO,100.0,100.0,0,0,481040354,60,31,12,4,2022,2022-12-31,1,2023,481040354,60
Bureau,Funds Appropriated to the President,Executive Branch,null,0.0,0.0,0,0,0,0,31,12,4,2022,2022-12-31,1,2023,0,0
Bureau,Department of Commerce,Office of the Inspector General,null,0.0,0.0,0,0,0,0,31,12,4,2022,2022-12-31,1,2023,0,0
Bureau,U.S. Tax Court,U.S. Tax Court,null,0.0,0.0,0,0,0,0,31,12,4,2022,2022-12-31,1,2023,0,0
Bureau,Other Agencies,U.S.  Agency of Global Media,null,0.0,0.0,0,0,0,0,31,12,4,2022,2022-12-31,1,2023,0,0
Bureau,Department of Justice,U.S. Marshals Service,null,0.0,0.0,0,0,0,0,31,12,4,2022,2022-12-31,1,2023,0,0
Bureau,Smithsonian Institution,JFK Center for the Performing Arts,null,0.0,0.0,0,0,0,0,31,12,4,2022,2022-12-31,1,2023,0,0
Bureau,Department of State,International Commissions,null,0.0,0.0,0,0,0,0,31,12,4,2022,2022-12-31,1,2023,0,0
Agency,Department of Housing and Urban Development,null,CFO,96.80325973111036,99.51690821256038,2063060,12,62473306,2472,31,12,4,2022,2022-12-31,1,2023,64536366,2484
Agency,Department of the Interior,null,CFO,99.99559313359052,99.90009704858137,3187,35,72315774,34999,31,12,4,2022,2022-12-31,1,2023,72318961,35034
Agency,Department of Transportation,null,CFO,99.99927253749529,99.98778998778998,548,1,75329795,8189,31,12,4,2022,2022-12-31,1,2023,75330343,8190
Agency,Department of Justice,null,CFO,97.28256121947419,98.92200542838121,2487673,421,89057094,38633,31,12,4,2022,2022-12-31,1,2023,91544767,39054
Agency,Department of Labor,null,CFO,90.0858721819771,78.53897238727717,17056704,3070,154987719,11235,31,12,4,2022,2022-12-31,1,2023,172044423,14305
Agency,Department of Homeland Security,null,CFO,98.1509751592292,82.31634735290784,5185299,12479,275248954,58089,31,12,4,2022,2022-12-31,1,2023,280434253,70568
Agency,Department of Veterans Affairs,null,CFO,98.96328428226785,99.95472204974607,4202204,4780,401135916,10552235,31,12,4,2022,2022-12-31,1,2023,405338120,10557015
Agency,Federal Mediation/Conciliation Service,null,Non-CFO,0.0,0.0,0,0,0,0,31,12,4,2022,2022-12-31,1,2023,0,0
Agency,U.S. Court of Appeals / Veterans Claims,null,Non-CFO,0.0,0.0,0,0,0,0,31,12,4,2022,2022-12-31,1,2023,0,0
Agency,Consumer Product Safety Commission,null,Non-CFO,100.0,100.0,0,0,265,2,31,12,4,2022,2022-12-31,1,2023,265,2
Agency,National Credit Union Administration,null,Non-CFO,100.0,100.0,0,0,445,1,31,12,4,2022,2022-12-31,1,2023,445,1
Agency,Equal Employment Opportunity Commission,null,Non-CFO,100.0,100.0,0,0,24912,23,31,12,4,2022,2022-12-31,1,2023,24912,23
Agency,Legislative Branch - U.S. House/Senate,null,Non-CFO,0.0,0.0,269543,234,0,0,31,12,4,2022,2022-12-31,1,2023,269543,234
Bureau,Office of Compliance,Office of Compliance,null,0.0,0.0,0,0,0,0,31,12,4,2022,2022-12-31,1,2023,0,0
Bureau,Funds Appropriated to the President,Peace Corps,null,0.0,0.0,0,0,0,0,31,12,4,2022,2022-12-31,1,2023,0,0
Bureau,Other Agencies,Gulf Coast Ecosystem Restoration Council,null,0.0,0.0,0,0,0,0,31,12,4,2022,2022-12-31,1,2023,0,0
Bureau,Other Agencies,Federal Housing Finance Agency OIG,null,0.0,0.0,0,0,0,0,31,12,4,2022,2022-12-31,1,2023,0,0
Bureau,Other Agencies,National Capital Planning Commission,null,0.0,0.0,0,0,0,0,31,12,4,2022,2022-12-31,1,2023,0,0
Bureau,Occupational Safety & Health Rev Comm,Occupational Safety & Health Rev Comm,null,0.0,0.0,0,0,0,0,31,12,4,2022,2022-12-31,1,2023,0,0
Bureau,Farm Credit Administration,Farm Credit System Insurance Corporation,null,0.0,0.0,0,0,0,0,31,12,4,2022,2022-12-31,1,2023,0,0
Bureau,Department of Homeland Security,Info Analysis Infrastructure Prot-NPPD,null,0.0,0.0,0,0,0,0,31,12,4,2022,2022-12-31,1,2023,0,0
Bureau,Department of Homeland Security,Management Headquarters,null,0.0,0.0,0,0,0,0,31,12,4,2022,2022-12-31,1,2023,0,0
Agency,National Science Foundation,null,CFO,100.0,100.0,0,0,556441,50,31,12,4,2022,2022-12-31,1,2023,556441,50
Agency,Merit Systems Protection Board,null,Non-CFO,100.0,100.0,0,0,144,1,31,12,4,2022,2022-12-31,1,2023,144,1
Agency,Farm Credit Administration,null,Non-CFO,100.0,100.0,0,0,630,1,31,12,4,2022,2022-12-31,1,2023,630,1
Bureau,Funds Appropriated to the President,Inter-American Foundation,null,0.0,0.0,0,0,0,0,31,12,4,2022,2022-12-31,1,2023,0,0
Bureau,Department of the Treasury,Treasury Franchise Fund,null,0.0,0.0,0,0,0,0,31,12,4,2022,2022-12-31,1,2023,0,0
Bureau,U.S. Court of Appeals / Veterans Claims,U.S. Court of Appeals / Veterans Claims,null,0.0,0.0,0,0,0,0,31,12,4,2022,2022-12-31,1,2023,0,0
Bureau,Department of Commerce,Economic and Statistical Analysis,null,0.0,0.0,0,0,0,0,31,12,4,2022,2022-12-31,1,2023,0,0
Bureau,Other Agencies,Commission On Fine Arts,null,0.0,0.0,0,0,0,0,31,12,4,2022,2022-12-31,1,2023,0,0
Bureau,Other Agencies,Advisory Council on Hist. Preservation,null,0.0,0.0,0,0,0,0,31,12,4,2022,2022-12-31,1,2023,0,0
Bureau,Other Agencies,U.S. Institute of Peace,null,0.0,0.0,0,0,0,0,31,12,4,2022,2022-12-31,1,2023,0,0
Bureau,Department of Justice,Federal Prison System,null,0.0,0.0,0,0,0,0,31,12,4,2022,2022-12-31,1,2023,0,0
Bureau,Federal Deposit Insurance Corporation,Federal Deposit Insurance Corporation,null,0.0,0.0,0,0,0,0,31,12,4,2022,2022-12-31,1,2023,0,0
Bureau,Smithsonian Institution,Smithsonian Institution,null,0.0,0.0,0,0,0,0,31,12,4,2022,2022-12-31,1,2023,0,0
Bureau,Department of Homeland Security,Science and Technology,null,0.0,0.0,0,0,0,0,31,12,4,2022,2022-12-31,1,2023,0,0
Bureau,Department of the Treasury,U.S. Treasury IG Office,null,0.0,0.0,0,0,0,0,31,12,4,2022,2022-12-31,1,2023,0,0
Bureau,Department of Homeland Security,Office of the Inspector General DHS,null,100.0,100.0,0,0,100,1,31,12,4,2022,2022-12-31,1,2023,100,1
Bureau,Department of Transportation,Research Innovative Technology Admin,null,100.0,100.0,0,0,985,1,31,12,4,2022,2022-12-31,1,2023,985,1
Bureau,Department of the Treasury,Tobacco Tax and Trade,null,100.0,100.0,0,0,1000,1,31,12,4,2022,2022-12-31,1,2023,1000,1
Agency,Department of Defense,null,CFO,39.183889455344016,18.543029852774417,1981286019,1372743,1276544844,312494,31,12,4,2022,2022-12-31,1,2023,3257830863,1685237
Agency,Department of Education,null,CFO,99.98868266475111,99.99961740067403,14067966,81,124290511607,21170892,31,12,4,2022,2022-12-31,1,2023,124304579573,21170973
Agency,National Labor Relations Board,null,Non-CFO,0.0,0.0,0,0,0,0,31,12,4,2022,2022-12-31,1,2023,0,0
Agency,Tennessee Valley Authority,null,Non-CFO,0.0,0.0,0,0,0,0,31,12,4,2022,2022-12-31,1,2023,0,0
Agency,U.S. Tax Court,null,Non-CFO,0.0,0.0,0,0,0,0,31,12,4,2022,2022-12-31,1,2023,0,0
Agency,American Battle Monuments Commission,null,Non-CFO,0.0,0.0,0,0,0,0,31,12,4,2022,2022-12-31,1,2023,0,0
Agency,Export - Import  Bank,null,Non-CFO,0.0,0.0,0,0,0,0,31,12,4,2022,2022-12-31,1,2023,0,0
Agency,Legislative Branch-CBO,null,Non-CFO,0.0,0.0,0,0,0,0,31,12,4,2022,2022-12-31,1,2023,0,0
Agency,Office of Special Counsel,null,Non-CFO,0.0,0.0,0,0,0,0,31,12,4,2022,2022-12-31,1,2023,0,0
Agency,Smithsonian Institution,null,Non-CFO,0.0,0.0,0,0,0,0,31,12,4,2022,2022-12-31,1,2023,0,0
Agency,Federal Deposit Insurance Corporation,null,Non-CFO,0.0,0.0,0,0,0,0,31,12,4,2022,2022-12-31,1,2023,0,0
Agency,Legislative Branch-GPO,null,Non-CFO,0.0,0.0,0,0,0,0,31,12,4,2022,2022-12-31,1,2023,0,0
Agency,Legislative Branch-Office of Tech.,null,Non-CFO,0.0,0.0,0,0,0,0,31,12,4,2022,2022-12-31,1,2023,0,0
Agency,Legis Branch-Library of Congress,null,Non-CFO,0.0,0.0,0,0,0,0,31,12,4,2022,2022-12-31,1,2023,0,0
Agency,Office of Government Ethics,null,Non-CFO,0.0,0.0,0,0,0,0,31,12,4,2022,2022-12-31,1,2023,0,0
Agency,Legislative Branch-GAO,null,Non-CFO,0.0,0.0,0,0,0,0,31,12,4,2022,2022-12-31,1,2023,0,0
Agency,Federal Labor Relations Authority,null,Non-CFO,0.0,0.0,0,0,0,0,31,12,4,2022,2022-12-31,1,2023,0,0
Agency,National Foundation  Arts & Humanities,null,Non-CFO,0.0,0.0,0,0,0,0,31,12,4,2022,2022-12-31,1,2023,0,0
Agency,Other Agencies/Boards/Commissions,null,Non-CFO,0.0,0.0,1024,1,0,0,31,12,4,2022,2022-12-31,1,2023,1024,1
Agency,Selective Service System,null,Non-CFO,0.0,0.0,2358,11,0,0,31,12,4,2022,2022-12-31,1,2023,2358,11
Agency,Neighborhood Reinvestment Corporation,null,Non-CFO,0.0,0.0,0,0,0,0,31,12,4,2022,2022-12-31,1,2023,0,0
Agency,Occupational Safety & Health Rev Comm,null,Non-CFO,0.0,0.0,0,0,0,0,31,12,4,2022,2022-12-31,1,2023,0,0
Agency,Office of Compliance,null,Non-CFO,0.0,0.0,0,0,0,0,31,12,4,2022,2022-12-31,1,2023,0,0
Agency,Armed Forces Retirement Home,null,Non-CFO,85.8457072680585,99.01960784313725,12678,1,76892,101,31,12,4,2022,2022-12-31,1,2023,89570,102
Agency,National Archives & Records Admin,null,Non-CFO,90.81160899279463,97.10144927536231,11885,4,117463,134,31,12,4,2022,2022-12-31,1,2023,129348,138
Agency,Federal Maritime Commission,null,Non-CFO,100.0,100.0,0,0,397899,6,31,12,4,2022,2022-12-31,1,2023,397899,6
Agency,The Judiciary,null,Non-CFO,93.1717712071422,54.78547854785479,72705,137,992066,166,31,12,4,2022,2022-12-31,1,2023,1064771,303
Agency,Funds Appropriated to the President,null,Non-CFO,0.19112955386147104,50.0,1236060,7,2367,7,31,12,4,2022,2022-12-31,1,2023,1238427,14
Agency,Presidio Trust Corporation,null,Non-CFO,100.0,100.0,0,0,1520774,62,31,12,4,2022,2022-12-31,1,2023,1520774,62
Agency,Federal Election Commission,null,Non-CFO,100.0,100.0,0,0,2126001,300,31,12,4,2022,2022-12-31,1,2023,2126001,300
Agency,Pension Benefit Guaranty Corp,null,Non-CFO,100.0,100.0,0,0,3300663,1227,31,12,4,2022,2022-12-31,1,2023,3300663,1227
Agency,Commodity Futures Trading Commission,null,Non-CFO,100.0,100.0,0,0,622455680,360,31,12,4,2022,2022-12-31,1,2023,622455680,360
Agency,Securities & Exchange Commission,null,Non-CFO,100.0,100.0,0,0,2167262880,1181,31,12,4,2022,2022-12-31,1,2023,2167262880,1181
Bureau,Legislative Branch-GPO,Government Publishing Office,null,0.0,0.0,0,0,0,0,31,12,4,2022,2022-12-31,1,2023,0,0
Bureau,Legislative Branch-GAO,Government Accountability Office,null,0.0,0.0,0,0,0,0,31,12,4,2022,2022-12-31,1,2023,0,0
Bureau,Funds Appropriated to the President,Defense Security Assistance Agency,null,0.0,0.0,0,0,0,0,31,12,4,2022,2022-12-31,1,2023,0,0
Bureau,Department of Commerce,Minority Business Development Agency,null,0.0,0.0,0,0,0,0,31,12,4,2022,2022-12-31,1,2023,0,0
Bureau,Department of the Treasury,International Monetary Funds,null,0.0,0.0,0,0,0,0,31,12,4,2022,2022-12-31,1,2023,0,0
Bureau,Other Agencies,District of Columbia Government,null,0.0,0.0,0,0,0,0,31,12,4,2022,2022-12-31,1,2023,0,0
Bureau,Department of Housing and Urban Development,Community Planning and Development,null,0.0,0.0,0,0,0,0,31,12,4,2022,2022-12-31,1,2023,0,0
Bureau,Export - Import  Bank,Export-Import Bank,null,0.0,0.0,0,0,0,0,31,12,4,2022,2022-12-31,1,2023,0,0
Bureau,Other Agencies/Boards/Commissions,U.S. Comm. on Int. Religious Freedom,null,0.0,0.0,1024,1,0,0,31,12,4,2022,2022-12-31,1,2023,1024,1
Bureau,Department of Homeland Security,Domestic Nuclear Detection Office,null,0.0,0.0,1493,17,0,0,31,12,4,2022,2022-12-31,1,2023,1493,17
Bureau,Legislative Branch-CBO,Congressional Budget Office,null,0.0,0.0,0,0,0,0,31,12,4,2022,2022-12-31,1,2023,0,0
Bureau,Department of Commerce,International Trade Administration,null,0.0,0.0,0,0,0,0,31,12,4,2022,2022-12-31,1,2023,0,0
Bureau,Other Agencies,Surface Transportation Board,null,0.0,0.0,0,0,0,0,31,12,4,2022,2022-12-31,1,2023,0,0
Bureau,Other Agencies,Millennium Challenge Corporation,null,0.0,0.0,0,0,0,0,31,12,4,2022,2022-12-31,1,2023,0,0
Bureau,Other Agencies,Comm. for Purchase from Blind/Handic.,null,0.0,0.0,0,0,0,0,31,12,4,2022,2022-12-31,1,2023,0,0
Bureau,Federal Mediation/Conciliation Service,Federal Mediation/Conciliation Service,null,0.0,0.0,0,0,0,0,31,12,4,2022,2022-12-31,1,2023,0,0
Bureau,Department of Housing and Urban Development,Government National Mortgage Association,null,0.0,0.0,0,0,0,0,31,12,4,2022,2022-12-31,1,2023,0,0
Bureau,Other Agencies/Boards/Commissions,U.S.-China Security Review Commission,null,0.0,0.0,0,0,0,0,31,12,4,2022,2022-12-31,1,2023,0,0
Bureau,Tennessee Valley Authority,Tennessee Valley Authority,null,0.0,0.0,0,0,0,0,31,12,4,2022,2022-12-31,1,2023,0,0
Bureau,Department of the Treasury,Treasury Forfeiture Fund,null,0.0,0.0,0,0,0,0,31,12,4,2022,2022-12-31,1,2023,0,0
Bureau,Merit Systems Protection Board,Merit Systems Protection Board,null,100.0,100.0,0,0,144,1,31,12,4,2022,2022-12-31,1,2023,144,1
Bureau,Department of the Treasury,Treasury IG for Tax Admin,null,100.0,100.0,0,0,193,1,31,12,4,2022,2022-12-31,1,2023,193,1
Bureau,Consumer Product Safety Commission,Consumer Product Safety Commission,null,100.0,100.0,0,0,265,2,31,12,4,2022,2022-12-31,1,2023,265,2
Bureau,Department of the Treasury,Office of Financial Research,null,100.0,100.0,0,0,268,1,31,12,4,2022,2022-12-31,1,2023,268,1
Bureau,National Credit Union Administration,National Credit Union Administration,null,100.0,100.0,0,0,445,1,31,12,4,2022,2022-12-31,1,2023,445,1
Bureau,Farm Credit Administration,Farm Credit Administration,null,100.0,100.0,0,0,630,1,31,12,4,2022,2022-12-31,1,2023,630,1
Bureau,Department of the Interior,"Bureau of Ocean Energy Mgmt., Reg & Enf",null,100.0,100.0,0,0,1724,1,31,12,4,2022,2022-12-31,1,2023,1724,1
Bureau,Other Agencies,Council of Insps. Gen. of Intg. & Effy.,null,0.0,0.0,2228,5,0,0,31,12,4,2022,2022-12-31,1,2023,2228,5
Bureau,Selective Service System,Selective Service System,null,0.0,0.0,2358,11,0,0,31,12,4,2022,2022-12-31,1,2023,2358,11
Bureau,Funds Appropriated to the President,African Development Foundation,null,100.0,100.0,0,0,2367,7,31,12,4,2022,2022-12-31,1,2023,2367,7
Bureau,Other Agencies,John C. Stennis,null,0.0,0.0,2934,2,0,0,31,12,4,2022,2022-12-31,1,2023,2934,2
Bureau,Department of the Treasury,Spec Insp Gen-Troubled Asset Rel Prog,null,100.0,100.0,0,0,3916,1,31,12,4,2022,2022-12-31,1,2023,3916,1
Bureau,Other Agencies,Delta Regional Authority,null,0.0,0.0,0,0,0,0,31,12,4,2022,2022-12-31,1,2023,0,0
Bureau,Federal Labor Relations Authority,Federal Labor Relations Authority,null,0.0,0.0,0,0,0,0,31,12,4,2022,2022-12-31,1,2023,0,0
Bureau,Department of Commerce,General Administration,null,100.0,100.0,0,0,4660,1,31,12,4,2022,2022-12-31,1,2023,4660,1
Bureau,Department of Housing and Urban Development,Management and Administration,null,100.0,100.0,0,0,4706,2,31,12,4,2022,2022-12-31,1,2023,4706,2
Bureau,Other Agencies,Election Assistance Commission,null,0.0,0.0,5576,1,0,0,31,12,4,2022,2022-12-31,1,2023,5576,1
Bureau,Department of Labor,Bureau of Labor Statistics,null,100.0,100.0,0,0,5608,1,31,12,4,2022,2022-12-31,1,2023,5608,1
Bureau,Department of Transportation,St. Lawrence Seaway Development Corp.,null,100.0,100.0,0,0,7728,2,31,12,4,2022,2022-12-31,1,2023,7728,2
Bureau,Department of Health & Human Services,Administration for Community Living,null,100.0,100.0,0,0,8321,1,31,12,4,2022,2022-12-31,1,2023,8321,1
Bureau,Department of Homeland Security,Federal Law Enforcement Training Ctr.,null,100.0,100.0,0,0,8562,1,31,12,4,2022,2022-12-31,1,2023,8562,1
Bureau,Other Agencies,U.S. Inst. for Env. Conflict Resolution,null,0.0,0.0,8859,2,0,0,31,12,4,2022,2022-12-31,1,2023,8859,2
Bureau,Department of the Treasury,Pandemic Receivables,null,0.0,0.0,256377,3,0,0,31,12,4,2022,2022-12-31,1,2023,256377,3
Bureau,Legislative Branch - U.S. House/Senate,U.S. House of Representatives,null,0.0,0.0,269543,234,0,0,31,12,4,2022,2022-12-31,1,2023,269543,234
Bureau,Department of Commerce,Nat'l Telecomm & Information Admin.,null,100.0,100.0,0,0,296093,1,31,12,4,2022,2022-12-31,1,2023,296093,1
Bureau,Department of Justice,Drug Enforcement Administration,null,100.0,100.0,0,0,307536,21,31,12,4,2022,2022-12-31,1,2023,307536,21
Bureau,Department of Justice,Federal Bureau of Investigation,null,100.0,100.0,0,0,448751,100,31,12,4,2022,2022-12-31,1,2023,448751,100
Bureau,Department of Veterans Affairs,Housing Credit Assistance,null,0.14922120319880444,1.7241379310344827,448997,57,671,1,31,12,4,2022,2022-12-31,1,2023,449668,58
Bureau,Department of the Treasury,D.C. Pension Program,null,100.0,100.0,0,0,455729,21,31,12,4,2022,2022-12-31,1,2023,455729,21
Bureau,Department of Health & Human Services,Office of the Secretary,null,100.0,100.0,0,0,466825,7,31,12,4,2022,2022-12-31,1,2023,466825,7
Bureau,Department of the Treasury,Departmental Offices,null,98.19037612979952,99.54545454545455,379670,6,20600933,1314,31,12,4,2022,2022-12-31,1,2023,20980603,1320
Bureau,Railroad Retirement Board,Railroad Retirement Board,null,100.0,100.0,0,0,21396551,4083,31,12,4,2022,2022-12-31,1,2023,21396551,4083
Bureau,Department of Education,Federal Student Aid,null,100.0,100.0,0,0,122871093000,21168883,31,12,4,2022,2022-12-31,1,2023,122871093000,21168883
Bureau,Department of the Interior,Bureau of Safety and Environmental Enf.,null,100.0,100.0,0,0,14790,3,31,12,4,2022,2022-12-31,1,2023,14790,3
Bureau,Department of Justice,Bureau of ATF and Explosives,null,100.0,100.0,0,0,20073,3,31,12,4,2022,2022-12-31,1,2023,20073,3
Bureau,Department of Agriculture,Federal Crop Insurance Corporation,null,91.03054293554047,98.7146529562982,1994,5,20237,384,31,12,4,2022,2022-12-31,1,2023,22231,389
Bureau,Department of the Treasury,U.S. Mint,null,95.89103011874923,95.0,1000,1,23337,19,31,12,4,2022,2022-12-31,1,2023,24337,20
Bureau,Equal Employment Opportunity Commission,Equal Employment Opportunity Commission,null,100.0,100.0,0,0,24912,23,31,12,4,2022,2022-12-31,1,2023,24912,23
Bureau,Department of Justice,Federal Prison Industries,null,0.0,0.0,26508,16,0,0,31,12,4,2022,2022-12-31,1,2023,26508,16
Bureau,Other Agencies,Chemical Safety Board,null,100.0,100.0,0,0,33198,2,31,12,4,2022,2022-12-31,1,2023,33198,2
Bureau,Department of Transportation,National Highway Traffic Safety Admin.,null,100.0,100.0,0,0,37085,6,31,12,4,2022,2022-12-31,1,2023,37085,6
Bureau,Department of the Treasury,Bureau of Engraving and Printing,null,100.0,100.0,0,0,38345,2,31,12,4,2022,2022-12-31,1,2023,38345,2
Bureau,Department of the Treasury,Internal Revenue Service,null,100.0,100.0,0,0,44932,40,31,12,4,2022,2022-12-31,1,2023,44932,40
Bureau,Department of Transportation,Maritime Administration,null,100.0,100.0,0,0,66630,15,31,12,4,2022,2022-12-31,1,2023,66630,15
Bureau,Armed Forces Retirement Home,Armed Forces Retirement Home,null,85.8457072680585,99.01960784313725,12678,1,76892,101,31,12,4,2022,2022-12-31,1,2023,89570,102
Bureau,Department of the Interior,Office of the Secretary,null,100.0,100.0,0,0,102162,27,31,12,4,2022,2022-12-31,1,2023,102162,27
Bureau,National Archives & Records Admin,Nat'l Archives & Records Administration,null,90.81160899279463,97.10144927536231,11885,4,117463,134,31,12,4,2022,2022-12-31,1,2023,129348,138
Bureau,Department of Transportation,Federal Railroad Administration,null,100.0,100.0,0,0,144217,16,31,12,4,2022,2022-12-31,1,2023,144217,16
Bureau,Department of Energy,Energy Consolidated Reports,null,100.0,100.0,0,0,12670948,87,31,12,4,2022,2022-12-31,1,2023,12670948,87
Bureau,Department of Commerce,NOAA,null,100.0,100.0,0,0,12995655,989,31,12,4,2022,2022-12-31,1,2023,12995655,989
Bureau,Department of the Treasury,Bureau of the Fiscal Service,null,100.0,100.0,0,0,13373149,3360,31,12,4,2022,2022-12-31,1,2023,13373149,3360
Bureau,Department of Homeland Security,Immigration and Customs Enforcement,null,100.0,100.0,0,0,15802534,628,31,12,4,2022,2022-12-31,1,2023,15802534,628
Bureau,Department of the Interior,Bureau of Indian Affairs,null,99.98074044672978,99.8867607092015,3187,35,16544445,30873,31,12,4,2022,2022-12-31,1,2023,16547632,30908
Bureau,Department of Agriculture,U.S. Department of Agriculture,null,84.26826427296214,55.20504731861199,3256937,1988,17446036,2450,31,12,4,2022,2022-12-31,1,2023,20702973,4438
Bureau,Department of the Interior,Geological Survey,null,100.0,100.0,0,0,170576,493,31,12,4,2022,2022-12-31,1,2023,170576,493
Bureau,Other Agencies,James Madison Memorial Fellowship,null,0.0,0.0,197595,23,0,0,31,12,4,2022,2022-12-31,1,2023,197595,23
Bureau,Securities & Exchange Commission,Securities and Exchange Commission,null,100.0,100.0,0,0,254198,46,31,12,4,2022,2022-12-31,1,2023,254198,46
Bureau,Federal Maritime Commission,Salaries and Expenses,null,100.0,100.0,0,0,397899,6,31,12,4,2022,2022-12-31,1,2023,397899,6
Bureau,National Science Foundation,National Science Foundation,null,100.0,100.0,0,0,556441,50,31,12,4,2022,2022-12-31,1,2023,556441,50
Bureau,Department of Commerce,Patent and Trademark Office,null,100.0,100.0,0,0,612342,711,31,12,4,2022,2022-12-31,1,2023,612342,711
Bureau,Department of Commerce,Nat'l Institute of Standards& Technology,null,100.0,100.0,0,0,673458,5,31,12,4,2022,2022-12-31,1,2023,673458,5
Bureau,Department of Transportation,Federal Transit Administration,null,100.0,100.0,0,0,783405,1,31,12,4,2022,2022-12-31,1,2023,783405,1
Bureau,Department of the Interior,Fish and Wildlife Service,null,100.0,100.0,0,0,811631,113,31,12,4,2022,2022-12-31,1,2023,811631,113
Bureau,Department of Transportation,Pipeline Hazardous Material Safety Admin,null,100.0,100.0,0,0,881782,74,31,12,4,2022,2022-12-31,1,2023,881782,74
Bureau,The Judiciary,Administrative Office of the U.S. Courts,null,93.1717712071422,54.78547854785479,72705,137,992066,166,31,12,4,2022,2022-12-31,1,2023,1064771,303
Bureau,Department of Health & Human Services,Substance Abuse & Mental Health Admin.,null,100.0,100.0,0,0,1064911,12,31,12,4,2022,2022-12-31,1,2023,1064911,12
Bureau,Department of Homeland Security,Citizenship and Immigration Services,null,100.0,100.0,0,0,1094952,1278,31,12,4,2022,2022-12-31,1,2023,1094952,1278
Bureau,Department of Housing and Urban Development,Public and Indian Housing Programs,null,0.0,0.0,1109881,5,0,0,31,12,4,2022,2022-12-31,1,2023,1109881,5
Bureau,Department of Transportation,Office of the Secretary,null,100.0,100.0,0,0,1111148,16,31,12,4,2022,2022-12-31,1,2023,1111148,16
Bureau,Department of Veterans Affairs,Life Insurance,null,100.0,100.0,0,0,1223579,252,31,12,4,2022,2022-12-31,1,2023,1223579,252
Bureau,Department of Justice,Office of Justice Assistance Programs,null,100.0,100.0,0,0,1230807,6,31,12,4,2022,2022-12-31,1,2023,1230807,6
Bureau,Department of Veterans Affairs,Veterans Benefits,null,0.0,0.0,1231398,1632,0,0,31,12,4,2022,2022-12-31,1,2023,1231398,1632
Bureau,Funds Appropriated to the President,Trade and Development Agency,null,0.0,0.0,1236060,7,0,0,31,12,4,2022,2022-12-31,1,2023,1236060,7
Bureau,Department of Labor,Mine Safety and Health Administration,null,92.31185180039,84.38553134127163,955022,695,11466981,3756,31,12,4,2022,2022-12-31,1,2023,12422003,4451
Bureau,Department of Labor,Employment and Training Administration,null,100.0,100.0,0,0,1257939,11,31,12,4,2022,2022-12-31,1,2023,1257939,11
Bureau,Department of the Treasury,Comptroller of the Currency,null,99.85753803692575,88.0,2043,3,1432024,22,31,12,4,2022,2022-12-31,1,2023,1434067,25
Bureau,Presidio Trust Corporation,Presidio Trust Corporation,null,100.0,100.0,0,0,1520774,62,31,12,4,2022,2022-12-31,1,2023,1520774,62
Bureau,National Aeronautics and Space Administration,National Aeronautics and Space Admin,null,100.0,100.0,0,0,1523852,128,31,12,4,2022,2022-12-31,1,2023,1523852,128
Bureau,Department of the Treasury,Financial Crimes Enforcement Network,null,100.0,100.0,0,0,1544945,3,31,12,4,2022,2022-12-31,1,2023,1544945,3
Bureau,Department of Energy,Bonneville Power Administration,null,65.95194795151389,77.41935483870968,545936,7,1057492,24,31,12,4,2022,2022-12-31,1,2023,1603428,31
Bureau,Department of State,Passport NSF,null,100.0,100.0,0,0,1883867,12152,31,12,4,2022,2022-12-31,1,2023,1883867,12152
Bureau,Department of Veterans Affairs,Administration and Cemeteries,null,6.056131156693928,11.240721102863203,1776813,837,114543,106,31,12,4,2022,2022-12-31,1,2023,1891356,943
Bureau,Federal Election Commission,Federal Election Commission,null,100.0,100.0,0,0,2126001,300,31,12,4,2022,2022-12-31,1,2023,2126001,300
Bureau,Department of Transportation,Federal Aviation Administration,null,100.0,100.0,0,0,2185286,282,31,12,4,2022,2022-12-31,1,2023,2185286,282
Bureau,Department of Agriculture,Food and Nutrition Service,null,2.174714286419012,47.61904761904762,2776264,22,61718,20,31,12,4,2022,2022-12-31,1,2023,2837982,42
Bureau,Department of Commerce,Bureau of the Census,null,100.0,100.0,0,0,3028059,16479,31,12,4,2022,2022-12-31,1,2023,3028059,16479
Bureau,Other Agencies,Consumer Financial Protection Bureau,null,15.980237436953168,42.857142857142854,2689134,8,511463,6,31,12,4,2022,2022-12-31,1,2023,3200597,14
Bureau,Pension Benefit Guaranty Corp,Pension Benefit Guaranty Corporation,null,100.0,100.0,0,0,3300663,1227,31,12,4,2022,2022-12-31,1,2023,3300663,1227
Bureau,Nuclear Regulatory Commission,Nuclear Regulatory Commission,null,100.0,100.0,0,0,3380515,385,31,12,4,2022,2022-12-31,1,2023,3380515,385
Bureau,Department of the Treasury,Community Dev Financial Inst Fund,null,100.0,100.0,0,0,3665183,8,31,12,4,2022,2022-12-31,1,2023,3665183,8
Bureau,Corp. for National and Community Service,Corp. for National and Community Service,null,95.64945519782047,47.72036474164134,164127,172,3608435,157,31,12,4,2022,2022-12-31,1,2023,3772562,329
Bureau,Department of Commerce,Economic Development Administration,null,100.0,100.0,0,0,5137182,12,31,12,4,2022,2022-12-31,1,2023,5137182,12
Bureau,Department of Homeland Security,Transportation Safety Administration,null,100.0,100.0,0,0,11801911,12920,31,12,4,2022,2022-12-31,1,2023,11801911,12920
Bureau,Department of Homeland Security,U.S. Coast Guard,null,19.612157565447443,10.125486802250109,5183806,12462,1264689,1404,31,12,4,2022,2022-12-31,1,2023,6448495,13866
Bureau,Department of the Interior,Bureau of Reclamation,null,100.0,100.0,0,0,7339232,68,31,12,4,2022,2022-12-31,1,2023,7339232,68
Bureau,Department of the Interior,Office of Surface Mining,null,100.0,100.0,0,0,8147070,359,31,12,4,2022,2022-12-31,1,2023,8147070,359
Bureau,Department of the Interior,National Park Service,null,100.0,100.0,0,0,8661935,2056,31,12,4,2022,2022-12-31,1,2023,8661935,2056
Bureau,Department of the Interior,Bureau of Land Management,null,100.0,100.0,0,0,9070965,427,31,12,4,2022,2022-12-31,1,2023,9070965,427
Bureau,Department of Health & Human Services,Centers for Disease Control,null,9.71535255382105,16.346153846153847,8288722,87,891933,17,31,12,4,2022,2022-12-31,1,2023,9180655,104
Bureau,Department of Homeland Security,Bureau of Customs & Border Protection,null,100.0,100.0,0,0,9396552,777,31,12,4,2022,2022-12-31,1,2023,9396552,777
Bureau,General Services Administration,General Services Administration,null,82.97738345063425,77.37520128824477,1948830,281,9499645,961,31,12,4,2022,2022-12-31,1,2023,11448475,1242
Bureau,Department of Labor,Employee Benefit Security Administration,null,100.0,100.0,0,0,21655166,481,31,12,4,2022,2022-12-31,1,2023,21655166,481
Bureau,Department of State,Department of State,null,96.30286391331325,99.6122152205526,834331,40,21732623,10275,31,12,4,2022,2022-12-31,1,2023,22566954,10315
Bureau,Agency for International Development,Agency for International Development,null,99.99892710223764,98.03921568627452,272,1,25351631,50,31,12,4,2022,2022-12-31,1,2023,25351903,51
Bureau,Department of Health & Human Services,National Institutes of Health,null,28.625779546243006,13.457330415754923,18600488,791,7460025,123,31,12,4,2022,2022-12-31,1,2023,26060513,914
Bureau,Environmental Protection Agency,Environmental Protection Agency,null,99.9985623894384,99.23371647509579,377,2,26223693,259,31,12,4,2022,2022-12-31,1,2023,26224070,261
Bureau,Department of Health & Human Services,Administration for Children and Families,null,100.0,100.0,0,0,37066448,1657,31,12,4,2022,2022-12-31,1,2023,37066448,1657
Bureau,Department of Commerce,Bureau of Industry and Security,null,100.0,100.0,0,0,37612305,28,31,12,4,2022,2022-12-31,1,2023,37612305,28
Bureau,Office of Personnel Management,Office of Personnel Management,null,34.878107407796,90.00876424189308,34125251,114,18276867,1027,31,12,4,2022,2022-12-31,1,2023,52402118,1141
Bureau,Department of Agriculture,Agricultural Marketing Service,null,66.99380708284005,42.79633267845448,2109909,1747,4282555,1307,31,12,4,2022,2022-12-31,1,2023,6392464,3054
Bureau,Department of the Interior,Office of Natural Resources Revenue,null,100.0,100.0,0,0,21451244,579,31,12,4,2022,2022-12-31,1,2023,21451244,579
Bureau,Department of Housing and Urban Development,Housing Programs,null,98.4970793707947,99.71740008074283,953179,7,62468600,2470,31,12,4,2022,2022-12-31,1,2023,63421779,2477
Bureau,Department of Labor,Occupational Safety and Health Admin,null,89.45885081779863,82.37600470495981,6843915,899,58081786,4202,31,12,4,2022,2022-12-31,1,2023,64925701,5101
Bureau,U.S. Postal Service,U.S. Postal Service,null,99.80060741758028,84.49687448138519,137592,11210,68867984,61098,31,12,4,2022,2022-12-31,1,2023,69005576,72308
Bureau,Department of Transportation,Federal Motor Carrier Safety Admin,null,99.9992182362431,99.98712169993561,548,1,70097355,7764,31,12,4,2022,2022-12-31,1,2023,70097903,7765
Bureau,Department of Labor,Employment Standards Administration,null,87.10222320748225,65.35211267605634,9257767,1476,62520239,2784,31,12,4,2022,2022-12-31,1,2023,71778006,4260
Bureau,Department of Agriculture,Forest Service,null,94.02220171887258,46.558704453441294,4331495,396,68128210,345,31,12,4,2022,2022-12-31,1,2023,72459705,741
Bureau,Department of Justice,Legal Activities,null,97.25043573370773,98.95908296494294,2461165,405,87049927,38503,31,12,4,2022,2022-12-31,1,2023,89511092,38908
Bureau,Department of Health & Human Services,Indian Health Services,null,100.0,100.0,0,0,91046252,4415,31,12,4,2022,2022-12-31,1,2023,91046252,4415
Bureau,Department of Health & Human Services,Health Resources and Services Admin,null,100.0,100.0,0,0,108894444,633,31,12,4,2022,2022-12-31,1,2023,108894444,633
Bureau,Department of Agriculture,Commodity Credit Corporation,null,100.0,100.0,0,0,133287779,9302,31,12,4,2022,2022-12-31,1,2023,133287779,9302
Bureau,Department of Homeland Security,Emergency Preparedness & Resp,null,100.0,100.0,0,0,235879654,41080,31,12,4,2022,2022-12-31,1,2023,235879654,41080
Bureau,Federal Communications Commission,Federal Communications Commission,null,100.0,100.0,0,0,236974371,13124,31,12,4,2022,2022-12-31,1,2023,236974371,13124
Bureau,Department of Health & Human Services,Food and Drug Administration,null,15.937767362984552,8.632564973826797,219240736,19898,41566917,1880,31,12,4,2022,2022-12-31,1,2023,260807653,21778
Bureau,US International Development Fin. Corp.,US International Development Fin. Corp.,null,0.0,0.0,265967767,72,0,0,31,12,4,2022,2022-12-31,1,2023,265967767,72
Bureau,Department of Veterans Affairs,Medical and Construction,null,99.81400308115911,99.9786434315287,744996,2254,399797123,10551876,31,12,4,2022,2022-12-31,1,2023,400542119,10554130
Bureau,Department of Agriculture,Farm Service Agency,null,100.0,100.0,0,0,444918565,4504,31,12,4,2022,2022-12-31,1,2023,444918565,4504
Bureau,Federal Trade Commission,Federal Trade Commission,null,100.0,100.0,0,0,481040354,60,31,12,4,2022,2022-12-31,1,2023,481040354,60
Bureau,Commodity Futures Trading Commission,Commodity Futures Trading Commission,null,100.0,100.0,0,0,622455680,360,31,12,4,2022,2022-12-31,1,2023,622455680,360
Bureau,Department of Agriculture,Rural Development,null,99.99731372783627,99.67478595606292,23057,98,858303970,30036,31,12,4,2022,2022-12-31,1,2023,858327027,30134
Bureau,Securities & Exchange Commission,SEC Enforcement,null,100.0,100.0,0,0,2167008682,1135,31,12,4,2022,2022-12-31,1,2023,2167008682,1135
Bureau,Department of Defense,Consolidated Report,null,39.183889455344016,18.543029852774417,1981286019,1372743,1276544844,312494,31,12,4,2022,2022-12-31,1,2023,3257830863,1685237
Bureau,Social Security Administration,Social Security Administration,null,57.285101322008295,31.971962223189394,1888198215,920635,2532269288,432682,31,12,4,2022,2022-12-31,1,2023,4420467503,1353317
Bureau,Department of Health & Human Services,Centers for Medicare & Medicaid Services,null,98.87295346463551,99.03382608687747,109915976,10628,9642651691,1089381,31,12,4,2022,2022-12-31,1,2023,9752567667,1100009
Bureau,Small Business Administration,Small Business Administration,null,100.0,100.0,0,0,13906655806,128786,31,12,4,2022,2022-12-31,1,2023,13906655806,128786
Bureau,Department of State,Civil Monetary Penalties,null,null,null,null,null,null,null,31,12,4,2022,2022-12-31,1,2023,null,null
Bureau,Department of Health & Human Services,Program Support Center,null,100.0,100.0,0,0,6269932,294,31,12,4,2022,2022-12-31,1,2023,6269932,294
Bureau,National Foundation  Arts & Humanities,National Endowment for the Arts,null,0.0,0.0,0,0,0,0,31,12,4,2022,2022-12-31,1,2023,0,0
Bureau,Department of Transportation,Federal Highway Administration,null,100.0,100.0,0,0,14174,12,31,12,4,2022,2022-12-31,1,2023,14174,12
Bureau,Department of Agriculture,Food Safety and Inspection Service,null,95.74956582229707,94.57013574660634,53280,60,1200239,1045,31,12,4,2022,2022-12-31,1,2023,1253519,1105
Bureau,Department of Education,Departmental Management,null,99.01861892082054,96.1244019138756,14067966,81,1419418607,2009,31,12,4,2022,2022-12-31,1,2023,1433486573,2090
Bureau,Other Agencies,National Mediation Board,null,0.0,0.0,0,0,0,0,31,12,4,2022,2022-12-31,1,2023,0,0
Bureau,Office of Government Ethics,Office of Government Ethics,null,0.0,0.0,0,0,0,0,31,12,4,2022,2022-12-31,1,2023,0,0
Bureau,Department of Commerce,National Technical Information Service,null,0.0,0.0,0,0,0,0,31,12,4,2022,2022-12-31,1,2023,0,0
Bureau,Department of Education,Office of Postsecondary Education,null,0.0,0.0,0,0,0,0,31,12,4,2022,2022-12-31,1,2023,0,0
Bureau,Department of Housing and Urban Development,"Policy, Development and Research",null,0.0,0.0,0,0,0,0,31,12,4,2022,2022-12-31,1,2023,0,0
Bureau,Department of Labor,Departmental Management,null,0.0,0.0,0,0,0,0,31,12,4,2022,2022-12-31,1,2023,0,0
Bureau,Department of the Treasury,Interest on Tax/Deposit of Earnings,null,0.0,0.0,0,0,0,0,31,12,4,2022,2022-12-31,1,2023,0,0
Bureau,National Labor Relations Board,National Labor Relations Board,null,0.0,0.0,0,0,0,0,31,12,4,2022,2022-12-31,1,2023,0,0
Bureau,Department of Homeland Security,Office of Biometric Identity Management,null,0.0,0.0,0,0,0,0,31,12,4,2022,2022-12-31,1,2023,0,0
Bureau,Smithsonian Institution,Administrative Conference of the US,null,0.0,0.0,0,0,0,0,31,12,4,2022,2022-12-31,1,2023,0,0
Bureau,Department of Transportation,Office of the Inspector General,null,0.0,0.0,0,0,0,0,31,12,4,2022,2022-12-31,1,2023,0,0
Bureau,National Foundation  Arts & Humanities,National Endowment for the Humanities,null,0.0,0.0,0,0,0,0,31,12,4,2022,2022-12-31,1,2023,0,0
Bureau,Legis Branch-Library of Congress,Library of Congress,null,0.0,0.0,0,0,0,0,31,12,4,2022,2022-12-31,1,2023,0,0
Bureau,Other Agencies,Privacy & Civil Liberties Oversight Bd,null,0.0,0.0,0,0,0,0,31,12,4,2022,2022-12-31,1,2023,0,0
Bureau,Other Agencies,National Transportation Safety Board,null,0.0,0.0,0,0,0,0,31,12,4,2022,2022-12-31,1,2023,0,0
Bureau,Department of Homeland Security,U.S. Secret Service,null,0.0,0.0,0,0,0,0,31,12,4,2022,2022-12-31,1,2023,0,0
Agency,Corp. for National and Community Service,null,Non-CFO,95.64945519782047,47.72036474164134,164127,172,3608435,157,31,12,4,2022,2022-12-31,1,2023,3772562,329
Bureau,Other Agencies,National Council on Disability,null,43.39622641509434,50.0,30,1,23,1,31,12,4,2022,2022-12-31,1,2023,53,2
Agency,Other Agencies,null,Non-CFO,15.783184199545644,17.647058823529413,2906356,42,544684,9,31,12,4,2022,2022-12-31,1,2023,3451040,51
Bureau,Department of Homeland Security,Bureau of Customs & Border Protection,null,100.0,100.0,0,0,9904897,890,31,03,1,2023,2023-03-31,2,2023,9904897,890
Agency,Office of Personnel Management,null,CFO,100.0,100.0,0,0,20818481,1142,31,03,1,2023,2023-03-31,2,2023,20818481,1142
Agency,Nuclear Regulatory Commission,null,CFO,100.0,100.0,0,0,3403607,400,31,03,1,2023,2023-03-31,2,2023,3403607,400
Agency,National Science Foundation,null,CFO,100.0,100.0,0,0,723090,36,31,03,1,2023,2023-03-31,2,2023,723090,36
Agency,Office of Government Ethics,null,Non-CFO,0.0,0.0,0,0,0,0,31,03,1,2023,2023-03-31,2,2023,0,0
Bureau,Legislative Branch-Office of Tech.,Open World Leadership,null,0.0,0.0,0,0,0,0,31,03,1,2023,2023-03-31,2,2023,0,0
Bureau,Other Agencies,Privacy & Civil Liberties Oversight Bd,null,0.0,0.0,0,0,0,0,31,03,1,2023,2023-03-31,2,2023,0,0
Bureau,Department of the Treasury,Treasury Franchise Fund,null,0.0,0.0,0,0,0,0,31,03,1,2023,2023-03-31,2,2023,0,0
Bureau,Other Agencies,Federal Housing Finance Agency,null,0.0,0.0,0,0,0,0,31,03,1,2023,2023-03-31,2,2023,0,0
Bureau,Department of Commerce,Economic and Statistical Analysis,null,0.0,0.0,0,0,0,0,31,03,1,2023,2023-03-31,2,2023,0,0
Bureau,Other Agencies,Defense Nuclear Facilities Safety Board,null,0.0,0.0,0,0,0,0,31,03,1,2023,2023-03-31,2,2023,0,0
Bureau,Other Agencies,U.S. Institute of Peace,null,0.0,0.0,0,0,0,0,31,03,1,2023,2023-03-31,2,2023,0,0
Bureau,Other Agencies,Federal Mine Safety & Health Review Comm,null,0.0,0.0,0,0,0,0,31,03,1,2023,2023-03-31,2,2023,0,0
Bureau,Department of Justice,U.S. Marshals Service,null,0.0,0.0,0,0,0,0,31,03,1,2023,2023-03-31,2,2023,0,0
Bureau,Department of Housing and Urban Development,Community Planning and Development,null,0.0,0.0,0,0,0,0,31,03,1,2023,2023-03-31,2,2023,0,0
Bureau,Department of the Treasury,Office of the Secretary,null,0.0,0.0,0,0,0,0,31,03,1,2023,2023-03-31,2,2023,0,0
Bureau,Department of the Treasury,Office of Sec International Affairs,null,0.0,0.0,0,0,0,0,31,03,1,2023,2023-03-31,2,2023,0,0
Bureau,Department of the Treasury,Interest on Tax/Deposit of Earnings,null,0.0,0.0,0,0,0,0,31,03,1,2023,2023-03-31,2,2023,0,0
Bureau,National Labor Relations Board,National Labor Relations Board,null,0.0,0.0,0,0,0,0,31,03,1,2023,2023-03-31,2,2023,0,0
Bureau,Federal Labor Relations Authority,Federal Labor Relations Authority,null,0.0,0.0,0,0,0,0,31,03,1,2023,2023-03-31,2,2023,0,0
Agency,Department of Energy,null,CFO,99.99986076057586,99.03846153846153,20,1,14363728,103,31,03,1,2023,2023-03-31,2,2023,14363748,104
Agency,Department of Housing and Urban Development,null,CFO,99.96231894178506,99.8048780487805,19609,4,52019800,2046,31,03,1,2023,2023-03-31,2,2023,52039409,2050
Agency,Department of the Treasury,null,CFO,99.28694055918545,99.7228144989339,390438,13,54364885,4677,31,03,1,2023,2023-03-31,2,2023,54755323,4690
Agency,Department of Commerce,null,CFO,100.0,100.0,0,0,59687094,18288,31,03,1,2023,2023-03-31,2,2023,59687094,18288
Agency,Department of the Interior,null,CFO,99.99253897808111,99.796289331829,5539,65,74233621,31843,31,03,1,2023,2023-03-31,2,2023,74239160,31908
Agency,Department of Transportation,null,CFO,99.99873684297371,99.97652582159624,986,2,78057401,8518,31,03,1,2023,2023-03-31,2,2023,78058387,8520
Agency,Department of Justice,null,CFO,97.25885951184085,98.80621381016759,2465883,468,87492403,38735,31,03,1,2023,2023-03-31,2,2023,89958286,39203
Agency,Department of Labor,null,CFO,90.34137426904638,78.38654680719156,15677813,2789,146641480,10115,31,03,1,2023,2023-03-31,2,2023,162319293,12904
Agency,Department of Veterans Affairs,null,CFO,98.68560438131196,99.84488498244836,2591680,4311,194584875,2774917,31,03,1,2023,2023-03-31,2,2023,197176555,2779228
Agency,Department of Homeland Security,null,CFO,94.85670253714314,82.17864559378964,14988491,12787,276429439,58964,31,03,1,2023,2023-03-31,2,2023,291417930,71751
Agency,Department of Agriculture,null,CFO,98.75460606106076,91.34183289615487,18294587,4258,1450685342,44921,31,03,1,2023,2023-03-31,2,2023,1468979929,49179
Agency,Department of Defense,null,CFO,33.81031330342711,17.481318128439117,2120947606,1403958,1083399947,297424,31,03,1,2023,2023-03-31,2,2023,3204347553,1701382
Agency,Social Security Administration,null,CFO,58.09810200121109,32.15149324236063,1788350680,893383,2479596037,423349,31,03,1,2023,2023-03-31,2,2023,4267946717,1316732
Bureau,Department of Commerce,International Trade Administration,null,0.0,0.0,0,0,0,0,31,03,1,2023,2023-03-31,2,2023,0,0
Bureau,Other Agencies/Boards/Commissions,Medicare Payment Advisory Commission,null,0.0,0.0,0,0,0,0,31,03,1,2023,2023-03-31,2,2023,0,0
Bureau,Other Agencies,Comm. for Purchase from Blind/Handic.,null,0.0,0.0,0,0,0,0,31,03,1,2023,2023-03-31,2,2023,0,0
Bureau,Other Agencies/Boards/Commissions,U.S.-China Security Review Commission,null,0.0,0.0,0,0,0,0,31,03,1,2023,2023-03-31,2,2023,0,0
Bureau,Department of Health & Human Services,Administration for Community Living,null,0.0,0.0,0,0,0,0,31,03,1,2023,2023-03-31,2,2023,0,0
Bureau,National Foundation  Arts & Humanities,National Endowment for the Humanities,null,0.0,0.0,0,0,0,0,31,03,1,2023,2023-03-31,2,2023,0,0
Bureau,Department of the Treasury,Spec Insp Gen-Troubled Asset Rel Prog,null,100.0,100.0,0,0,3916,1,31,03,1,2023,2023-03-31,2,2023,3916,1
Bureau,Department of Commerce,General Administration,null,100.0,100.0,0,0,4660,1,31,03,1,2023,2023-03-31,2,2023,4660,1
Agency,Department of Health & Human Services,null,CFO,97.72781343585758,97.10935801032883,240286781,32699,10334847532,1098503,31,03,1,2023,2023-03-31,2,2023,10575134313,1131202
Agency,National Credit Union Administration,null,Non-CFO,100.0,100.0,0,0,2059,3,31,03,1,2023,2023-03-31,2,2023,2059,3
Agency,Equal Employment Opportunity Commission,null,Non-CFO,100.0,100.0,0,0,22760,19,31,03,1,2023,2023-03-31,2,2023,22760,19
Agency,Armed Forces Retirement Home,null,Non-CFO,100.0,100.0,0,0,77021,102,31,03,1,2023,2023-03-31,2,2023,77021,102
Agency,National Archives & Records Admin,null,Non-CFO,100.0,100.0,0,0,136398,135,31,03,1,2023,2023-03-31,2,2023,136398,135
Agency,Legislative Branch - U.S. House/Senate,null,Non-CFO,0.0,0.0,337584,203,0,0,31,03,1,2023,2023-03-31,2,2023,337584,203
Agency,Federal Maritime Commission,null,Non-CFO,100.0,100.0,0,0,397687,6,31,03,1,2023,2023-03-31,2,2023,397687,6
Agency,The Judiciary,null,Non-CFO,97.87120327269749,55.73770491803279,22345,135,1027309,170,31,03,1,2023,2023-03-31,2,2023,1049654,305
Agency,Presidio Trust Corporation,null,Non-CFO,100.0,100.0,0,0,1536491,62,31,03,1,2023,2023-03-31,2,2023,1536491,62
Agency,Federal Election Commission,null,Non-CFO,100.0,100.0,0,0,2191216,302,31,03,1,2023,2023-03-31,2,2023,2191216,302
Agency,Other Agencies,null,Non-CFO,15.767244759332215,15.686274509803921,2911004,43,544901,8,31,03,1,2023,2023-03-31,2,2023,3455905,51
Agency,Corp. for National and Community Service,null,Non-CFO,94.39136158196526,43.50282485875706,214310,200,3606760,154,31,03,1,2023,2023-03-31,2,2023,3821070,354
Agency,Pension Benefit Guaranty Corp,null,Non-CFO,100.0,100.0,0,0,4393578,1832,31,03,1,2023,2023-03-31,2,2023,4393578,1832
Agency,Railroad Retirement Board,null,Non-CFO,100.0,100.0,0,0,21469634,4059,31,03,1,2023,2023-03-31,2,2023,21469634,4059
Agency,Federal Communications Commission,null,Non-CFO,100.0,100.0,0,0,234290204,13639,31,03,1,2023,2023-03-31,2,2023,234290204,13639
Agency,Federal Trade Commission,null,Non-CFO,100.0,100.0,0,0,481038032,62,31,03,1,2023,2023-03-31,2,2023,481038032,62
Agency,Commodity Futures Trading Commission,null,Non-CFO,100.0,100.0,0,0,624898894,360,31,03,1,2023,2023-03-31,2,2023,624898894,360
Agency,Securities & Exchange Commission,null,Non-CFO,100.0,100.0,0,0,2503848184,1310,31,03,1,2023,2023-03-31,2,2023,2503848184,1310
Bureau,Office of Compliance,Office of Compliance,null,0.0,0.0,0,0,0,0,31,03,1,2023,2023-03-31,2,2023,0,0
Bureau,Funds Appropriated to the President,Peace Corps,null,0.0,0.0,0,0,0,0,31,03,1,2023,2023-03-31,2,2023,0,0
Bureau,Department of Homeland Security,U.S. Secret Service,null,0.0,0.0,0,0,0,0,31,03,1,2023,2023-03-31,2,2023,0,0
Bureau,Department of the Treasury,U.S. Treasury IG Office,null,0.0,0.0,0,0,0,0,31,03,1,2023,2023-03-31,2,2023,0,0
Bureau,Department of Homeland Security,Office of the Inspector General DHS,null,100.0,100.0,0,0,100,1,31,03,1,2023,2023-03-31,2,2023,100,1
Agency,Department of Education,null,CFO,99.92947697837603,99.86787840248145,86261422,27438,122230423277,20739795,31,03,1,2023,2023-03-31,2,2023,122316684699,20767233
Agency,National Labor Relations Board,null,Non-CFO,0.0,0.0,0,0,0,0,31,03,1,2023,2023-03-31,2,2023,0,0
Agency,Neighborhood Reinvestment Corporation,null,Non-CFO,0.0,0.0,0,0,0,0,31,03,1,2023,2023-03-31,2,2023,0,0
Agency,Legis Branch-Library of Congress,null,Non-CFO,0.0,0.0,0,0,0,0,31,03,1,2023,2023-03-31,2,2023,0,0
Agency,Merit Systems Protection Board,null,Non-CFO,100.0,100.0,0,0,144,1,31,03,1,2023,2023-03-31,2,2023,144,1
Agency,Consumer Product Safety Commission,null,Non-CFO,100.0,100.0,0,0,523,3,31,03,1,2023,2023-03-31,2,2023,523,3
Agency,Other Agencies/Boards/Commissions,null,Non-CFO,0.0,0.0,1024,1,0,0,31,03,1,2023,2023-03-31,2,2023,1024,1
Agency,Smithsonian Institution,null,Non-CFO,0.0,0.0,1072,2,0,0,31,03,1,2023,2023-03-31,2,2023,1072,2
Agency,Selective Service System,null,Non-CFO,0.0,0.0,1746,10,0,0,31,03,1,2023,2023-03-31,2,2023,1746,10
Agency,Funds Appropriated to the President,null,Non-CFO,0.19112955386147104,50.0,1236060,7,2367,7,31,03,1,2023,2023-03-31,2,2023,1238427,14
Agency,U.S. Postal Service,null,Non-CFO,86.34047582150242,84.27627678495807,10235235,11139,64695889,59703,31,03,1,2023,2023-03-31,2,2023,74931124,70842
Bureau,Legis Branch-Library of Congress,Library of Congress,null,0.0,0.0,0,0,0,0,31,03,1,2023,2023-03-31,2,2023,0,0
Bureau,Legislative Branch-Office of Tech.,Medicaid & CHIP Payment & Access Comm.,null,0.0,0.0,0,0,0,0,31,03,1,2023,2023-03-31,2,2023,0,0
Bureau,Other Agencies,U.S.  Agency of Global Media,null,0.0,0.0,0,0,0,0,31,03,1,2023,2023-03-31,2,2023,0,0
Bureau,Other Agencies,Archit.&Trans. Barriers Compliance Bd,null,0.0,0.0,0,0,0,0,31,03,1,2023,2023-03-31,2,2023,0,0
Bureau,Other Agencies,District of Columbia Government,null,0.0,0.0,0,0,0,0,31,03,1,2023,2023-03-31,2,2023,0,0
Bureau,Other Agencies,Morris K. Udall Scholarship,null,0.0,0.0,0,0,0,0,31,03,1,2023,2023-03-31,2,2023,0,0
Bureau,Occupational Safety & Health Rev Comm,Occupational Safety & Health Rev Comm,null,0.0,0.0,0,0,0,0,31,03,1,2023,2023-03-31,2,2023,0,0
Bureau,Federal Deposit Insurance Corporation,Federal Deposit Insurance Corporation,null,0.0,0.0,0,0,0,0,31,03,1,2023,2023-03-31,2,2023,0,0
Bureau,National Credit Union Administration,National Credit Union Administration,null,100.0,100.0,0,0,2059,3,31,03,1,2023,2023-03-31,2,2023,2059,3
Bureau,Funds Appropriated to the President,African Development Foundation,null,100.0,100.0,0,0,2367,7,31,03,1,2023,2023-03-31,2,2023,2367,7
Bureau,Other Agencies,Council of Insps. Gen. of Intg. & Effy.,null,0.0,0.0,2569,6,0,0,31,03,1,2023,2023-03-31,2,2023,2569,6
Bureau,Department of the Treasury,U.S. Mint,null,87.98876319186091,90.47619047619048,3164,2,23178,19,31,03,1,2023,2023-03-31,2,2023,26342,21
Bureau,Legislative Branch-GPO,Government Publishing Office,null,0.0,0.0,0,0,0,0,31,03,1,2023,2023-03-31,2,2023,0,0
Bureau,Legislative Branch-CBO,Congressional Budget Office,null,0.0,0.0,0,0,0,0,31,03,1,2023,2023-03-31,2,2023,0,0
Bureau,Funds Appropriated to the President,Defense Security Assistance Agency,null,0.0,0.0,0,0,0,0,31,03,1,2023,2023-03-31,2,2023,0,0
Bureau,Other Agencies,Delta Regional Authority,null,0.0,0.0,0,0,0,0,31,03,1,2023,2023-03-31,2,2023,0,0
Bureau,Department of Homeland Security,Office of Biometric Identity Management,null,0.0,0.0,0,0,0,0,31,03,1,2023,2023-03-31,2,2023,0,0
Bureau,Other Agencies,National Mediation Board,null,0.0,0.0,0,0,0,0,31,03,1,2023,2023-03-31,2,2023,0,0
Bureau,Other Agencies,Millennium Challenge Corporation,null,0.0,0.0,0,0,0,0,31,03,1,2023,2023-03-31,2,2023,0,0
Bureau,Other Agencies,National Council on Disability,null,0.0,0.0,0,0,0,0,31,03,1,2023,2023-03-31,2,2023,0,0
Bureau,Other Agencies,Advisory Council on Hist. Preservation,null,0.0,0.0,0,0,0,0,31,03,1,2023,2023-03-31,2,2023,0,0
Bureau,Department of Education,Office of Postsecondary Education,null,0.0,0.0,0,0,0,0,31,03,1,2023,2023-03-31,2,2023,0,0
Bureau,Department of Housing and Urban Development,Public and Indian Housing Programs,null,0.0,0.0,0,0,0,0,31,03,1,2023,2023-03-31,2,2023,0,0
Bureau,Smithsonian Institution,JFK Center for the Performing Arts,null,0.0,0.0,0,0,0,0,31,03,1,2023,2023-03-31,2,2023,0,0
Bureau,American Battle Monuments Commission,American Battle Monuments Commission,null,0.0,0.0,0,0,0,0,31,03,1,2023,2023-03-31,2,2023,0,0
Bureau,Department of the Treasury,Treasury Forfeiture Fund,null,0.0,0.0,0,0,0,0,31,03,1,2023,2023-03-31,2,2023,0,0
Bureau,Other Agencies,John C. Stennis,null,0.0,0.0,2934,2,0,0,31,03,1,2023,2023-03-31,2,2023,2934,2
Bureau,Department of Housing and Urban Development,Management and Administration,null,100.0,100.0,0,0,4706,2,31,03,1,2023,2023-03-31,2,2023,4706,2
Bureau,Department of Labor,Bureau of Labor Statistics,null,100.0,100.0,0,0,5128,1,31,03,1,2023,2023-03-31,2,2023,5128,1
Bureau,Department of Justice,Bureau of ATF and Explosives,null,100.0,100.0,0,0,19881,1,31,03,1,2023,2023-03-31,2,2023,19881,1
Bureau,Department of Transportation,Research Innovative Technology Admin,null,100.0,100.0,0,0,21089,5,31,03,1,2023,2023-03-31,2,2023,21089,5
Bureau,Department of Homeland Security,Domestic Nuclear Detection Office,null,0.0,0.0,30970,26,0,0,31,03,1,2023,2023-03-31,2,2023,30970,26
Bureau,Other Agencies,Chemical Safety Board,null,100.0,100.0,0,0,33438,2,31,03,1,2023,2023-03-31,2,2023,33438,2
Bureau,Department of Health & Human Services,Office of the Inspector General,null,100.0,100.0,0,0,33600,1,31,03,1,2023,2023-03-31,2,2023,33600,1
Bureau,Legislative Branch-GAO,Government Accountability Office,null,0.0,0.0,0,0,0,0,31,03,1,2023,2023-03-31,2,2023,0,0
Bureau,Funds Appropriated to the President,Executive Branch,null,0.0,0.0,0,0,0,0,31,03,1,2023,2023-03-31,2,2023,0,0
Bureau,Other Agencies,Surface Transportation Board,null,0.0,0.0,0,0,0,0,31,03,1,2023,2023-03-31,2,2023,0,0
Bureau,Other Agencies,Gulf Coast Ecosystem Restoration Council,null,0.0,0.0,0,0,0,0,31,03,1,2023,2023-03-31,2,2023,0,0
Bureau,Smithsonian Institution,Administrative Conference of the US,null,0.0,0.0,0,0,0,0,31,03,1,2023,2023-03-31,2,2023,0,0
Bureau,Other Agencies,National Capital Planning Commission,null,0.0,0.0,0,0,0,0,31,03,1,2023,2023-03-31,2,2023,0,0
Bureau,Other Agencies,National Transportation Safety Board,null,0.0,0.0,0,0,0,0,31,03,1,2023,2023-03-31,2,2023,0,0
Bureau,Other Agencies,U.S. Holocaust Memorial Council,null,0.0,0.0,0,0,0,0,31,03,1,2023,2023-03-31,2,2023,0,0
Bureau,Other Agencies,Architect of the Capitol,null,0.0,0.0,0,0,0,0,31,03,1,2023,2023-03-31,2,2023,0,0
Bureau,Federal Mediation/Conciliation Service,Federal Mediation/Conciliation Service,null,0.0,0.0,0,0,0,0,31,03,1,2023,2023-03-31,2,2023,0,0
Bureau,Department of Housing and Urban Development,"Policy, Development and Research",null,0.0,0.0,0,0,0,0,31,03,1,2023,2023-03-31,2,2023,0,0
Bureau,Department of Housing and Urban Development,Government National Mortgage Association,null,0.0,0.0,0,0,0,0,31,03,1,2023,2023-03-31,2,2023,0,0
Bureau,Department of Labor,Departmental Management,null,0.0,0.0,0,0,0,0,31,03,1,2023,2023-03-31,2,2023,0,0
Bureau,Export - Import  Bank,Export-Import Bank,null,0.0,0.0,0,0,0,0,31,03,1,2023,2023-03-31,2,2023,0,0
Bureau,Neighborhood Reinvestment Corporation,Neighborhood Reinvestment Corporation,null,0.0,0.0,0,0,0,0,31,03,1,2023,2023-03-31,2,2023,0,0
Bureau,Smithsonian Institution,National Gallery of Art,null,0.0,0.0,0,0,0,0,31,03,1,2023,2023-03-31,2,2023,0,0
Bureau,Other Agencies/Boards/Commissions,Nuclear Waste Technical Review Board,null,0.0,0.0,0,0,0,0,31,03,1,2023,2023-03-31,2,2023,0,0
Bureau,Department of Homeland Security,Management Headquarters,null,0.0,0.0,0,0,0,0,31,03,1,2023,2023-03-31,2,2023,0,0
Bureau,Tennessee Valley Authority,Tennessee Valley Authority,null,0.0,0.0,0,0,0,0,31,03,1,2023,2023-03-31,2,2023,0,0
Bureau,National Foundation  Arts & Humanities,National Endowment for the Arts,null,0.0,0.0,0,0,0,0,31,03,1,2023,2023-03-31,2,2023,0,0
Bureau,Equal Employment Opportunity Commission,Equal Employment Opportunity Commission,null,100.0,100.0,0,0,22760,19,31,03,1,2023,2023-03-31,2,2023,22760,19
Bureau,Department of Transportation,National Highway Traffic Safety Admin.,null,100.0,100.0,0,0,36529,6,31,03,1,2023,2023-03-31,2,2023,36529,6
Agency,Federal Mediation/Conciliation Service,null,Non-CFO,0.0,0.0,0,0,0,0,31,03,1,2023,2023-03-31,2,2023,0,0
Agency,American Battle Monuments Commission,null,Non-CFO,0.0,0.0,0,0,0,0,31,03,1,2023,2023-03-31,2,2023,0,0
Agency,Export - Import  Bank,null,Non-CFO,0.0,0.0,0,0,0,0,31,03,1,2023,2023-03-31,2,2023,0,0
Agency,Federal Deposit Insurance Corporation,null,Non-CFO,0.0,0.0,0,0,0,0,31,03,1,2023,2023-03-31,2,2023,0,0
Agency,Office of Special Counsel,null,Non-CFO,0.0,0.0,0,0,0,0,31,03,1,2023,2023-03-31,2,2023,0,0
Agency,Legislative Branch-GPO,null,Non-CFO,0.0,0.0,0,0,0,0,31,03,1,2023,2023-03-31,2,2023,0,0
Agency,Occupational Safety & Health Rev Comm,null,Non-CFO,0.0,0.0,0,0,0,0,31,03,1,2023,2023-03-31,2,2023,0,0
Agency,Office of Compliance,null,Non-CFO,0.0,0.0,0,0,0,0,31,03,1,2023,2023-03-31,2,2023,0,0
Agency,Legislative Branch-GAO,null,Non-CFO,0.0,0.0,0,0,0,0,31,03,1,2023,2023-03-31,2,2023,0,0
Agency,U.S. Court of Appeals / Veterans Claims,null,Non-CFO,0.0,0.0,0,0,0,0,31,03,1,2023,2023-03-31,2,2023,0,0
Agency,US International Development Fin. Corp.,null,Non-CFO,0.0,0.0,0,0,0,0,31,03,1,2023,2023-03-31,2,2023,0,0
Agency,U.S. Tax Court,null,Non-CFO,0.0,0.0,0,0,0,0,31,03,1,2023,2023-03-31,2,2023,0,0
Agency,National Foundation  Arts & Humanities,null,Non-CFO,0.0,0.0,0,0,0,0,31,03,1,2023,2023-03-31,2,2023,0,0
Agency,Farm Credit Administration,null,Non-CFO,100.0,100.0,0,0,630,1,31,03,1,2023,2023-03-31,2,2023,630,1
Bureau,US International Development Fin. Corp.,US International Development Fin. Corp.,null,0.0,0.0,0,0,0,0,31,03,1,2023,2023-03-31,2,2023,0,0
Bureau,U.S. Court of Appeals / Veterans Claims,U.S. Court of Appeals / Veterans Claims,null,0.0,0.0,0,0,0,0,31,03,1,2023,2023-03-31,2,2023,0,0
Bureau,Department of Commerce,National Technical Information Service,null,0.0,0.0,0,0,0,0,31,03,1,2023,2023-03-31,2,2023,0,0
Bureau,Department of State,International Commissions,null,0.0,0.0,0,0,0,0,31,03,1,2023,2023-03-31,2,2023,0,0
Bureau,Department of the Interior,Office of the Secretary,null,100.0,100.0,0,0,26134,20,31,03,1,2023,2023-03-31,2,2023,26134,20
Bureau,Department of Agriculture,U.S. Department of Agriculture,null,84.92928387339917,54.7022303977926,3090348,1970,17415300,2379,31,03,1,2023,2023-03-31,2,2023,20505648,4349
Agency,Department of State,null,CFO,98.93492922944955,99.59850477640869,241971,87,22476801,21582,31,03,1,2023,2023-03-31,2,2023,22718772,21669
Agency,Small Business Administration,null,CFO,100.0,100.0,0,0,17077256847,145761,31,03,1,2023,2023-03-31,2,2023,17077256847,145761
Agency,Tennessee Valley Authority,null,Non-CFO,0.0,0.0,0,0,0,0,31,03,1,2023,2023-03-31,2,2023,0,0
Bureau,Funds Appropriated to the President,Inter-American Foundation,null,0.0,0.0,0,0,0,0,31,03,1,2023,2023-03-31,2,2023,0,0
Bureau,Department of Commerce,Office of the Inspector General,null,0.0,0.0,0,0,0,0,31,03,1,2023,2023-03-31,2,2023,0,0
Bureau,U.S. Tax Court,U.S. Tax Court,null,0.0,0.0,0,0,0,0,31,03,1,2023,2023-03-31,2,2023,0,0
Bureau,Office of Government Ethics,Office of Government Ethics,null,0.0,0.0,0,0,0,0,31,03,1,2023,2023-03-31,2,2023,0,0
Bureau,Other Agencies,Denali Commission,null,0.0,0.0,0,0,0,0,31,03,1,2023,2023-03-31,2,2023,0,0
Bureau,Other Agencies,Commission On Fine Arts,null,0.0,0.0,0,0,0,0,31,03,1,2023,2023-03-31,2,2023,0,0
Bureau,Department of Justice,Federal Prison System,null,0.0,0.0,0,0,0,0,31,03,1,2023,2023-03-31,2,2023,0,0
Bureau,Farm Credit Administration,Farm Credit System Insurance Corporation,null,0.0,0.0,0,0,0,0,31,03,1,2023,2023-03-31,2,2023,0,0
Bureau,Department of Homeland Security,Science and Technology,null,0.0,0.0,0,0,0,0,31,03,1,2023,2023-03-31,2,2023,0,0
Bureau,Merit Systems Protection Board,Merit Systems Protection Board,null,100.0,100.0,0,0,144,1,31,03,1,2023,2023-03-31,2,2023,144,1
Bureau,Department of the Treasury,Treasury IG for Tax Admin,null,100.0,100.0,0,0,195,1,31,03,1,2023,2023-03-31,2,2023,195,1
Bureau,Department of the Treasury,Office of Financial Research,null,100.0,100.0,0,0,268,1,31,03,1,2023,2023-03-31,2,2023,268,1
Bureau,Consumer Product Safety Commission,Consumer Product Safety Commission,null,100.0,100.0,0,0,523,3,31,03,1,2023,2023-03-31,2,2023,523,3
Bureau,Farm Credit Administration,Farm Credit Administration,null,100.0,100.0,0,0,630,1,31,03,1,2023,2023-03-31,2,2023,630,1
Bureau,Department of Transportation,Office of the Inspector General,null,100.0,100.0,0,0,845,1,31,03,1,2023,2023-03-31,2,2023,845,1
Bureau,Department of the Treasury,Tobacco Tax and Trade,null,100.0,100.0,0,0,1000,1,31,03,1,2023,2023-03-31,2,2023,1000,1
Bureau,Other Agencies/Boards/Commissions,U.S. Comm. on Int. Religious Freedom,null,0.0,0.0,1024,1,0,0,31,03,1,2023,2023-03-31,2,2023,1024,1
Bureau,Smithsonian Institution,Smithsonian Institution,null,0.0,0.0,1072,2,0,0,31,03,1,2023,2023-03-31,2,2023,1072,2
Bureau,Department of the Interior,"Bureau of Ocean Energy Mgmt., Reg & Enf",null,100.0,100.0,0,0,1333,1,31,03,1,2023,2023-03-31,2,2023,1333,1
Bureau,Other Agencies,Election Assistance Commission,null,0.0,0.0,5576,1,0,0,31,03,1,2023,2023-03-31,2,2023,5576,1
Bureau,Department of Justice,General Administration,null,0.0,0.0,0,0,0,0,31,03,1,2023,2023-03-31,2,2023,0,0
Bureau,Selective Service System,Selective Service System,null,0.0,0.0,1746,10,0,0,31,03,1,2023,2023-03-31,2,2023,1746,10
Bureau,Department of Agriculture,Federal Crop Insurance Corporation,null,100.0,100.0,0,0,7298,383,31,03,1,2023,2023-03-31,2,2023,7298,383
Bureau,Department of Transportation,St. Lawrence Seaway Development Corp.,null,100.0,100.0,0,0,7728,2,31,03,1,2023,2023-03-31,2,2023,7728,2
Bureau,Department of Health & Human Services,Office of the Secretary,null,100.0,100.0,0,0,8273,7,31,03,1,2023,2023-03-31,2,2023,8273,7
Bureau,Other Agencies,U.S. Inst. for Env. Conflict Resolution,null,0.0,0.0,8859,2,0,0,31,03,1,2023,2023-03-31,2,2023,8859,2
Bureau,Department of Transportation,Federal Highway Administration,null,100.0,100.0,0,0,13157,10,31,03,1,2023,2023-03-31,2,2023,13157,10
Bureau,Department of the Interior,Bureau of Safety and Environmental Enf.,null,100.0,100.0,0,0,14790,3,31,03,1,2023,2023-03-31,2,2023,14790,3
Bureau,Department of the Treasury,Bureau of Engraving and Printing,null,100.0,100.0,0,0,38345,2,31,03,1,2023,2023-03-31,2,2023,38345,2
Bureau,Department of the Treasury,Internal Revenue Service,null,100.0,100.0,0,0,43721,41,31,03,1,2023,2023-03-31,2,2023,43721,41
Bureau,Department of Transportation,Maritime Administration,null,100.0,100.0,0,0,65458,14,31,03,1,2023,2023-03-31,2,2023,65458,14
Bureau,Armed Forces Retirement Home,Armed Forces Retirement Home,null,100.0,100.0,0,0,77021,102,31,03,1,2023,2023-03-31,2,2023,77021,102
Bureau,Department of Energy,Bonneville Power Administration,null,99.99811184665174,96.55172413793103,20,1,1059216,28,31,03,1,2023,2023-03-31,2,2023,1059236,29
Bureau,Department of Health & Human Services,Substance Abuse & Mental Health Admin.,null,100.0,100.0,0,0,1077870,12,31,03,1,2023,2023-03-31,2,2023,1077870,12
Bureau,Department of Homeland Security,Citizenship and Immigration Services,null,100.0,100.0,0,0,1112983,1308,31,03,1,2023,2023-03-31,2,2023,1112983,1308
Bureau,Department of Veterans Affairs,Life Insurance,null,100.0,100.0,0,0,1220876,254,31,03,1,2023,2023-03-31,2,2023,1220876,254
Bureau,Department of Veterans Affairs,Veterans Benefits,null,0.0,0.0,1227580,1627,0,0,31,03,1,2023,2023-03-31,2,2023,1227580,1627
Bureau,Funds Appropriated to the President,Trade and Development Agency,null,0.0,0.0,1236060,7,0,0,31,03,1,2023,2023-03-31,2,2023,1236060,7
Bureau,Department of Transportation,Pipeline Hazardous Material Safety Admin,null,100.0,100.0,0,0,1259292,98,31,03,1,2023,2023-03-31,2,2023,1259292,98
Bureau,Department of Agriculture,Agricultural Marketing Service,null,62.84976685263889,47.58723088344469,2432838,1412,4115810,1282,31,03,1,2023,2023-03-31,2,2023,6548648,2694
Bureau,Department of Health & Human Services,Centers for Disease Control,null,2.3477304785842183,16.3265306122449,7565301,82,181883,16,31,03,1,2023,2023-03-31,2,2023,7747184,98
Bureau,Department of Justice,Federal Prison Industries,null,0.0,0.0,87994,50,0,0,31,03,1,2023,2023-03-31,2,2023,87994,50
Bureau,National Archives & Records Admin,Nat'l Archives & Records Administration,null,100.0,100.0,0,0,136398,135,31,03,1,2023,2023-03-31,2,2023,136398,135
Bureau,Other Agencies,James Madison Memorial Fellowship,null,0.0,0.0,201880,24,0,0,31,03,1,2023,2023-03-31,2,2023,201880,24
Bureau,Department of Justice,Drug Enforcement Administration,null,100.0,100.0,0,0,280860,13,31,03,1,2023,2023-03-31,2,2023,280860,13
Bureau,Department of the Treasury,Pandemic Receivables,null,7.770990785795631,25.0,267252,3,22518,1,31,03,1,2023,2023-03-31,2,2023,289770,4
Bureau,Department of Commerce,Nat'l Telecomm & Information Admin.,null,100.0,100.0,0,0,296093,1,31,03,1,2023,2023-03-31,2,2023,296093,1
Bureau,Legislative Branch - U.S. House/Senate,U.S. House of Representatives,null,0.0,0.0,337584,203,0,0,31,03,1,2023,2023-03-31,2,2023,337584,203
Bureau,Department of Veterans Affairs,Housing Credit Assistance,null,0.0,0.0,374072,19,0,0,31,03,1,2023,2023-03-31,2,2023,374072,19
Bureau,Federal Maritime Commission,Salaries and Expenses,null,100.0,100.0,0,0,397687,6,31,03,1,2023,2023-03-31,2,2023,397687,6
Bureau,Department of the Treasury,D.C. Pension Program,null,100.0,100.0,0,0,428403,18,31,03,1,2023,2023-03-31,2,2023,428403,18
Bureau,Department of Justice,Federal Bureau of Investigation,null,100.0,100.0,0,0,479823,111,31,03,1,2023,2023-03-31,2,2023,479823,111
Bureau,Department of Commerce,Patent and Trademark Office,null,100.0,100.0,0,0,505919,669,31,03,1,2023,2023-03-31,2,2023,505919,669
Bureau,Department of Commerce,Nat'l Institute of Standards& Technology,null,100.0,100.0,0,0,667997,3,31,03,1,2023,2023-03-31,2,2023,667997,3
Bureau,National Science Foundation,National Science Foundation,null,100.0,100.0,0,0,723090,36,31,03,1,2023,2023-03-31,2,2023,723090,36
Bureau,Department of Transportation,Federal Transit Administration,null,100.0,100.0,0,0,783405,1,31,03,1,2023,2023-03-31,2,2023,783405,1
Bureau,Department of the Interior,Fish and Wildlife Service,null,100.0,100.0,0,0,797471,114,31,03,1,2023,2023-03-31,2,2023,797471,114
Bureau,The Judiciary,Administrative Office of the U.S. Courts,null,97.87120327269749,55.73770491803279,22345,135,1027309,170,31,03,1,2023,2023-03-31,2,2023,1049654,305
Bureau,Department of Labor,Employment and Training Administration,null,100.0,100.0,0,0,1257939,11,31,03,1,2023,2023-03-31,2,2023,1257939,11
Bureau,Department of Agriculture,Commodity Credit Corporation,null,100.0,100.0,0,0,135232596,9684,31,03,1,2023,2023-03-31,2,2023,135232596,9684
Bureau,Securities & Exchange Commission,Securities and Exchange Commission,null,100.0,100.0,0,0,271820,47,31,03,1,2023,2023-03-31,2,2023,271820,47
Bureau,Department of Transportation,Office of the Secretary,null,100.0,100.0,0,0,1120697,16,31,03,1,2023,2023-03-31,2,2023,1120697,16
Bureau,Department of Agriculture,Food Safety and Inspection Service,null,96.50773047596421,95.32908704883228,42187,44,1165824,898,31,03,1,2023,2023-03-31,2,2023,1208011,942
Bureau,Department of Justice,Office of Justice Assistance Programs,null,100.0,100.0,0,0,1399982,6,31,03,1,2023,2023-03-31,2,2023,1399982,6
Bureau,Department of the Treasury,Comptroller of the Currency,null,99.45900492105774,84.0,7746,4,1424060,21,31,03,1,2023,2023-03-31,2,2023,1431806,25
Bureau,National Aeronautics and Space Administration,National Aeronautics and Space Admin,null,100.0,100.0,0,0,1518126,127,31,03,1,2023,2023-03-31,2,2023,1518126,127
Bureau,Presidio Trust Corporation,Presidio Trust Corporation,null,100.0,100.0,0,0,1536491,62,31,03,1,2023,2023-03-31,2,2023,1536491,62
Bureau,Department of the Treasury,Financial Crimes Enforcement Network,null,100.0,100.0,0,0,1544945,3,31,03,1,2023,2023-03-31,2,2023,1544945,3
Bureau,Department of State,Passport NSF,null,100.0,100.0,0,0,1843246,11893,31,03,1,2023,2023-03-31,2,2023,1843246,11893
Bureau,Department of Transportation,Federal Aviation Administration,null,100.0,100.0,0,0,2177443,274,31,03,1,2023,2023-03-31,2,2023,2177443,274
Bureau,Federal Election Commission,Federal Election Commission,null,100.0,100.0,0,0,2191216,302,31,03,1,2023,2023-03-31,2,2023,2191216,302
Bureau,Department of Labor,Mine Safety and Health Administration,null,80.19358364827238,87.77751811170835,2483828,523,10056694,3756,31,03,1,2023,2023-03-31,2,2023,12540522,4279
Bureau,General Services Administration,General Services Administration,null,83.41704679193136,92.73153575615474,2139623,124,10762922,1582,31,03,1,2023,2023-03-31,2,2023,12902545,1706
Bureau,Department of Commerce,NOAA,null,100.0,100.0,0,0,12991845,987,31,03,1,2023,2023-03-31,2,2023,12991845,987
Bureau,Department of Energy,Energy Consolidated Reports,null,100.0,100.0,0,0,13304512,75,31,03,1,2023,2023-03-31,2,2023,13304512,75
Bureau,Department of the Treasury,Bureau of the Fiscal Service,null,100.0,100.0,0,0,13433476,3240,31,03,1,2023,2023-03-31,2,2023,13433476,3240
Bureau,Department of Homeland Security,Immigration and Customs Enforcement,null,100.0,100.0,0,0,16200820,632,31,03,1,2023,2023-03-31,2,2023,16200820,632
Bureau,Department of Homeland Security,U.S. Coast Guard,null,7.769778645313065,9.899032690814092,14957521,12761,1260071,1402,31,03,1,2023,2023-03-31,2,2023,16217592,14163
Bureau,Department of the Interior,Bureau of Indian Affairs,null,99.97066799860113,99.7617302052786,5539,65,18878273,27215,31,03,1,2023,2023-03-31,2,2023,18883812,27280
Bureau,Office of Personnel Management,Office of Personnel Management,null,100.0,100.0,0,0,20818481,1142,31,03,1,2023,2023-03-31,2,2023,20818481,1142
Bureau,Department of the Interior,Office of Natural Resources Revenue,null,100.0,100.0,0,0,21283380,584,31,03,1,2023,2023-03-31,2,2023,21283380,584
Bureau,Department of Commerce,Bureau of the Census,null,100.0,100.0,0,0,2537828,16587,31,03,1,2023,2023-03-31,2,2023,2537828,16587
Bureau,Other Agencies,Consumer Financial Protection Bureau,null,15.979977810750258,42.857142857142854,2689186,8,511463,6,31,03,1,2023,2023-03-31,2,2023,3200649,14
Bureau,Department of Agriculture,Food and Nutrition Service,null,1.8353392766708982,51.282051282051285,3301039,19,61718,20,31,03,1,2023,2023-03-31,2,2023,3362757,39
Bureau,Nuclear Regulatory Commission,Nuclear Regulatory Commission,null,100.0,100.0,0,0,3403607,400,31,03,1,2023,2023-03-31,2,2023,3403607,400
Bureau,Department of the Treasury,Community Dev Financial Inst Fund,null,100.0,100.0,0,0,3642572,8,31,03,1,2023,2023-03-31,2,2023,3642572,8
Bureau,Corp. for National and Community Service,Corp. for National and Community Service,null,94.39136158196526,43.50282485875706,214310,200,3606760,154,31,03,1,2023,2023-03-31,2,2023,3821070,354
Bureau,Department of Veterans Affairs,Administration and Cemeteries,null,91.67674033791018,46.13466334164588,318102,432,3503742,370,31,03,1,2023,2023-03-31,2,2023,3821844,802
Bureau,Pension Benefit Guaranty Corp,Pension Benefit Guaranty Corporation,null,100.0,100.0,0,0,4393578,1832,31,03,1,2023,2023-03-31,2,2023,4393578,1832
Bureau,Department of Commerce,Economic Development Administration,null,100.0,100.0,0,0,5137182,12,31,03,1,2023,2023-03-31,2,2023,5137182,12
Bureau,Department of Health & Human Services,Program Support Center,null,100.0,100.0,0,0,5975888,189,31,03,1,2023,2023-03-31,2,2023,5975888,189
Bureau,Department of the Interior,Bureau of Reclamation,null,100.0,100.0,0,0,7398393,69,31,03,1,2023,2023-03-31,2,2023,7398393,69
Bureau,Department of the Interior,Office of Surface Mining,null,100.0,100.0,0,0,7871953,355,31,03,1,2023,2023-03-31,2,2023,7871953,355
Bureau,Department of State,Department of State,null,98.84088669190899,99.11006546644845,241971,87,20633555,9689,31,03,1,2023,2023-03-31,2,2023,20875526,9776
Bureau,Railroad Retirement Board,Railroad Retirement Board,null,100.0,100.0,0,0,21469634,4059,31,03,1,2023,2023-03-31,2,2023,21469634,4059
Bureau,Department of Labor,Employee Benefit Security Administration,null,100.0,100.0,0,0,21985422,493,31,03,1,2023,2023-03-31,2,2023,21985422,493
Bureau,Agency for International Development,Agency for International Development,null,99.99894676970202,98.07692307692308,272,1,25825039,51,31,03,1,2023,2023-03-31,2,2023,25825311,52
Bureau,Environmental Protection Agency,Environmental Protection Agency,null,100.0,100.0,0,0,26123455,255,31,03,1,2023,2023-03-31,2,2023,26123455,255
Bureau,Department of Health & Human Services,National Institutes of Health,null,25.07640233138957,13.646288209606986,22357245,791,7482813,125,31,03,1,2023,2023-03-31,2,2023,29840058,916
Bureau,Department of the Treasury,Departmental Offices,null,99.66851452488362,99.69788519637463,112276,4,33758288,1320,31,03,1,2023,2023-03-31,2,2023,33870564,1324
Bureau,Department of Housing and Urban Development,Housing Programs,null,99.96231553392359,99.8046875,19609,4,52015094,2044,31,03,1,2023,2023-03-31,2,2023,52034703,2048
Bureau,Department of Labor,Occupational Safety and Health Admin,null,89.89331889570778,81.89918533604887,5820651,711,51771460,3217,31,03,1,2023,2023-03-31,2,2023,57592111,3928
Bureau,Department of Labor,Employment Standards Administration,null,89.30442468512835,62.905534351145036,7373334,1555,61564837,2637,31,03,1,2023,2023-03-31,2,2023,68938171,4192
Bureau,Department of Transportation,Federal Motor Carrier Safety Admin,null,99.99863862401504,99.97523833106351,986,2,72425736,8075,31,03,1,2023,2023-03-31,2,2023,72426722,8077
Bureau,U.S. Postal Service,U.S. Postal Service,null,86.34047582150242,84.27627678495807,10235235,11139,64695889,59703,31,03,1,2023,2023-03-31,2,2023,74931124,70842
Bureau,Department of Agriculture,Forest Service,null,87.94715236756534,32.590529247910865,9411431,726,68673278,351,31,03,1,2023,2023-03-31,2,2023,78084709,1077
Bureau,Department of Justice,Legal Activities,null,97.28829297783574,98.92880938957511,2377889,418,85311857,38604,31,03,1,2023,2023-03-31,2,2023,87689746,39022
Bureau,Department of Health & Human Services,Indian Health Services,null,100.0,100.0,0,0,92757849,4230,31,03,1,2023,2023-03-31,2,2023,92757849,4230
Bureau,Department of Health & Human Services,Health Resources and Services Admin,null,100.0,100.0,0,0,108788414,620,31,03,1,2023,2023-03-31,2,2023,108788414,620
Bureau,Department of Health & Human Services,Food and Drug Administration,null,23.094197019685627,7.730249170847861,140118740,21700,42076536,1818,31,03,1,2023,2023-03-31,2,2023,182195276,23518
Bureau,Department of Veterans Affairs,Medical and Construction,null,99.64734251745806,99.91957575761941,671926,2233,189860257,2774293,31,03,1,2023,2023-03-31,2,2023,190532183,2776526
Bureau,Federal Communications Commission,Federal Communications Commission,null,100.0,100.0,0,0,234290204,13639,31,03,1,2023,2023-03-31,2,2023,234290204,13639
Bureau,Department of Homeland Security,Emergency Preparedness & Resp,null,100.0,100.0,0,0,236437560,41624,31,03,1,2023,2023-03-31,2,2023,236437560,41624
Bureau,Department of Agriculture,Farm Service Agency,null,100.0,100.0,0,0,377306237,3869,31,03,1,2023,2023-03-31,2,2023,377306237,3869
Bureau,Federal Trade Commission,Federal Trade Commission,null,100.0,100.0,0,0,481038032,62,31,03,1,2023,2023-03-31,2,2023,481038032,62
Bureau,Commodity Futures Trading Commission,Commodity Futures Trading Commission,null,100.0,100.0,0,0,624898894,360,31,03,1,2023,2023-03-31,2,2023,624898894,360
Bureau,Department of Agriculture,Rural Development,null,99.99802249617282,99.66720220335093,16744,87,846707281,26055,31,03,1,2023,2023-03-31,2,2023,846724025,26142
Bureau,Department of Education,Departmental Management,null,98.894249896053,95.21072796934865,15819225,100,1414813695,1988,31,03,1,2023,2023-03-31,2,2023,1430632920,2088
Bureau,Securities & Exchange Commission,SEC Enforcement,null,100.0,100.0,0,0,2503576364,1263,31,03,1,2023,2023-03-31,2,2023,2503576364,1263
Bureau,Department of Defense,Consolidated Report,null,33.81031330342711,17.481318128439117,2120947606,1403958,1083399947,297424,31,03,1,2023,2023-03-31,2,2023,3204347553,1701382
Bureau,Social Security Administration,Social Security Administration,null,58.09810200121109,32.15149324236063,1788350680,893383,2479596037,423349,31,03,1,2023,2023-03-31,2,2023,4267946717,1316732
Bureau,Department of Health & Human Services,Centers for Medicare & Medicaid Services,null,99.30512699385879,99.07943613417723,70245495,10126,10038867160,1089852,31,03,1,2023,2023-03-31,2,2023,10109112655,1099978
Bureau,Small Business Administration,Small Business Administration,null,100.0,100.0,0,0,17077256847,145761,31,03,1,2023,2023-03-31,2,2023,17077256847,145761
Agency,Agency for International Development,null,CFO,99.99894676970202,98.07692307692308,272,1,25825039,51,31,03,1,2023,2023-03-31,2,2023,25825311,52
Agency,Environmental Protection Agency,null,CFO,100.0,100.0,0,0,26123455,255,31,03,1,2023,2023-03-31,2,2023,26123455,255
Agency,Federal Labor Relations Authority,null,Non-CFO,0.0,0.0,0,0,0,0,31,03,1,2023,2023-03-31,2,2023,0,0
Bureau,Department of Health & Human Services,Administration for Children and Families,null,100.0,100.0,0,0,37597246,1633,31,03,1,2023,2023-03-31,2,2023,37597246,1633
Agency,National Aeronautics and Space Administration,null,CFO,100.0,100.0,0,0,1518126,127,31,03,1,2023,2023-03-31,2,2023,1518126,127
Agency,General Services Administration,null,CFO,83.41704679193136,92.73153575615474,2139623,124,10762922,1582,31,03,1,2023,2023-03-31,2,2023,12902545,1706
Bureau,Office of Special Counsel,Office of Special Counsel,null,0.0,0.0,0,0,0,0,31,03,1,2023,2023-03-31,2,2023,0,0
Bureau,Department of Commerce,Minority Business Development Agency,null,0.0,0.0,0,0,0,0,31,03,1,2023,2023-03-31,2,2023,0,0
Bureau,Department of Homeland Security,Info Analysis Infrastructure Prot-NPPD,null,0.0,0.0,0,0,0,0,31,03,1,2023,2023-03-31,2,2023,0,0
Bureau,Other Agencies,Federal Housing Finance Agency OIG,null,0.0,0.0,0,0,0,0,31,03,1,2023,2023-03-31,2,2023,0,0
Agency,Legislative Branch-CBO,null,Non-CFO,0.0,0.0,0,0,0,0,31,03,1,2023,2023-03-31,2,2023,0,0
Agency,Legislative Branch-Office of Tech.,null,Non-CFO,0.0,0.0,0,0,0,0,31,03,1,2023,2023-03-31,2,2023,0,0
Bureau,Department of Homeland Security,Federal Law Enforcement Training Ctr.,null,100.0,100.0,0,0,8562,1,31,03,1,2023,2023-03-31,2,2023,8562,1
Bureau,Department of Transportation,Federal Railroad Administration,null,100.0,100.0,0,0,146022,16,31,03,1,2023,2023-03-31,2,2023,146022,16
Bureau,Department of the Interior,Geological Survey,null,100.0,100.0,0,0,164593,1089,31,03,1,2023,2023-03-31,2,2023,164593,1089
Bureau,Department of Homeland Security,Transportation Safety Administration,null,100.0,100.0,0,0,11504446,13106,31,03,1,2023,2023-03-31,2,2023,11504446,13106
Bureau,Department of Commerce,Bureau of Industry and Security,null,100.0,100.0,0,0,37545570,28,31,03,1,2023,2023-03-31,2,2023,37545570,28
Bureau,Department of the Treasury,International Monetary Funds,null,0.0,0.0,0,0,0,0,31,03,1,2023,2023-03-31,2,2023,0,0
Bureau,Department of the Interior,National Park Service,null,100.0,100.0,0,0,8767549,2042,31,03,1,2023,2023-03-31,2,2023,8767549,2042
Bureau,Department of the Interior,Bureau of Land Management,null,100.0,100.0,0,0,9029752,351,31,03,1,2023,2023-03-31,2,2023,9029752,351
Bureau,Department of Education,Federal Student Aid,null,99.94172843271548,99.86834669346156,70442197,27338,120815609582,20737807,31,03,1,2023,2023-03-31,2,2023,120886051779,20765145
Bureau,Department of Commerce,Office of the Inspector General,null,0.0,0.0,0,0,0,0,30,06,2,2023,2023-06-30,3,2023,0,0
Bureau,Department of Commerce,Minority Business Development Agency,null,0.0,0.0,0,0,0,0,30,06,2,2023,2023-06-30,3,2023,0,0
Bureau,Department of Housing and Urban Development,Public and Indian Housing Programs,null,0.0,0.0,0,0,0,0,30,06,2,2023,2023-06-30,3,2023,0,0
Bureau,Occupational Safety & Health Rev Comm,Occupational Safety & Health Rev Comm,null,0.0,0.0,0,0,0,0,30,06,2,2023,2023-06-30,3,2023,0,0
Bureau,Other Agencies,District of Columbia Government,null,0.0,0.0,0,0,0,0,30,06,2,2023,2023-06-30,3,2023,0,0
Bureau,American Battle Monuments Commission,American Battle Monuments Commission,null,0.0,0.0,0,0,0,0,30,06,2,2023,2023-06-30,3,2023,0,0
Bureau,Department of Housing and Urban Development,"Policy, Development and Research",null,0.0,0.0,0,0,0,0,30,06,2,2023,2023-06-30,3,2023,0,0
Bureau,Farm Credit Administration,Farm Credit System Insurance Corporation,null,0.0,0.0,0,0,0,0,30,06,2,2023,2023-06-30,3,2023,0,0
Bureau,Other Agencies,National Capital Planning Commission,null,0.0,0.0,0,0,0,0,30,06,2,2023,2023-06-30,3,2023,0,0
Bureau,Department of Justice,General Administration,null,0.0,0.0,0,0,0,0,30,06,2,2023,2023-06-30,3,2023,0,0
Bureau,Department of Homeland Security,Info Analysis Infrastructure Prot-NPPD,null,0.0,0.0,0,0,0,0,30,06,2,2023,2023-06-30,3,2023,0,0
Bureau,Department of Commerce,NOAA,null,100.0,100.0,0,0,13080057,1009,30,06,2,2023,2023-06-30,3,2023,13080057,1009
Bureau,Department of Veterans Affairs,Life Insurance,null,100.0,100.0,0,0,1222848,255,30,06,2,2023,2023-06-30,3,2023,1222848,255
Bureau,Legislative Branch-GPO,Government Publishing Office,null,0.0,0.0,0,0,0,0,30,06,2,2023,2023-06-30,3,2023,0,0
Bureau,Department of the Treasury,International Monetary Funds,null,0.0,0.0,0,0,0,0,30,06,2,2023,2023-06-30,3,2023,0,0
Bureau,Department of Commerce,National Technical Information Service,null,0.0,0.0,0,0,0,0,30,06,2,2023,2023-06-30,3,2023,0,0
Bureau,Other Agencies,National Transportation Safety Board,null,0.0,0.0,0,0,0,0,30,06,2,2023,2023-06-30,3,2023,0,0
Bureau,Department of Education,Office of Postsecondary Education,null,0.0,0.0,0,0,0,0,30,06,2,2023,2023-06-30,3,2023,0,0
Bureau,Department of Labor,Departmental Management,null,0.0,0.0,0,0,0,0,30,06,2,2023,2023-06-30,3,2023,0,0
Bureau,Export - Import  Bank,Export-Import Bank,null,0.0,0.0,0,0,0,0,30,06,2,2023,2023-06-30,3,2023,0,0
Bureau,Other Agencies/Boards/Commissions,Nuclear Waste Technical Review Board,null,0.0,0.0,0,0,0,0,30,06,2,2023,2023-06-30,3,2023,0,0
Bureau,Department of the Treasury,Interest on Tax/Deposit of Earnings,null,0.0,0.0,0,0,0,0,30,06,2,2023,2023-06-30,3,2023,0,0
Bureau,National Foundation  Arts & Humanities,National Endowment for the Humanities,null,0.0,0.0,0,0,0,0,30,06,2,2023,2023-06-30,3,2023,0,0
Bureau,Department of Homeland Security,U.S. Secret Service,null,0.0,0.0,0,0,0,0,30,06,2,2023,2023-06-30,3,2023,0,0
Bureau,Department of Homeland Security,Emergency Preparedness & Resp,null,100.0,100.0,0,0,205717987,38982,30,06,2,2023,2023-06-30,3,2023,205717987,38982
Bureau,Office of Government Ethics,Office of Government Ethics,null,0.0,0.0,0,0,0,0,30,06,2,2023,2023-06-30,3,2023,0,0
Bureau,Other Agencies,Denali Commission,null,0.0,0.0,0,0,0,0,30,06,2,2023,2023-06-30,3,2023,0,0
Bureau,Department of Justice,Federal Prison System,null,0.0,0.0,0,0,0,0,30,06,2,2023,2023-06-30,3,2023,0,0
Agency,Federal Election Commission,null,Non-CFO,100.0,100.0,0,0,2285529,313,30,06,2,2023,2023-06-30,3,2023,2285529,313
Agency,National Labor Relations Board,null,Non-CFO,0.0,0.0,0,0,0,0,30,06,2,2023,2023-06-30,3,2023,0,0
Agency,Tennessee Valley Authority,null,Non-CFO,0.0,0.0,0,0,0,0,30,06,2,2023,2023-06-30,3,2023,0,0
Bureau,Department of Justice,U.S. Marshals Service,null,0.0,0.0,0,0,0,0,30,06,2,2023,2023-06-30,3,2023,0,0
Bureau,National Labor Relations Board,National Labor Relations Board,null,0.0,0.0,0,0,0,0,30,06,2,2023,2023-06-30,3,2023,0,0
Agency,Office of Personnel Management,null,CFO,100.0,100.0,0,0,21360898,1176,30,06,2,2023,2023-06-30,3,2023,21360898,1176
Bureau,Legislative Branch-Office of Tech.,Medicaid & CHIP Payment & Access Comm.,null,0.0,0.0,0,0,0,0,30,06,2,2023,2023-06-30,3,2023,0,0
Bureau,Department of the Treasury,Office of Sec International Affairs,null,0.0,0.0,0,0,0,0,30,06,2,2023,2023-06-30,3,2023,0,0
Agency,Department of State,null,CFO,98.52022351634156,99.81354878806712,330209,39,21984580,20878,30,06,2,2023,2023-06-30,3,2023,22314789,20917
Bureau,Department of the Treasury,U.S. Treasury IG Office,null,0.0,0.0,0,0,0,0,30,06,2,2023,2023-06-30,3,2023,0,0
Bureau,Office of Special Counsel,Office of Special Counsel,null,0.0,0.0,0,0,0,0,30,06,2,2023,2023-06-30,3,2023,0,0
Bureau,Legislative Branch-GAO,Government Accountability Office,null,0.0,0.0,0,0,0,0,30,06,2,2023,2023-06-30,3,2023,0,0
Bureau,US International Development Fin. Corp.,US International Development Fin. Corp.,null,0.0,0.0,0,0,0,0,30,06,2,2023,2023-06-30,3,2023,0,0
Bureau,Department of Homeland Security,Office of Biometric Identity Management,null,0.0,0.0,0,0,0,0,30,06,2,2023,2023-06-30,3,2023,0,0
Bureau,Other Agencies/Boards/Commissions,Medicare Payment Advisory Commission,null,0.0,0.0,0,0,0,0,30,06,2,2023,2023-06-30,3,2023,0,0
Bureau,Other Agencies,Commission On Fine Arts,null,0.0,0.0,0,0,0,0,30,06,2,2023,2023-06-30,3,2023,0,0
Bureau,Smithsonian Institution,National Gallery of Art,null,0.0,0.0,0,0,0,0,30,06,2,2023,2023-06-30,3,2023,0,0
Bureau,National Foundation  Arts & Humanities,National Endowment for the Arts,null,0.0,0.0,0,0,0,0,30,06,2,2023,2023-06-30,3,2023,0,0
Bureau,Federal Labor Relations Authority,Federal Labor Relations Authority,null,0.0,0.0,0,0,0,0,30,06,2,2023,2023-06-30,3,2023,0,0
Agency,Department of Energy,null,CFO,100.0,100.0,0,0,14276675,95,30,06,2,2023,2023-06-30,3,2023,14276675,95
Bureau,Other Agencies,U.S. Institute of Peace,null,0.0,0.0,0,0,0,0,30,06,2,2023,2023-06-30,3,2023,0,0
Bureau,Merit Systems Protection Board,Merit Systems Protection Board,null,100.0,100.0,0,0,144,1,30,06,2,2023,2023-06-30,3,2023,144,1
Bureau,Farm Credit Administration,Farm Credit Administration,null,100.0,100.0,0,0,630,1,30,06,2,2023,2023-06-30,3,2023,630,1
Bureau,Equal Employment Opportunity Commission,Equal Employment Opportunity Commission,null,100.0,100.0,0,0,20935,19,30,06,2,2023,2023-06-30,3,2023,20935,19
Bureau,Department of Transportation,Research Innovative Technology Admin,null,100.0,100.0,0,0,22950,6,30,06,2,2023,2023-06-30,3,2023,22950,6
Bureau,Other Agencies,Chemical Safety Board,null,100.0,100.0,0,0,31538,2,30,06,2,2023,2023-06-30,3,2023,31538,2
Bureau,Department of Transportation,National Highway Traffic Safety Admin.,null,100.0,100.0,0,0,36618,6,30,06,2,2023,2023-06-30,3,2023,36618,6
Bureau,Department of the Treasury,Bureau of Engraving and Printing,null,100.0,100.0,0,0,38345,2,30,06,2,2023,2023-06-30,3,2023,38345,2
Bureau,Department of the Treasury,Internal Revenue Service,null,100.0,100.0,0,0,44464,34,30,06,2,2023,2023-06-30,3,2023,44464,34
Bureau,Department of Justice,Federal Prison Industries,null,0.0,0.0,237857,62,0,0,30,06,2,2023,2023-06-30,3,2023,237857,62
Agency,Funds Appropriated to the President,null,Non-CFO,0.19112955386147104,50.0,1236060,7,2367,7,30,06,2,2023,2023-06-30,3,2023,1238427,14
Agency,Presidio Trust Corporation,null,Non-CFO,100.0,100.0,0,0,1548205,61,30,06,2,2023,2023-06-30,3,2023,1548205,61
Bureau,Other Agencies,Comm. for Purchase from Blind/Handic.,null,0.0,0.0,0,0,0,0,30,06,2,2023,2023-06-30,3,2023,0,0
Bureau,Department of Housing and Urban Development,Community Planning and Development,null,0.0,0.0,0,0,0,0,30,06,2,2023,2023-06-30,3,2023,0,0
Bureau,Smithsonian Institution,JFK Center for the Performing Arts,null,0.0,0.0,0,0,0,0,30,06,2,2023,2023-06-30,3,2023,0,0
Bureau,Department of the Treasury,Office of the Secretary,null,0.0,0.0,0,0,0,0,30,06,2,2023,2023-06-30,3,2023,0,0
Bureau,Department of the Interior,Office of Surface Mining,null,99.8681519130278,99.46524064171123,10929,2,8278156,372,30,06,2,2023,2023-06-30,3,2023,8289085,374
Bureau,Department of the Interior,National Park Service,null,100.0,100.0,0,0,8671607,1983,30,06,2,2023,2023-06-30,3,2023,8671607,1983
Bureau,Department of the Interior,Bureau of Land Management,null,100.0,100.0,0,0,9053672,377,30,06,2,2023,2023-06-30,3,2023,9053672,377
Bureau,Department of Homeland Security,U.S. Coast Guard,null,6.829504698560871,8.709185230393652,17179457,14958,1259274,1427,30,06,2,2023,2023-06-30,3,2023,18438731,16385
Bureau,Funds Appropriated to the President,Inter-American Foundation,null,0.0,0.0,0,0,0,0,30,06,2,2023,2023-06-30,3,2023,0,0
Bureau,Other Agencies,Federal Housing Finance Agency OIG,null,0.0,0.0,0,0,0,0,30,06,2,2023,2023-06-30,3,2023,0,0
Bureau,Other Agencies,Morris K. Udall Scholarship,null,0.0,0.0,0,0,0,0,30,06,2,2023,2023-06-30,3,2023,0,0
Bureau,Other Agencies,U.S. Holocaust Memorial Council,null,0.0,0.0,0,0,0,0,30,06,2,2023,2023-06-30,3,2023,0,0
Bureau,Department of State,International Commissions,null,0.0,0.0,0,0,0,0,30,06,2,2023,2023-06-30,3,2023,0,0
Bureau,Department of Homeland Security,Management Headquarters,null,0.0,0.0,0,0,0,0,30,06,2,2023,2023-06-30,3,2023,0,0
Bureau,Tennessee Valley Authority,Tennessee Valley Authority,null,0.0,0.0,0,0,0,0,30,06,2,2023,2023-06-30,3,2023,0,0
Bureau,Department of Homeland Security,Office of the Inspector General DHS,null,100.0,100.0,0,0,100,1,30,06,2,2023,2023-06-30,3,2023,100,1
Bureau,Department of the Treasury,Treasury IG for Tax Admin,null,100.0,100.0,0,0,260,2,30,06,2,2023,2023-06-30,3,2023,260,2
Bureau,Department of Homeland Security,Domestic Nuclear Detection Office,null,0.0,0.0,2069,20,0,0,30,06,2,2023,2023-06-30,3,2023,2069,20
Bureau,Department of Health & Human Services,Office of the Inspector General,null,100.0,100.0,0,0,33600,1,30,06,2,2023,2023-06-30,3,2023,33600,1
Bureau,Department of Veterans Affairs,Housing Credit Assistance,null,0.0,0.0,378701,14,0,0,30,06,2,2023,2023-06-30,3,2023,378701,14
Bureau,Federal Maritime Commission,Salaries and Expenses,null,100.0,100.0,0,0,397569,6,30,06,2,2023,2023-06-30,3,2023,397569,6
Bureau,Department of the Treasury,D.C. Pension Program,null,100.0,100.0,0,0,428404,18,30,06,2,2023,2023-06-30,3,2023,428404,18
Bureau,Department of Justice,Federal Bureau of Investigation,null,100.0,100.0,0,0,478036,112,30,06,2,2023,2023-06-30,3,2023,478036,112
Bureau,Department of Commerce,Patent and Trademark Office,null,100.0,100.0,0,0,492876,703,30,06,2,2023,2023-06-30,3,2023,492876,703
Bureau,Other Agencies,Consumer Financial Protection Bureau,null,99.15205772366077,46.15384615384615,4374,7,511463,6,30,06,2,2023,2023-06-30,3,2023,515837,13
Bureau,Department of Veterans Affairs,Veterans Benefits,null,0.0,0.0,1224051,1626,0,0,30,06,2,2023,2023-06-30,3,2023,1224051,1626
Bureau,Department of Energy,Energy Consolidated Reports,null,100.0,100.0,0,0,13218205,67,30,06,2,2023,2023-06-30,3,2023,13218205,67
Bureau,Department of the Treasury,Bureau of the Fiscal Service,null,100.0,100.0,0,0,13580224,3130,30,06,2,2023,2023-06-30,3,2023,13580224,3130
Bureau,Department of Homeland Security,Immigration and Customs Enforcement,null,100.0,100.0,0,0,16436204,645,30,06,2,2023,2023-06-30,3,2023,16436204,645
Bureau,General Services Administration,General Services Administration,null,88.61667590387479,91.91176470588235,2056149,143,16006668,1625,30,06,2,2023,2023-06-30,3,2023,18062817,1768
Bureau,Department of Commerce,Bureau of Industry and Security,null,100.0,100.0,0,0,37545771,27,30,06,2,2023,2023-06-30,3,2023,37545771,27
Bureau,Department of Housing and Urban Development,Housing Programs,null,99.96045907617936,99.86749116607774,22338,3,56471031,2261,30,06,2,2023,2023-06-30,3,2023,56493369,2264
Bureau,Department of Labor,Occupational Safety and Health Admin,null,89.80546667402774,76.66666666666667,5995806,966,52818127,3174,30,06,2,2023,2023-06-30,3,2023,58813933,4140
Agency,Legislative Branch-GPO,null,Non-CFO,0.0,0.0,0,0,0,0,30,06,2,2023,2023-06-30,3,2023,0,0
Agency,Federal Labor Relations Authority,null,Non-CFO,0.0,0.0,0,0,0,0,30,06,2,2023,2023-06-30,3,2023,0,0
Agency,National Foundation  Arts & Humanities,null,Non-CFO,0.0,0.0,0,0,0,0,30,06,2,2023,2023-06-30,3,2023,0,0
Agency,Merit Systems Protection Board,null,Non-CFO,100.0,100.0,0,0,144,1,30,06,2,2023,2023-06-30,3,2023,144,1
Agency,Consumer Product Safety Commission,null,Non-CFO,100.0,100.0,0,0,531,3,30,06,2,2023,2023-06-30,3,2023,531,3
Agency,Farm Credit Administration,null,Non-CFO,100.0,100.0,0,0,630,1,30,06,2,2023,2023-06-30,3,2023,630,1
Agency,Smithsonian Institution,null,Non-CFO,0.0,0.0,898,8,0,0,30,06,2,2023,2023-06-30,3,2023,898,8
Agency,Other Agencies/Boards/Commissions,null,Non-CFO,0.0,0.0,1024,1,0,0,30,06,2,2023,2023-06-30,3,2023,1024,1
Agency,Selective Service System,null,Non-CFO,0.0,0.0,1301,4,0,0,30,06,2,2023,2023-06-30,3,2023,1301,4
Bureau,Legislative Branch-Office of Tech.,Open World Leadership,null,0.0,0.0,0,0,0,0,30,06,2,2023,2023-06-30,3,2023,0,0
Bureau,Department of the Treasury,Treasury Franchise Fund,null,0.0,0.0,0,0,0,0,30,06,2,2023,2023-06-30,3,2023,0,0
Bureau,Other Agencies,National Mediation Board,null,0.0,0.0,0,0,0,0,30,06,2,2023,2023-06-30,3,2023,0,0
Agency,Federal Deposit Insurance Corporation,null,Non-CFO,0.0,0.0,0,0,0,0,30,06,2,2023,2023-06-30,3,2023,0,0
Agency,Agency for International Development,null,CFO,99.99894904425621,98.11320754716981,272,1,25880932,52,30,06,2,2023,2023-06-30,3,2023,25881204,53
Agency,Environmental Protection Agency,null,CFO,100.0,100.0,0,0,26318019,256,30,06,2,2023,2023-06-30,3,2023,26318019,256
Agency,Department of the Treasury,null,CFO,99.18188600016352,99.58542439450142,375849,19,45565059,4564,30,06,2,2023,2023-06-30,3,2023,45940908,4583
Agency,Department of Housing and Urban Development,null,CFO,99.96046236973561,99.86754966887418,22338,3,56475737,2262,30,06,2,2023,2023-06-30,3,2023,56498075,2265
Agency,Department of Commerce,null,CFO,100.0,100.0,0,0,59859537,17691,30,06,2,2023,2023-06-30,3,2023,59859537,17691
Agency,Department of Transportation,null,CFO,100.0,100.0,0,0,80519033,8713,30,06,2,2023,2023-06-30,3,2023,80519033,8713
Agency,Department of the Interior,null,CFO,99.97633411332012,99.6490886051272,20459,108,86428869,30669,30,06,2,2023,2023-06-30,3,2023,86449328,30777
Agency,Department of Justice,null,CFO,96.4207066584786,98.80834160873883,3315291,468,89308886,38805,30,06,2,2023,2023-06-30,3,2023,92624177,39273
Agency,Department of Labor,null,CFO,90.89187077453957,77.66666666666667,14198848,2680,141693187,9320,30,06,2,2023,2023-06-30,3,2023,155892035,12000
Agency,Department of Veterans Affairs,null,CFO,98.67788365662109,99.86745281011413,2776193,4080,207204798,3074069,30,06,2,2023,2023-06-30,3,2023,209980991,3078149
Agency,Department of Homeland Security,null,CFO,93.46292594890272,78.96141474583175,17181526,14978,245650528,56215,30,06,2,2023,2023-06-30,3,2023,262832054,71193
Agency,Department of Agriculture,null,CFO,98.46565145752976,92.25957455622527,20405062,3737,1309479344,44542,30,06,2,2023,2023-06-30,3,2023,1329884406,48279
Agency,Department of Defense,null,CFO,33.50882024365026,16.957753867054873,2135354213,1443770,1076130710,294827,30,06,2,2023,2023-06-30,3,2023,3211484923,1738597
Agency,Social Security Administration,null,CFO,57.731384953169105,31.98333201982957,1792986202,888935,2448899178,418002,30,06,2,2023,2023-06-30,3,2023,4241885380,1306937
Agency,Federal Trade Commission,null,Non-CFO,100.0,100.0,0,0,380678869,57,30,06,2,2023,2023-06-30,3,2023,380678869,57
Agency,Commodity Futures Trading Commission,null,Non-CFO,100.0,100.0,0,0,627349991,360,30,06,2,2023,2023-06-30,3,2023,627349991,360
Agency,Securities & Exchange Commission,null,Non-CFO,100.0,100.0,0,0,2539624850,1363,30,06,2,2023,2023-06-30,3,2023,2539624850,1363
Bureau,Federal Mediation/Conciliation Service,Federal Mediation/Conciliation Service,null,0.0,0.0,0,0,0,0,30,06,2,2023,2023-06-30,3,2023,0,0
Bureau,Department of Homeland Security,Science and Technology,null,0.0,0.0,0,0,0,0,30,06,2,2023,2023-06-30,3,2023,0,0
Agency,Department of Education,null,CFO,99.99539058370925,99.99963555437007,5514648,74,119633234646,20304738,30,06,2,2023,2023-06-30,3,2023,119638749294,20304812
Agency,Neighborhood Reinvestment Corporation,null,Non-CFO,0.0,0.0,0,0,0,0,30,06,2,2023,2023-06-30,3,2023,0,0
Agency,Legislative Branch-CBO,null,Non-CFO,0.0,0.0,0,0,0,0,30,06,2,2023,2023-06-30,3,2023,0,0
Agency,Occupational Safety & Health Rev Comm,null,Non-CFO,0.0,0.0,0,0,0,0,30,06,2,2023,2023-06-30,3,2023,0,0
Agency,Legislative Branch-Office of Tech.,null,Non-CFO,0.0,0.0,0,0,0,0,30,06,2,2023,2023-06-30,3,2023,0,0
Agency,Office of Compliance,null,Non-CFO,0.0,0.0,0,0,0,0,30,06,2,2023,2023-06-30,3,2023,0,0
Agency,Legis Branch-Library of Congress,null,Non-CFO,0.0,0.0,0,0,0,0,30,06,2,2023,2023-06-30,3,2023,0,0
Agency,Legislative Branch-GAO,null,Non-CFO,0.0,0.0,0,0,0,0,30,06,2,2023,2023-06-30,3,2023,0,0
Agency,U.S. Court of Appeals / Veterans Claims,null,Non-CFO,0.0,0.0,0,0,0,0,30,06,2,2023,2023-06-30,3,2023,0,0
Agency,US International Development Fin. Corp.,null,Non-CFO,0.0,0.0,0,0,0,0,30,06,2,2023,2023-06-30,3,2023,0,0
Bureau,Department of Labor,Employment and Training Administration,null,100.0,100.0,0,0,885054,10,30,06,2,2023,2023-06-30,3,2023,885054,10
Bureau,The Judiciary,Administrative Office of the U.S. Courts,null,98.36098413105292,56.41025641025641,17264,136,1036051,176,30,06,2,2023,2023-06-30,3,2023,1053315,312
Bureau,Department of Energy,Bonneville Power Administration,null,100.0,100.0,0,0,1058470,28,30,06,2,2023,2023-06-30,3,2023,1058470,28
Bureau,Department of Health & Human Services,Substance Abuse & Mental Health Admin.,null,100.0,100.0,0,0,1058773,11,30,06,2,2023,2023-06-30,3,2023,1058773,11
Bureau,Federal Election Commission,Federal Election Commission,null,100.0,100.0,0,0,2285529,313,30,06,2,2023,2023-06-30,3,2023,2285529,313
Bureau,Nuclear Regulatory Commission,Nuclear Regulatory Commission,null,100.0,100.0,0,0,2911495,354,30,06,2,2023,2023-06-30,3,2023,2911495,354
Bureau,Department of Veterans Affairs,Administration and Cemeteries,null,84.77162881662869,59.178433889602054,511025,318,2844718,461,30,06,2,2023,2023-06-30,3,2023,3355743,779
Bureau,Department of Homeland Security,Bureau of Customs & Border Protection,null,100.0,100.0,0,0,9556269,916,30,06,2,2023,2023-06-30,3,2023,9556269,916
Bureau,Department of Labor,Mine Safety and Health Administration,null,86.56465234112953,92.35339705502454,1383506,296,8914002,3575,30,06,2,2023,2023-06-30,3,2023,10297508,3871
Agency,Legislative Branch - U.S. House/Senate,null,Non-CFO,0.0,0.0,351558,218,0,0,30,06,2,2023,2023-06-30,3,2023,351558,218
Bureau,U.S. Tax Court,U.S. Tax Court,null,0.0,0.0,0,0,0,0,30,06,2,2023,2023-06-30,3,2023,0,0
Agency,Federal Maritime Commission,null,Non-CFO,100.0,100.0,0,0,397569,6,30,06,2,2023,2023-06-30,3,2023,397569,6
Bureau,Funds Appropriated to the President,Defense Security Assistance Agency,null,0.0,0.0,0,0,0,0,30,06,2,2023,2023-06-30,3,2023,0,0
Bureau,Other Agencies,Gulf Coast Ecosystem Restoration Council,null,0.0,0.0,0,0,0,0,30,06,2,2023,2023-06-30,3,2023,0,0
Bureau,Department of Commerce,Economic and Statistical Analysis,null,0.0,0.0,0,0,0,0,30,06,2,2023,2023-06-30,3,2023,0,0
Bureau,Department of the Treasury,U.S. Mint,null,12.917750769267325,86.36363636363636,146596,3,21746,19,30,06,2,2023,2023-06-30,3,2023,168342,22
Bureau,Other Agencies,James Madison Memorial Fellowship,null,0.0,0.0,197596,23,0,0,30,06,2,2023,2023-06-30,3,2023,197596,23
Bureau,Department of the Interior,Geological Survey,null,100.0,100.0,0,0,222765,1051,30,06,2,2023,2023-06-30,3,2023,222765,1051
Bureau,Funds Appropriated to the President,Trade and Development Agency,null,0.0,0.0,1236060,7,0,0,30,06,2,2023,2023-06-30,3,2023,1236060,7
Bureau,Department of Transportation,Pipeline Hazardous Material Safety Admin,null,100.0,100.0,0,0,1250652,95,30,06,2,2023,2023-06-30,3,2023,1250652,95
Bureau,Department of Justice,Office of Justice Assistance Programs,null,100.0,100.0,0,0,1383807,6,30,06,2,2023,2023-06-30,3,2023,1383807,6
Bureau,Department of the Treasury,Comptroller of the Currency,null,99.33049108069156,75.0,9551,7,1417017,21,30,06,2,2023,2023-06-30,3,2023,1426568,28
Agency,U.S. Tax Court,null,Non-CFO,0.0,0.0,0,0,0,0,30,06,2,2023,2023-06-30,3,2023,0,0
Agency,National Archives & Records Admin,null,Non-CFO,100.0,100.0,0,0,131736,113,30,06,2,2023,2023-06-30,3,2023,131736,113
Agency,Other Agencies,null,Non-CFO,70.60011285595783,16.666666666666668,226121,40,543001,8,30,06,2,2023,2023-06-30,3,2023,769122,48
Agency,The Judiciary,null,Non-CFO,98.36098413105292,56.41025641025641,17264,136,1036051,176,30,06,2,2023,2023-06-30,3,2023,1053315,312
Bureau,Department of the Interior,Fish and Wildlife Service,null,100.0,100.0,0,0,796491,96,30,06,2,2023,2023-06-30,3,2023,796491,96
Bureau,Department of Commerce,Nat'l Institute of Standards& Technology,null,100.0,100.0,0,0,1087068,4,30,06,2,2023,2023-06-30,3,2023,1087068,4
Bureau,Department of Homeland Security,Citizenship and Immigration Services,null,100.0,100.0,0,0,1121143,1348,30,06,2,2023,2023-06-30,3,2023,1121143,1348
Bureau,Department of State,Passport NSF,null,100.0,100.0,0,0,1790322,11539,30,06,2,2023,2023-06-30,3,2023,1790322,11539
Bureau,Department of Transportation,Federal Aviation Administration,null,100.0,100.0,0,0,2144034,266,30,06,2,2023,2023-06-30,3,2023,2144034,266
Bureau,Department of Commerce,Bureau of the Census,null,100.0,100.0,0,0,2199232,15933,30,06,2,2023,2023-06-30,3,2023,2199232,15933
Bureau,Corp. for National and Community Service,Corp. for National and Community Service,null,95.86515359133662,45.67901234567901,155402,176,3602948,148,30,06,2,2023,2023-06-30,3,2023,3758350,324
Bureau,Department of Agriculture,Forest Service,null,0.0,0.0,10220684,1406,0,0,30,06,2,2023,2023-06-30,3,2023,10220684,1406
Bureau,Department of State,Department of State,null,98.39114457880927,99.58413307741523,330209,39,20194258,9339,30,06,2,2023,2023-06-30,3,2023,20524467,9378
Bureau,Department of the Treasury,Departmental Offices,null,98.95267672084684,99.3202416918429,219702,9,20757775,1315,30,06,2,2023,2023-06-30,3,2023,20977477,1324
Bureau,Office of Personnel Management,Office of Personnel Management,null,100.0,100.0,0,0,21360898,1176,30,06,2,2023,2023-06-30,3,2023,21360898,1176
Bureau,Railroad Retirement Board,Railroad Retirement Board,null,100.0,100.0,0,0,21471425,4023,30,06,2,2023,2023-06-30,3,2023,21471425,4023
Bureau,Department of Agriculture,U.S. Department of Agriculture,null,84.77006421682266,65.8108108108108,3280219,1265,18257751,2435,30,06,2,2023,2023-06-30,3,2023,21537970,3700
Bureau,Department of Labor,Employee Benefit Security Administration,null,100.0,100.0,0,0,21587961,469,30,06,2,2023,2023-06-30,3,2023,21587961,469
Bureau,Department of the Interior,Bureau of Indian Affairs,null,99.96094567366991,99.59608276492779,9530,106,24392376,26137,30,06,2,2023,2023-06-30,3,2023,24401906,26243
Bureau,Department of Labor,Employment Standards Administration,null,89.3946512249747,59.58962667426617,6819536,1418,57483262,2091,30,06,2,2023,2023-06-30,3,2023,64302798,3509
Agency,Department of Health & Human Services,null,CFO,97.73871596764837,97.47581229632408,244531691,29883,10569310688,1153983,30,06,2,2023,2023-06-30,3,2023,10813842379,1183866
Agency,Small Business Administration,null,CFO,100.0,100.0,0,0,17230635410,143051,30,06,2,2023,2023-06-30,3,2023,17230635410,143051
Agency,National Credit Union Administration,null,Non-CFO,100.0,100.0,0,0,1373,2,30,06,2,2023,2023-06-30,3,2023,1373,2
Agency,Equal Employment Opportunity Commission,null,Non-CFO,100.0,100.0,0,0,20935,19,30,06,2,2023,2023-06-30,3,2023,20935,19
Agency,Armed Forces Retirement Home,null,Non-CFO,90.89525113293051,97.14285714285714,7715,3,77021,102,30,06,2,2023,2023-06-30,3,2023,84736,105
Agency,Corp. for National and Community Service,null,Non-CFO,95.86515359133662,45.67901234567901,155402,176,3602948,148,30,06,2,2023,2023-06-30,3,2023,3758350,324
Agency,Pension Benefit Guaranty Corp,null,Non-CFO,100.0,100.0,0,0,4436707,1606,30,06,2,2023,2023-06-30,3,2023,4436707,1606
Agency,U.S. Postal Service,null,Non-CFO,70.693829464946,73.37949733515863,25668640,20029,61919194,55210,30,06,2,2023,2023-06-30,3,2023,87587834,75239
Agency,Federal Communications Commission,null,Non-CFO,100.0,100.0,0,0,235548812,13419,30,06,2,2023,2023-06-30,3,2023,235548812,13419
Bureau,Other Agencies,Privacy & Civil Liberties Oversight Bd,null,0.0,0.0,0,0,0,0,30,06,2,2023,2023-06-30,3,2023,0,0
Bureau,Other Agencies,Millennium Challenge Corporation,null,0.0,0.0,0,0,0,0,30,06,2,2023,2023-06-30,3,2023,0,0
Bureau,Other Agencies,Archit.&Trans. Barriers Compliance Bd,null,0.0,0.0,0,0,0,0,30,06,2,2023,2023-06-30,3,2023,0,0
Bureau,Smithsonian Institution,Smithsonian Institution,null,0.0,0.0,898,8,0,0,30,06,2,2023,2023-06-30,3,2023,898,8
Bureau,Department of the Treasury,Tobacco Tax and Trade,null,100.0,100.0,0,0,1000,1,30,06,2,2023,2023-06-30,3,2023,1000,1
Bureau,Other Agencies/Boards/Commissions,U.S. Comm. on Int. Religious Freedom,null,0.0,0.0,1024,1,0,0,30,06,2,2023,2023-06-30,3,2023,1024,1
Bureau,Selective Service System,Selective Service System,null,0.0,0.0,1301,4,0,0,30,06,2,2023,2023-06-30,3,2023,1301,4
Bureau,Department of the Interior,"Bureau of Ocean Energy Mgmt., Reg & Enf",null,100.0,100.0,0,0,1333,1,30,06,2,2023,2023-06-30,3,2023,1333,1
Bureau,National Credit Union Administration,National Credit Union Administration,null,100.0,100.0,0,0,1373,2,30,06,2,2023,2023-06-30,3,2023,1373,2
Agency,Federal Mediation/Conciliation Service,null,Non-CFO,0.0,0.0,0,0,0,0,30,06,2,2023,2023-06-30,3,2023,0,0
Agency,Railroad Retirement Board,null,Non-CFO,100.0,100.0,0,0,21471425,4023,30,06,2,2023,2023-06-30,3,2023,21471425,4023
Bureau,Legis Branch-Library of Congress,Library of Congress,null,0.0,0.0,0,0,0,0,30,06,2,2023,2023-06-30,3,2023,0,0
Bureau,Other Agencies,Delta Regional Authority,null,0.0,0.0,0,0,0,0,30,06,2,2023,2023-06-30,3,2023,0,0
Bureau,Other Agencies,Surface Transportation Board,null,0.0,0.0,0,0,0,0,30,06,2,2023,2023-06-30,3,2023,0,0
Bureau,Other Agencies,National Council on Disability,null,0.0,0.0,0,0,0,0,30,06,2,2023,2023-06-30,3,2023,0,0
Bureau,Neighborhood Reinvestment Corporation,Neighborhood Reinvestment Corporation,null,0.0,0.0,0,0,0,0,30,06,2,2023,2023-06-30,3,2023,0,0
Bureau,Federal Deposit Insurance Corporation,Federal Deposit Insurance Corporation,null,0.0,0.0,0,0,0,0,30,06,2,2023,2023-06-30,3,2023,0,0
Bureau,Department of the Treasury,Treasury Forfeiture Fund,null,0.0,0.0,0,0,0,0,30,06,2,2023,2023-06-30,3,2023,0,0
Bureau,Department of the Treasury,Office of Financial Research,null,100.0,100.0,0,0,268,1,30,06,2,2023,2023-06-30,3,2023,268,1
Agency,National Science Foundation,null,CFO,100.0,100.0,0,0,711137,33,30,06,2,2023,2023-06-30,3,2023,711137,33
Agency,National Aeronautics and Space Administration,null,CFO,100.0,100.0,0,0,1493206,123,30,06,2,2023,2023-06-30,3,2023,1493206,123
Agency,Nuclear Regulatory Commission,null,CFO,100.0,100.0,0,0,2911495,354,30,06,2,2023,2023-06-30,3,2023,2911495,354
Agency,General Services Administration,null,CFO,88.61667590387479,91.91176470588235,2056149,143,16006668,1625,30,06,2,2023,2023-06-30,3,2023,18062817,1768
Agency,American Battle Monuments Commission,null,Non-CFO,0.0,0.0,0,0,0,0,30,06,2,2023,2023-06-30,3,2023,0,0
Agency,Export - Import  Bank,null,Non-CFO,0.0,0.0,0,0,0,0,30,06,2,2023,2023-06-30,3,2023,0,0
Agency,Office of Special Counsel,null,Non-CFO,0.0,0.0,0,0,0,0,30,06,2,2023,2023-06-30,3,2023,0,0
Agency,Office of Government Ethics,null,Non-CFO,0.0,0.0,0,0,0,0,30,06,2,2023,2023-06-30,3,2023,0,0
Bureau,Smithsonian Institution,Administrative Conference of the US,null,0.0,0.0,0,0,0,0,30,06,2,2023,2023-06-30,3,2023,0,0
Bureau,Other Agencies,Federal Housing Finance Agency,null,0.0,0.0,0,0,0,0,30,06,2,2023,2023-06-30,3,2023,0,0
Bureau,Department of the Treasury,Pandemic Receivables,null,100.0,100.0,0,0,4099198,9,30,06,2,2023,2023-06-30,3,2023,4099198,9
Bureau,Department of Agriculture,Food and Nutrition Service,null,0.9976735154508523,46.15384615384615,4066080,21,40975,18,30,06,2,2023,2023-06-30,3,2023,4107055,39
Bureau,Pension Benefit Guaranty Corp,Pension Benefit Guaranty Corporation,null,100.0,100.0,0,0,4436707,1606,30,06,2,2023,2023-06-30,3,2023,4436707,1606
Bureau,Department of Commerce,Economic Development Administration,null,100.0,100.0,0,0,5153780,13,30,06,2,2023,2023-06-30,3,2023,5153780,13
Bureau,Department of Health & Human Services,Program Support Center,null,100.0,100.0,0,0,6409009,265,30,06,2,2023,2023-06-30,3,2023,6409009,265
Bureau,Department of Agriculture,Agricultural Marketing Service,null,57.96205280534616,54.677565849227975,2790241,998,3847193,1204,30,06,2,2023,2023-06-30,3,2023,6637434,2202
Bureau,Department of the Interior,Bureau of Reclamation,null,100.0,100.0,0,0,7386879,65,30,06,2,2023,2023-06-30,3,2023,7386879,65
Bureau,Office of Compliance,Office of Compliance,null,0.0,0.0,0,0,0,0,30,06,2,2023,2023-06-30,3,2023,0,0
Bureau,Funds Appropriated to the President,Peace Corps,null,0.0,0.0,0,0,0,0,30,06,2,2023,2023-06-30,3,2023,0,0
Bureau,U.S. Court of Appeals / Veterans Claims,U.S. Court of Appeals / Veterans Claims,null,0.0,0.0,0,0,0,0,30,06,2,2023,2023-06-30,3,2023,0,0
Bureau,Other Agencies,Defense Nuclear Facilities Safety Board,null,0.0,0.0,0,0,0,0,30,06,2,2023,2023-06-30,3,2023,0,0
Bureau,Other Agencies,Federal Mine Safety & Health Review Comm,null,0.0,0.0,0,0,0,0,30,06,2,2023,2023-06-30,3,2023,0,0
Bureau,Funds Appropriated to the President,African Development Foundation,null,100.0,100.0,0,0,2367,7,30,06,2,2023,2023-06-30,3,2023,2367,7
Bureau,Other Agencies,John C. Stennis,null,0.0,0.0,2934,2,0,0,30,06,2,2023,2023-06-30,3,2023,2934,2
Bureau,Department of Transportation,Federal Highway Administration,null,100.0,100.0,0,0,12219,10,30,06,2,2023,2023-06-30,3,2023,12219,10
Bureau,Department of Justice,Bureau of ATF and Explosives,null,100.0,100.0,0,0,19881,1,30,06,2,2023,2023-06-30,3,2023,19881,1
Bureau,Department of the Interior,Office of the Secretary,null,100.0,100.0,0,0,20692,16,30,06,2,2023,2023-06-30,3,2023,20692,16
Bureau,Securities & Exchange Commission,Securities and Exchange Commission,null,100.0,100.0,0,0,257961,46,30,06,2,2023,2023-06-30,3,2023,257961,46
Bureau,Department of Commerce,Nat'l Telecomm & Information Admin.,null,100.0,100.0,0,0,296093,1,30,06,2,2023,2023-06-30,3,2023,296093,1
Bureau,Department of Justice,Drug Enforcement Administration,null,100.0,100.0,0,0,343044,15,30,06,2,2023,2023-06-30,3,2023,343044,15
Bureau,Legislative Branch - U.S. House/Senate,U.S. House of Representatives,null,0.0,0.0,351558,218,0,0,30,06,2,2023,2023-06-30,3,2023,351558,218
Bureau,Department of Agriculture,Food Safety and Inspection Service,null,96.59912305645368,96.70608108108108,38750,39,1100662,1145,30,06,2,2023,2023-06-30,3,2023,1139412,1184
Bureau,Department of Transportation,Office of the Secretary,null,100.0,100.0,0,0,1197151,16,30,06,2,2023,2023-06-30,3,2023,1197151,16
Bureau,Department of Homeland Security,Transportation Safety Administration,null,100.0,100.0,0,0,11550989,12895,30,06,2,2023,2023-06-30,3,2023,11550989,12895
Bureau,Agency for International Development,Agency for International Development,null,99.99894904425621,98.11320754716981,272,1,25880932,52,30,06,2,2023,2023-06-30,3,2023,25881204,53
Bureau,Department of Veterans Affairs,Medical and Construction,null,99.67496705391758,99.93100252806477,662416,2122,203137232,3073353,30,06,2,2023,2023-06-30,3,2023,203799648,3075475
Bureau,Federal Trade Commission,Federal Trade Commission,null,100.0,100.0,0,0,380678869,57,30,06,2,2023,2023-06-30,3,2023,380678869,57
Bureau,Commodity Futures Trading Commission,Commodity Futures Trading Commission,null,100.0,100.0,0,0,627349991,360,30,06,2,2023,2023-06-30,3,2023,627349991,360
Bureau,Department of the Treasury,Community Dev Financial Inst Fund,null,100.0,100.0,0,0,3627497,8,30,06,2,2023,2023-06-30,3,2023,3627497,8
Bureau,Department of Health & Human Services,Indian Health Services,null,100.0,100.0,0,0,72455132,4280,30,06,2,2023,2023-06-30,3,2023,72455132,4280
Bureau,Department of Transportation,Federal Motor Carrier Safety Admin,null,100.0,100.0,0,0,74850288,8281,30,06,2,2023,2023-06-30,3,2023,74850288,8281
Bureau,U.S. Postal Service,U.S. Postal Service,null,70.693829464946,73.37949733515863,25668640,20029,61919194,55210,30,06,2,2023,2023-06-30,3,2023,87587834,75239
Bureau,Department of Justice,Legal Activities,null,96.58675573818871,98.96102566727231,3077434,406,87084118,38671,30,06,2,2023,2023-06-30,3,2023,90161552,39077
Bureau,Department of Health & Human Services,Health Resources and Services Admin,null,100.0,100.0,0,0,112964023,642,30,06,2,2023,2023-06-30,3,2023,112964023,642
Bureau,Department of Agriculture,Commodity Credit Corporation,null,100.0,100.0,0,0,114338049,9365,30,06,2,2023,2023-06-30,3,2023,114338049,9365
Bureau,Department of Agriculture,Rural Development,null,99.99892361692311,99.97061524334252,9088,8,844299987,27217,30,06,2,2023,2023-06-30,3,2023,844309075,27225
Bureau,Department of Defense,Consolidated Report,null,33.50882024365026,16.957753867054873,2135354213,1443770,1076130710,294827,30,06,2,2023,2023-06-30,3,2023,3211484923,1738597
Bureau,Department of Health & Human Services,Centers for Medicare & Medicaid Services,null,99.25047955823341,99.48010425716768,77592457,5984,10274687838,1145016,30,06,2,2023,2023-06-30,3,2023,10352280295,1151000
Bureau,Small Business Administration,Small Business Administration,null,100.0,100.0,0,0,17230635410,143051,30,06,2,2023,2023-06-30,3,2023,17230635410,143051
Bureau,Department of Education,Federal Student Aid,null,100.0,100.0,0,0,118194687791,20302760,30,06,2,2023,2023-06-30,3,2023,118194687791,20302760
Bureau,Social Security Administration,Social Security Administration,null,57.731384953169105,31.98333201982957,1792986202,888935,2448899178,418002,30,06,2,2023,2023-06-30,3,2023,4241885380,1306937
Bureau,Legislative Branch-CBO,Congressional Budget Office,null,0.0,0.0,0,0,0,0,30,06,2,2023,2023-06-30,3,2023,0,0
Bureau,Funds Appropriated to the President,Executive Branch,null,0.0,0.0,0,0,0,0,30,06,2,2023,2023-06-30,3,2023,0,0
Bureau,Department of Commerce,International Trade Administration,null,0.0,0.0,0,0,0,0,30,06,2,2023,2023-06-30,3,2023,0,0
Bureau,Other Agencies,U.S.  Agency of Global Media,null,0.0,0.0,0,0,0,0,30,06,2,2023,2023-06-30,3,2023,0,0
Bureau,Other Agencies,Advisory Council on Hist. Preservation,null,0.0,0.0,0,0,0,0,30,06,2,2023,2023-06-30,3,2023,0,0
Bureau,Other Agencies,Architect of the Capitol,null,0.0,0.0,0,0,0,0,30,06,2,2023,2023-06-30,3,2023,0,0
Bureau,Department of Housing and Urban Development,Government National Mortgage Association,null,0.0,0.0,0,0,0,0,30,06,2,2023,2023-06-30,3,2023,0,0
Bureau,Other Agencies/Boards/Commissions,U.S.-China Security Review Commission,null,0.0,0.0,0,0,0,0,30,06,2,2023,2023-06-30,3,2023,0,0
Bureau,Department of Health & Human Services,Administration for Community Living,null,0.0,0.0,0,0,0,0,30,06,2,2023,2023-06-30,3,2023,0,0
Bureau,Consumer Product Safety Commission,Consumer Product Safety Commission,null,100.0,100.0,0,0,531,3,30,06,2,2023,2023-06-30,3,2023,531,3
Bureau,Department of Transportation,Maritime Administration,null,100.0,100.0,0,0,61389,12,30,06,2,2023,2023-06-30,3,2023,61389,12
Bureau,Armed Forces Retirement Home,Armed Forces Retirement Home,null,90.89525113293051,97.14285714285714,7715,3,77021,102,30,06,2,2023,2023-06-30,3,2023,84736,105
Bureau,National Archives & Records Admin,Nat'l Archives & Records Administration,null,100.0,100.0,0,0,131736,113,30,06,2,2023,2023-06-30,3,2023,131736,113
Bureau,Department of Transportation,Federal Railroad Administration,null,100.0,100.0,0,0,145373,14,30,06,2,2023,2023-06-30,3,2023,145373,14
Bureau,National Aeronautics and Space Administration,National Aeronautics and Space Admin,null,100.0,100.0,0,0,1493206,123,30,06,2,2023,2023-06-30,3,2023,1493206,123
Bureau,Department of the Treasury,Financial Crimes Enforcement Network,null,100.0,100.0,0,0,1544945,3,30,06,2,2023,2023-06-30,3,2023,1544945,3
Bureau,Presidio Trust Corporation,Presidio Trust Corporation,null,100.0,100.0,0,0,1548205,61,30,06,2,2023,2023-06-30,3,2023,1548205,61
Bureau,Department of Health & Human Services,Food and Drug Administration,null,28.72118345708827,8.013575563984828,140311912,23038,56537473,2007,30,06,2,2023,2023-06-30,3,2023,196849385,25045
Bureau,Securities & Exchange Commission,SEC Enforcement,null,100.0,100.0,0,0,2539366889,1317,30,06,2,2023,2023-06-30,3,2023,2539366889,1317
Bureau,Department of the Treasury,Spec Insp Gen-Troubled Asset Rel Prog,null,100.0,100.0,0,0,3916,1,30,06,2,2023,2023-06-30,3,2023,3916,1
Bureau,Department of Commerce,General Administration,null,100.0,100.0,0,0,4660,1,30,06,2,2023,2023-06-30,3,2023,4660,1
Bureau,Department of Housing and Urban Development,Management and Administration,null,100.0,100.0,0,0,4706,1,30,06,2,2023,2023-06-30,3,2023,4706,1
Bureau,Department of Labor,Bureau of Labor Statistics,null,100.0,100.0,0,0,4781,1,30,06,2,2023,2023-06-30,3,2023,4781,1
Bureau,Other Agencies,Election Assistance Commission,null,0.0,0.0,5576,1,0,0,30,06,2,2023,2023-06-30,3,2023,5576,1
Bureau,Other Agencies,Council of Insps. Gen. of Intg. & Effy.,null,0.0,0.0,6782,5,0,0,30,06,2,2023,2023-06-30,3,2023,6782,5
Bureau,Department of the Interior,Bureau of Safety and Environmental Enf.,null,100.0,100.0,0,0,7653,3,30,06,2,2023,2023-06-30,3,2023,7653,3
Bureau,Department of Transportation,St. Lawrence Seaway Development Corp.,null,100.0,100.0,0,0,7728,2,30,06,2,2023,2023-06-30,3,2023,7728,2
Bureau,Department of Agriculture,Federal Crop Insurance Corporation,null,100.0,100.0,0,0,7857,5,30,06,2,2023,2023-06-30,3,2023,7857,5
Bureau,Department of Health & Human Services,Office of the Secretary,null,100.0,100.0,0,0,8375,7,30,06,2,2023,2023-06-30,3,2023,8375,7
Bureau,Department of Homeland Security,Federal Law Enforcement Training Ctr.,null,100.0,100.0,0,0,8562,1,30,06,2,2023,2023-06-30,3,2023,8562,1
Bureau,Other Agencies,U.S. Inst. for Env. Conflict Resolution,null,0.0,0.0,8859,2,0,0,30,06,2,2023,2023-06-30,3,2023,8859,2
Bureau,National Science Foundation,National Science Foundation,null,100.0,100.0,0,0,711137,33,30,06,2,2023,2023-06-30,3,2023,711137,33
Bureau,Department of Transportation,Federal Transit Administration,null,100.0,100.0,0,0,787343,4,30,06,2,2023,2023-06-30,3,2023,787343,4
Bureau,Department of Transportation,Office of the Inspector General,null,100.0,100.0,0,0,3288,1,30,06,2,2023,2023-06-30,3,2023,3288,1
Bureau,Environmental Protection Agency,Environmental Protection Agency,null,100.0,100.0,0,0,26318019,256,30,06,2,2023,2023-06-30,3,2023,26318019,256
Bureau,Department of Health & Human Services,National Institutes of Health,null,28.483723449789725,14.035087719298245,19042674,784,7584375,128,30,06,2,2023,2023-06-30,3,2023,26627049,912
Bureau,Department of the Interior,Office of Natural Resources Revenue,null,100.0,100.0,0,0,27597245,568,30,06,2,2023,2023-06-30,3,2023,27597245,568
Bureau,Department of Health & Human Services,Administration for Children and Families,null,100.0,100.0,0,0,37371711,1606,30,06,2,2023,2023-06-30,3,2023,37371711,1606
Bureau,Federal Communications Commission,Federal Communications Commission,null,100.0,100.0,0,0,235548812,13419,30,06,2,2023,2023-06-30,3,2023,235548812,13419
Bureau,Department of Agriculture,Farm Service Agency,null,100.0,100.0,0,0,327586870,3153,30,06,2,2023,2023-06-30,3,2023,327586870,3153
Bureau,Department of Education,Departmental Management,null,99.6181154342427,96.39376218323586,5514648,74,1438546855,1978,30,06,2,2023,2023-06-30,3,2023,1444061503,2052
Bureau,Department of Health & Human Services,Centers for Disease Control,null,2.5739024411861386,20.61855670103093,7584648,77,200379,20,30,06,2,2023,2023-06-30,3,2023,7785027,97
Agency,U.S. Tax Court,null,Non-CFO,0.0,0.0,0,0,0,0,30,09,3,2023,2023-09-30,4,2023,0,0
Agency,Selective Service System,null,Non-CFO,0.0,0.0,1301,4,0,0,30,09,3,2023,2023-09-30,4,2023,1301,4
Agency,Department of Agriculture,null,CFO,98.87202161929903,95.07167086114454,12712764,2252,1114326922,43443,30,09,3,2023,2023-09-30,4,2023,1127039686,45695
Bureau,Department of Homeland Security,Citizenship and Immigration Services,null,100.0,100.0,0,0,1159268,1395,30,09,3,2023,2023-09-30,4,2023,1159268,1395
Bureau,Department of Commerce,International Trade Administration,null,0.0,0.0,0,0,0,0,30,09,3,2023,2023-09-30,4,2023,0,0
Bureau,Department of Labor,Departmental Management,null,0.0,0.0,0,0,0,0,30,09,3,2023,2023-09-30,4,2023,0,0
Bureau,Department of the Treasury,U.S. Mint,null,14.090626203953413,86.36363636363636,144942,3,23773,19,30,09,3,2023,2023-09-30,4,2023,168715,22
Agency,Environmental Protection Agency,null,CFO,99.9863087338638,99.59183673469387,3858,1,28174690,244,30,09,3,2023,2023-09-30,4,2023,28178548,245
Agency,Office of Special Counsel,null,Non-CFO,0.0,0.0,0,0,0,0,30,09,3,2023,2023-09-30,4,2023,0,0
Agency,National Labor Relations Board,null,Non-CFO,0.0,0.0,0,0,0,0,30,09,3,2023,2023-09-30,4,2023,0,0
Bureau,Department of Transportation,St. Lawrence Seaway Development Corp.,null,100.0,100.0,0,0,7728,2,30,09,3,2023,2023-09-30,4,2023,7728,2
Bureau,Other Agencies/Boards/Commissions,U.S. Comm. on Int. Religious Freedom,null,0.0,0.0,1024,1,0,0,30,09,3,2023,2023-09-30,4,2023,1024,1
Bureau,Selective Service System,Selective Service System,null,0.0,0.0,1301,4,0,0,30,09,3,2023,2023-09-30,4,2023,1301,4
Bureau,Department of Commerce,General Administration,null,100.0,100.0,0,0,4660,1,30,09,3,2023,2023-09-30,4,2023,4660,1
Bureau,Department of Labor,Bureau of Labor Statistics,null,100.0,100.0,0,0,4782,1,30,09,3,2023,2023-09-30,4,2023,4782,1
Bureau,Other Agencies,Election Assistance Commission,null,0.0,0.0,5576,1,0,0,30,09,3,2023,2023-09-30,4,2023,5576,1
Bureau,Department of the Interior,Bureau of Safety and Environmental Enf.,null,100.0,100.0,0,0,7451,2,30,09,3,2023,2023-09-30,4,2023,7451,2
Bureau,Department of the Interior,Office of the Secretary,null,41.21199051110632,57.142857142857146,5452,6,3822,8,30,09,3,2023,2023-09-30,4,2023,9274,14
Bureau,Federal Deposit Insurance Corporation,Federal Deposit Insurance Corporation,null,0.0,0.0,0,0,0,0,30,09,3,2023,2023-09-30,4,2023,0,0
Bureau,Other Agencies/Boards/Commissions,U.S.-China Security Review Commission,null,0.0,0.0,0,0,0,0,30,09,3,2023,2023-09-30,4,2023,0,0
Bureau,Legis Branch-Library of Congress,Library of Congress,null,0.0,0.0,0,0,0,0,30,09,3,2023,2023-09-30,4,2023,0,0
Bureau,Department of Commerce,Minority Business Development Agency,null,0.0,0.0,0,0,0,0,30,09,3,2023,2023-09-30,4,2023,0,0
Bureau,Department of the Treasury,Treasury Franchise Fund,null,0.0,0.0,0,0,0,0,30,09,3,2023,2023-09-30,4,2023,0,0
Bureau,Other Agencies,Federal Housing Finance Agency OIG,null,0.0,0.0,0,0,0,0,30,09,3,2023,2023-09-30,4,2023,0,0
Bureau,Office of Government Ethics,Office of Government Ethics,null,0.0,0.0,0,0,0,0,30,09,3,2023,2023-09-30,4,2023,0,0
Bureau,Other Agencies,Denali Commission,null,0.0,0.0,0,0,0,0,30,09,3,2023,2023-09-30,4,2023,0,0
Bureau,Other Agencies,Federal Housing Finance Agency,null,0.0,0.0,0,0,0,0,30,09,3,2023,2023-09-30,4,2023,0,0
Bureau,Other Agencies,Archit.&Trans. Barriers Compliance Bd,null,0.0,0.0,0,0,0,0,30,09,3,2023,2023-09-30,4,2023,0,0
Bureau,Department of Commerce,National Technical Information Service,null,0.0,0.0,0,0,0,0,30,09,3,2023,2023-09-30,4,2023,0,0
Bureau,Other Agencies,National Council on Disability,null,0.0,0.0,0,0,0,0,30,09,3,2023,2023-09-30,4,2023,0,0
Bureau,Other Agencies,Commission On Fine Arts,null,0.0,0.0,0,0,0,0,30,09,3,2023,2023-09-30,4,2023,0,0
Bureau,Other Agencies,National Capital Planning Commission,null,0.0,0.0,0,0,0,0,30,09,3,2023,2023-09-30,4,2023,0,0
Bureau,Federal Mediation/Conciliation Service,Federal Mediation/Conciliation Service,null,0.0,0.0,0,0,0,0,30,09,3,2023,2023-09-30,4,2023,0,0
Bureau,Department of Justice,U.S. Marshals Service,null,0.0,0.0,0,0,0,0,30,09,3,2023,2023-09-30,4,2023,0,0
Bureau,Farm Credit Administration,Farm Credit System Insurance Corporation,null,0.0,0.0,0,0,0,0,30,09,3,2023,2023-09-30,4,2023,0,0
Bureau,Department of Homeland Security,Science and Technology,null,0.0,0.0,0,0,0,0,30,09,3,2023,2023-09-30,4,2023,0,0
Bureau,Department of Homeland Security,U.S. Secret Service,null,0.0,0.0,0,0,0,0,30,09,3,2023,2023-09-30,4,2023,0,0
Bureau,Tennessee Valley Authority,Tennessee Valley Authority,null,0.0,0.0,0,0,0,0,30,09,3,2023,2023-09-30,4,2023,0,0
Bureau,National Labor Relations Board,National Labor Relations Board,null,0.0,0.0,0,0,0,0,30,09,3,2023,2023-09-30,4,2023,0,0
Bureau,Department of Labor,Employment Standards Administration,null,89.46202441036674,59.12027833001988,7073798,1645,60052928,2379,30,09,3,2023,2023-09-30,4,2023,67126726,4024
Bureau,Legislative Branch-GPO,Government Publishing Office,null,0.0,0.0,0,0,0,0,30,09,3,2023,2023-09-30,4,2023,0,0
Bureau,Other Agencies,Surface Transportation Board,null,0.0,0.0,0,0,0,0,30,09,3,2023,2023-09-30,4,2023,0,0
Bureau,Other Agencies,Advisory Council on Hist. Preservation,null,0.0,0.0,0,0,0,0,30,09,3,2023,2023-09-30,4,2023,0,0
Bureau,Other Agencies,Comm. for Purchase from Blind/Handic.,null,0.0,0.0,0,0,0,0,30,09,3,2023,2023-09-30,4,2023,0,0
Bureau,Department of Health & Human Services,Administration for Community Living,null,0.0,0.0,0,0,0,0,30,09,3,2023,2023-09-30,4,2023,0,0
Bureau,Department of the Treasury,Office of the Secretary,null,0.0,0.0,0,0,0,0,30,09,3,2023,2023-09-30,4,2023,0,0
Bureau,Federal Labor Relations Authority,Federal Labor Relations Authority,null,0.0,0.0,0,0,0,0,30,09,3,2023,2023-09-30,4,2023,0,0
Bureau,Other Agencies,John C. Stennis,null,0.0,0.0,1467,2,0,0,30,09,3,2023,2023-09-30,4,2023,1467,2
Bureau,Department of the Interior,Geological Survey,null,100.0,100.0,0,0,143786,406,30,09,3,2023,2023-09-30,4,2023,143786,406
Bureau,Department of Commerce,Patent and Trademark Office,null,100.0,100.0,0,0,473007,702,30,09,3,2023,2023-09-30,4,2023,473007,702
Agency,National Science Foundation,null,CFO,100.0,100.0,0,0,710131,30,30,09,3,2023,2023-09-30,4,2023,710131,30
Agency,Department of State,null,CFO,98.95576782428607,99.20015235193297,236839,168,22443845,20836,30,09,3,2023,2023-09-30,4,2023,22680684,21004
Agency,Department of the Treasury,null,CFO,99.38128354197774,99.71946482520501,289650,13,46525009,4621,30,09,3,2023,2023-09-30,4,2023,46814659,4634
Agency,Legislative Branch-CBO,null,Non-CFO,0.0,0.0,0,0,0,0,30,09,3,2023,2023-09-30,4,2023,0,0
Agency,Other Agencies,null,Non-CFO,62.32259241662925,8.235294117647058,318009,78,526022,7,30,09,3,2023,2023-09-30,4,2023,844031,85
Agency,The Judiciary,null,Non-CFO,98.85638981559083,58.63192182410423,11967,127,1034456,180,30,09,3,2023,2023-09-30,4,2023,1046423,307
Agency,Funds Appropriated to the President,null,Non-CFO,0.0,0.0,1236060,7,0,0,30,09,3,2023,2023-09-30,4,2023,1236060,7
Bureau,Department of Energy,Energy Consolidated Reports,null,100.0,100.0,0,0,12701726,73,30,09,3,2023,2023-09-30,4,2023,12701726,73
Bureau,Department of the Treasury,Bureau of the Fiscal Service,null,100.0,100.0,0,0,13423814,3179,30,09,3,2023,2023-09-30,4,2023,13423814,3179
Bureau,Department of Homeland Security,Immigration and Customs Enforcement,null,100.0,100.0,0,0,16713418,658,30,09,3,2023,2023-09-30,4,2023,16713418,658
Bureau,Department of Health & Human Services,National Institutes of Health,null,28.872175295958204,11.16751269035533,19129598,1050,7765078,132,30,09,3,2023,2023-09-30,4,2023,26894676,1182
Bureau,Environmental Protection Agency,Environmental Protection Agency,null,99.9863087338638,99.59183673469387,3858,1,28174690,244,30,09,3,2023,2023-09-30,4,2023,28178548,245
Bureau,Agency for International Development,Agency for International Development,null,99.99903918022434,98.18181818181819,273,1,28412964,54,30,09,3,2023,2023-09-30,4,2023,28413237,55
Bureau,Department of the Interior,Bureau of Indian Affairs,null,99.9739164401787,99.6927241467608,7625,84,29225348,27253,30,09,3,2023,2023-09-30,4,2023,29232973,27337
Bureau,Department of Labor,Occupational Safety and Health Admin,null,94.82156159513684,79.14452037458871,2912561,824,53331441,3127,30,09,3,2023,2023-09-30,4,2023,56244002,3951
Bureau,Department of Housing and Urban Development,Housing Programs,null,99.9680103341373,99.8819362455726,20275,3,63359568,2538,30,09,3,2023,2023-09-30,4,2023,63379843,2541
Bureau,Department of Transportation,Federal Motor Carrier Safety Admin,null,100.0,100.0,0,0,75263151,8371,30,09,3,2023,2023-09-30,4,2023,75263151,8371
Bureau,US International Development Fin. Corp.,US International Development Fin. Corp.,null,100.0,100.0,0,0,76307492,11,30,09,3,2023,2023-09-30,4,2023,76307492,11
Agency,Occupational Safety & Health Rev Comm,null,Non-CFO,0.0,0.0,0,0,0,0,30,09,3,2023,2023-09-30,4,2023,0,0
Agency,National Foundation  Arts & Humanities,null,Non-CFO,0.0,0.0,0,0,0,0,30,09,3,2023,2023-09-30,4,2023,0,0
Agency,Presidio Trust Corporation,null,Non-CFO,100.0,100.0,0,0,1324482,60,30,09,3,2023,2023-09-30,4,2023,1324482,60
Agency,Federal Election Commission,null,Non-CFO,100.0,100.0,0,0,2344754,327,30,09,3,2023,2023-09-30,4,2023,2344754,327
Agency,Corp. for National and Community Service,null,Non-CFO,88.45922304639586,44.61077844311377,470060,185,3602976,149,30,09,3,2023,2023-09-30,4,2023,4073036,334
Agency,Pension Benefit Guaranty Corp,null,Non-CFO,100.0,100.0,0,0,4645894,1683,30,09,3,2023,2023-09-30,4,2023,4645894,1683
Agency,Railroad Retirement Board,null,Non-CFO,100.0,100.0,0,0,21719276,4441,30,09,3,2023,2023-09-30,4,2023,21719276,4441
Agency,US International Development Fin. Corp.,null,Non-CFO,100.0,100.0,0,0,76307492,11,30,09,3,2023,2023-09-30,4,2023,76307492,11
Agency,U.S. Postal Service,null,Non-CFO,83.73613761177076,82.53043600454784,13361010,13675,68790509,64604,30,09,3,2023,2023-09-30,4,2023,82151519,78279
Agency,Federal Communications Commission,null,Non-CFO,100.0,100.0,0,0,249427890,12165,30,09,3,2023,2023-09-30,4,2023,249427890,12165
Agency,Commodity Futures Trading Commission,null,Non-CFO,100.0,100.0,0,0,629802832,360,30,09,3,2023,2023-09-30,4,2023,629802832,360
Agency,Securities & Exchange Commission,null,Non-CFO,100.0,100.0,0,0,2742794931,1526,30,09,3,2023,2023-09-30,4,2023,2742794931,1526
Bureau,Other Agencies/Boards/Commissions,Nuclear Waste Technical Review Board,null,0.0,0.0,0,0,0,0,30,09,3,2023,2023-09-30,4,2023,0,0
Bureau,Department of the Treasury,U.S. Treasury IG Office,null,0.0,0.0,0,0,0,0,30,09,3,2023,2023-09-30,4,2023,0,0
Bureau,Department of the Treasury,Treasury Forfeiture Fund,null,0.0,0.0,0,0,0,0,30,09,3,2023,2023-09-30,4,2023,0,0
Bureau,Legislative Branch-CBO,Congressional Budget Office,null,0.0,0.0,0,0,0,0,30,09,3,2023,2023-09-30,4,2023,0,0
Bureau,Funds Appropriated to the President,Executive Branch,null,0.0,0.0,0,0,0,0,30,09,3,2023,2023-09-30,4,2023,0,0
Bureau,Smithsonian Institution,Administrative Conference of the US,null,0.0,0.0,0,0,0,0,30,09,3,2023,2023-09-30,4,2023,0,0
Bureau,U.S. Court of Appeals / Veterans Claims,U.S. Court of Appeals / Veterans Claims,null,0.0,0.0,0,0,0,0,30,09,3,2023,2023-09-30,4,2023,0,0
Bureau,Other Agencies,U.S.  Agency of Global Media,null,0.0,0.0,0,0,0,0,30,09,3,2023,2023-09-30,4,2023,0,0
Bureau,Department of Education,Federal Student Aid,null,97.58064171719742,96.25617072447615,2830558563,766500,114165695490,19707190,30,09,3,2023,2023-09-30,4,2023,116996254053,20473690
Bureau,Other Agencies,Defense Nuclear Facilities Safety Board,null,0.0,0.0,0,0,0,0,30,09,3,2023,2023-09-30,4,2023,0,0
Bureau,Department of Health & Human Services,Agency for Healthcare Research & Quality,null,100.0,100.0,0,0,99,1,30,09,3,2023,2023-09-30,4,2023,99,1
Bureau,Department of Homeland Security,Office of the Inspector General DHS,null,100.0,100.0,0,0,100,1,30,09,3,2023,2023-09-30,4,2023,100,1
Bureau,Department of Housing and Urban Development,Public and Indian Housing Programs,null,100.0,100.0,0,0,253,2,30,09,3,2023,2023-09-30,4,2023,253,2
Agency,Neighborhood Reinvestment Corporation,null,Non-CFO,0.0,0.0,0,0,0,0,30,09,3,2023,2023-09-30,4,2023,0,0
Agency,American Battle Monuments Commission,null,Non-CFO,0.0,0.0,0,0,0,0,30,09,3,2023,2023-09-30,4,2023,0,0
Agency,Legislative Branch-GPO,null,Non-CFO,0.0,0.0,0,0,0,0,30,09,3,2023,2023-09-30,4,2023,0,0
Agency,Federal Deposit Insurance Corporation,null,Non-CFO,0.0,0.0,0,0,0,0,30,09,3,2023,2023-09-30,4,2023,0,0
Agency,Merit Systems Protection Board,null,Non-CFO,100.0,100.0,0,0,144,1,30,09,3,2023,2023-09-30,4,2023,144,1
Agency,Consumer Product Safety Commission,null,Non-CFO,100.0,100.0,0,0,468,3,30,09,3,2023,2023-09-30,4,2023,468,3
Agency,Farm Credit Administration,null,Non-CFO,100.0,100.0,0,0,630,1,30,09,3,2023,2023-09-30,4,2023,630,1
Bureau,Farm Credit Administration,Farm Credit Administration,null,100.0,100.0,0,0,630,1,30,09,3,2023,2023-09-30,4,2023,630,1
Bureau,Smithsonian Institution,Smithsonian Institution,null,0.0,0.0,783,12,0,0,30,09,3,2023,2023-09-30,4,2023,783,12
Bureau,Department of the Treasury,Pandemic Receivables,null,100.0,100.0,0,0,4099198,9,30,09,3,2023,2023-09-30,4,2023,4099198,9
Bureau,Department of the Treasury,Tobacco Tax and Trade,null,100.0,100.0,0,0,1000,1,30,09,3,2023,2023-09-30,4,2023,1000,1
Agency,Smithsonian Institution,null,Non-CFO,0.0,0.0,783,12,0,0,30,09,3,2023,2023-09-30,4,2023,783,12
Agency,Other Agencies/Boards/Commissions,null,Non-CFO,0.0,0.0,1024,1,0,0,30,09,3,2023,2023-09-30,4,2023,1024,1
Agency,National Credit Union Administration,null,Non-CFO,100.0,100.0,0,0,1373,2,30,09,3,2023,2023-09-30,4,2023,1373,2
Agency,Equal Employment Opportunity Commission,null,Non-CFO,100.0,100.0,0,0,15652,15,30,09,3,2023,2023-09-30,4,2023,15652,15
Agency,Legislative Branch-GAO,null,Non-CFO,100.0,100.0,0,0,24441,9,30,09,3,2023,2023-09-30,4,2023,24441,9
Agency,Armed Forces Retirement Home,null,Non-CFO,69.89744985933388,99.02912621359224,33170,1,77020,102,30,09,3,2023,2023-09-30,4,2023,110190,103
Agency,National Archives & Records Admin,null,Non-CFO,100.0,100.0,0,0,126935,112,30,09,3,2023,2023-09-30,4,2023,126935,112
Agency,Legislative Branch - U.S. House/Senate,null,Non-CFO,0.0,0.0,329537,226,0,0,30,09,3,2023,2023-09-30,4,2023,329537,226
Bureau,Other Agencies,Chemical Safety Board,null,100.0,100.0,0,0,14952,1,30,09,3,2023,2023-09-30,4,2023,14952,1
Bureau,Department of Agriculture,Federal Crop Insurance Corporation,null,100.0,100.0,0,0,15141,4,30,09,3,2023,2023-09-30,4,2023,15141,4
Bureau,Equal Employment Opportunity Commission,Equal Employment Opportunity Commission,null,100.0,100.0,0,0,15652,15,30,09,3,2023,2023-09-30,4,2023,15652,15
Bureau,Department of Justice,Bureau of ATF and Explosives,null,100.0,100.0,0,0,19881,1,30,09,3,2023,2023-09-30,4,2023,19881,1
Bureau,Legislative Branch-GAO,Government Accountability Office,null,100.0,100.0,0,0,24441,9,30,09,3,2023,2023-09-30,4,2023,24441,9
Bureau,Smithsonian Institution,National Gallery of Art,null,0.0,0.0,0,0,0,0,30,09,3,2023,2023-09-30,4,2023,0,0
Bureau,Funds Appropriated to the President,Defense Security Assistance Agency,null,0.0,0.0,0,0,0,0,30,09,3,2023,2023-09-30,4,2023,0,0
Bureau,Department of Commerce,Office of the Inspector General,null,0.0,0.0,0,0,0,0,30,09,3,2023,2023-09-30,4,2023,0,0
Bureau,Other Agencies,Millennium Challenge Corporation,null,0.0,0.0,0,0,0,0,30,09,3,2023,2023-09-30,4,2023,0,0
Bureau,Other Agencies,U.S. Institute of Peace,null,0.0,0.0,0,0,0,0,30,09,3,2023,2023-09-30,4,2023,0,0
Bureau,Department of Justice,General Administration,null,0.0,0.0,0,0,0,0,30,09,3,2023,2023-09-30,4,2023,0,0
Bureau,Neighborhood Reinvestment Corporation,Neighborhood Reinvestment Corporation,null,0.0,0.0,0,0,0,0,30,09,3,2023,2023-09-30,4,2023,0,0
Bureau,Department of State,International Commissions,null,0.0,0.0,0,0,0,0,30,09,3,2023,2023-09-30,4,2023,0,0
Bureau,Department of the Treasury,Office of Sec International Affairs,null,0.0,0.0,0,0,0,0,30,09,3,2023,2023-09-30,4,2023,0,0
Bureau,Other Agencies,James Madison Memorial Fellowship,null,0.0,0.0,201616,25,0,0,30,09,3,2023,2023-09-30,4,2023,201616,25
Bureau,Securities & Exchange Commission,Securities and Exchange Commission,null,100.0,100.0,0,0,258690,46,30,09,3,2023,2023-09-30,4,2023,258690,46
Bureau,Department of Transportation,Maritime Administration,null,100.0,100.0,0,0,295449,15,30,09,3,2023,2023-09-30,4,2023,295449,15
Bureau,Department of Commerce,Nat'l Telecomm & Information Admin.,null,100.0,100.0,0,0,296093,1,30,09,3,2023,2023-09-30,4,2023,296093,1
Bureau,Legislative Branch - U.S. House/Senate,U.S. House of Representatives,null,0.0,0.0,329537,226,0,0,30,09,3,2023,2023-09-30,4,2023,329537,226
Bureau,Department of Justice,Drug Enforcement Administration,null,100.0,100.0,0,0,343675,16,30,09,3,2023,2023-09-30,4,2023,343675,16
Bureau,Department of Veterans Affairs,Housing Credit Assistance,null,0.16985234743031877,8.333333333333334,394378,11,671,1,30,09,3,2023,2023-09-30,4,2023,395049,12
Bureau,Federal Maritime Commission,Salaries and Expenses,null,100.0,100.0,0,0,397569,6,30,09,3,2023,2023-09-30,4,2023,397569,6
Bureau,Department of Justice,Federal Bureau of Investigation,null,100.0,100.0,0,0,428276,104,30,09,3,2023,2023-09-30,4,2023,428276,104
Bureau,Other Agencies,Consumer Financial Protection Bureau,null,99.14140943867653,46.15384615384615,4426,7,511070,6,30,09,3,2023,2023-09-30,4,2023,515496,13
Bureau,National Science Foundation,National Science Foundation,null,100.0,100.0,0,0,710131,30,30,09,3,2023,2023-09-30,4,2023,710131,30
Bureau,Department of Transportation,Federal Transit Administration,null,100.0,100.0,0,0,784983,3,30,09,3,2023,2023-09-30,4,2023,784983,3
Bureau,Department of the Interior,Fish and Wildlife Service,null,100.0,100.0,0,0,830472,106,30,09,3,2023,2023-09-30,4,2023,830472,106
Agency,National Aeronautics and Space Administration,null,CFO,100.0,100.0,0,0,1047677,123,30,09,3,2023,2023-09-30,4,2023,1047677,123
Agency,Nuclear Regulatory Commission,null,CFO,100.0,100.0,0,0,3168818,358,30,09,3,2023,2023-09-30,4,2023,3168818,358
Agency,Department of Energy,null,CFO,100.0,100.0,0,0,13760196,101,30,09,3,2023,2023-09-30,4,2023,13760196,101
Agency,Office of Personnel Management,null,CFO,100.0,100.0,0,0,20899877,1153,30,09,3,2023,2023-09-30,4,2023,20899877,1153
Agency,Agency for International Development,null,CFO,99.99903918022434,98.18181818181819,273,1,28412964,54,30,09,3,2023,2023-09-30,4,2023,28413237,55
Agency,Department of Housing and Urban Development,null,CFO,99.74250374517507,99.84295249312918,163860,4,63472017,2543,30,09,3,2023,2023-09-30,4,2023,63635877,2547
Agency,Department of Commerce,null,CFO,100.0,100.0,0,0,76772661,11840,30,09,3,2023,2023-09-30,4,2023,76772661,11840
Agency,Department of Transportation,null,CFO,100.0,100.0,0,0,82954724,9027,30,09,3,2023,2023-09-30,4,2023,82954724,9027
Agency,Department of the Interior,null,CFO,99.98523080684508,99.7114644780713,13077,90,88529336,31102,30,09,3,2023,2023-09-30,4,2023,88542413,31192
Agency,Department of Justice,null,CFO,98.6437302758603,98.87424559674837,1617766,457,117662785,40138,30,09,3,2023,2023-09-30,4,2023,119280551,40595
Agency,Department of Labor,null,CFO,91.97041103240694,76.45299490744483,12494878,2913,143115553,9458,30,09,3,2023,2023-09-30,4,2023,155610431,12371
Agency,Department of Veterans Affairs,null,CFO,98.93178511830669,99.87703444820023,2657022,4341,246077764,3525916,30,09,3,2023,2023-09-30,4,2023,248734786,3530257
Bureau,Department of Commerce,Nat'l Institute of Standards& Technology,null,100.0,100.0,0,0,965081,2,30,09,3,2023,2023-09-30,4,2023,965081,2
Bureau,The Judiciary,Administrative Office of the U.S. Courts,null,98.85638981559083,58.63192182410423,11967,127,1034456,180,30,09,3,2023,2023-09-30,4,2023,1046423,307
Bureau,National Aeronautics and Space Administration,National Aeronautics and Space Admin,null,100.0,100.0,0,0,1047677,123,30,09,3,2023,2023-09-30,4,2023,1047677,123
Bureau,Department of the Treasury,Interest on Tax/Deposit of Earnings,null,0.0,0.0,0,0,0,0,30,09,3,2023,2023-09-30,4,2023,0,0
Bureau,Smithsonian Institution,JFK Center for the Performing Arts,null,0.0,0.0,0,0,0,0,30,09,3,2023,2023-09-30,4,2023,0,0
Bureau,Office of Compliance,Office of Compliance,null,0.0,0.0,0,0,0,0,30,09,3,2023,2023-09-30,4,2023,0,0
Bureau,Funds Appropriated to the President,Inter-American Foundation,null,0.0,0.0,0,0,0,0,30,09,3,2023,2023-09-30,4,2023,0,0
Bureau,Department of Commerce,Economic and Statistical Analysis,null,0.0,0.0,0,0,0,0,30,09,3,2023,2023-09-30,4,2023,0,0
Bureau,Other Agencies,District of Columbia Government,null,0.0,0.0,0,0,0,0,30,09,3,2023,2023-09-30,4,2023,0,0
Bureau,Other Agencies,Morris K. Udall Scholarship,null,0.0,0.0,0,0,0,0,30,09,3,2023,2023-09-30,4,2023,0,0
Bureau,Occupational Safety & Health Rev Comm,Occupational Safety & Health Rev Comm,null,0.0,0.0,0,0,0,0,30,09,3,2023,2023-09-30,4,2023,0,0
Bureau,Department of Homeland Security,Info Analysis Infrastructure Prot-NPPD,null,0.0,0.0,0,0,0,0,30,09,3,2023,2023-09-30,4,2023,0,0
Bureau,National Foundation  Arts & Humanities,National Endowment for the Arts,null,0.0,0.0,0,0,0,0,30,09,3,2023,2023-09-30,4,2023,0,0
Bureau,Department of Health & Human Services,Program Support Center,null,100.0,100.0,0,0,6482841,258,30,09,3,2023,2023-09-30,4,2023,6482841,258
Bureau,Department of the Interior,Bureau of Reclamation,null,100.0,100.0,0,0,7392883,65,30,09,3,2023,2023-09-30,4,2023,7392883,65
Bureau,Department of the Interior,Office of Surface Mining,null,100.0,100.0,0,0,8373471,379,30,09,3,2023,2023-09-30,4,2023,8373471,379
Bureau,Department of Health & Human Services,Centers for Disease Control,null,10.703052637902589,18.91891891891892,7892967,90,946044,21,30,09,3,2023,2023-09-30,4,2023,8839011,111
Agency,General Services Administration,null,CFO,0.0,0.0,1259836,51,0,0,30,09,3,2023,2023-09-30,4,2023,1259836,51
Agency,Department of Homeland Security,null,CFO,93.1537835664913,71.4816874000973,19318679,24621,262861693,61713,30,09,3,2023,2023-09-30,4,2023,282180372,86334
Agency,Department of Defense,null,CFO,33.32431875779446,17.563244256048627,2210869499,1427263,1104986384,304080,30,09,3,2023,2023-09-30,4,2023,3315855883,1731343
Agency,Social Security Administration,null,CFO,56.94592081586121,31.48006826919842,1825121278,896079,2414015437,411685,30,09,3,2023,2023-09-30,4,2023,4239136715,1307764
Agency,Department of Health & Human Services,null,CFO,97.37138243367285,97.36185866736737,290742663,31124,10769925375,1148646,30,09,3,2023,2023-09-30,4,2023,11060668038,1179770
Agency,Small Business Administration,null,CFO,100.0,100.0,0,0,18648730593,148450,30,09,3,2023,2023-09-30,4,2023,18648730593,148450
Agency,Department of Education,null,CFO,97.60601477907622,96.25625191995785,2835779848,766559,115618579152,19709151,30,09,3,2023,2023-09-30,4,2023,118454359000,20475710
Agency,Export - Import  Bank,null,Non-CFO,0.0,0.0,0,0,0,0,30,09,3,2023,2023-09-30,4,2023,0,0
Agency,Legis Branch-Library of Congress,null,Non-CFO,0.0,0.0,0,0,0,0,30,09,3,2023,2023-09-30,4,2023,0,0
Agency,Federal Labor Relations Authority,null,Non-CFO,0.0,0.0,0,0,0,0,30,09,3,2023,2023-09-30,4,2023,0,0
Agency,Tennessee Valley Authority,null,Non-CFO,0.0,0.0,0,0,0,0,30,09,3,2023,2023-09-30,4,2023,0,0
Agency,Federal Maritime Commission,null,Non-CFO,100.0,100.0,0,0,397569,6,30,09,3,2023,2023-09-30,4,2023,397569,6
Bureau,Legislative Branch-Office of Tech.,Open World Leadership,null,0.0,0.0,0,0,0,0,30,09,3,2023,2023-09-30,4,2023,0,0
Bureau,Other Agencies,Federal Mine Safety & Health Review Comm,null,0.0,0.0,0,0,0,0,30,09,3,2023,2023-09-30,4,2023,0,0
Bureau,Department of Housing and Urban Development,"Policy, Development and Research",null,0.0,0.0,0,0,0,0,30,09,3,2023,2023-09-30,4,2023,0,0
Bureau,American Battle Monuments Commission,American Battle Monuments Commission,null,0.0,0.0,0,0,0,0,30,09,3,2023,2023-09-30,4,2023,0,0
Agency,Federal Mediation/Conciliation Service,null,Non-CFO,0.0,0.0,0,0,0,0,30,09,3,2023,2023-09-30,4,2023,0,0
Agency,Office of Compliance,null,Non-CFO,0.0,0.0,0,0,0,0,30,09,3,2023,2023-09-30,4,2023,0,0
Agency,Office of Government Ethics,null,Non-CFO,0.0,0.0,0,0,0,0,30,09,3,2023,2023-09-30,4,2023,0,0
Bureau,Office of Special Counsel,Office of Special Counsel,null,0.0,0.0,0,0,0,0,30,09,3,2023,2023-09-30,4,2023,0,0
Bureau,Other Agencies,U.S. Inst. for Env. Conflict Resolution,null,0.0,0.0,8859,2,0,0,30,09,3,2023,2023-09-30,4,2023,8859,2
Bureau,Department of Transportation,Research Innovative Technology Admin,null,100.0,100.0,0,0,26898,7,30,09,3,2023,2023-09-30,4,2023,26898,7
Bureau,Department of Veterans Affairs,Veterans Benefits,null,0.0,0.0,1224253,1627,0,0,30,09,3,2023,2023-09-30,4,2023,1224253,1627
Bureau,Department of Commerce,Bureau of the Census,null,100.0,100.0,0,0,2297697,9831,30,09,3,2023,2023-09-30,4,2023,2297697,9831
Bureau,Federal Election Commission,Federal Election Commission,null,100.0,100.0,0,0,2344754,327,30,09,3,2023,2023-09-30,4,2023,2344754,327
Bureau,Department of Veterans Affairs,Administration and Cemeteries,null,88.38836902014489,49.171270718232044,347469,368,2644953,356,30,09,3,2023,2023-09-30,4,2023,2992422,724
Bureau,Nuclear Regulatory Commission,Nuclear Regulatory Commission,null,100.0,100.0,0,0,3168818,358,30,09,3,2023,2023-09-30,4,2023,3168818,358
Bureau,Department of Health & Human Services,Indian Health Services,null,100.0,100.0,0,0,81429057,4151,30,09,3,2023,2023-09-30,4,2023,81429057,4151
Bureau,U.S. Postal Service,U.S. Postal Service,null,83.73613761177076,82.53043600454784,13361010,13675,68790509,64604,30,09,3,2023,2023-09-30,4,2023,82151519,78279
Bureau,Department of Agriculture,Farm Service Agency,null,100.0,100.0,0,0,85337188,1667,30,09,3,2023,2023-09-30,4,2023,85337188,1667
Bureau,Department of Justice,Legal Activities,null,98.32971002159758,98.94975655764868,1502517,412,88452941,38817,30,09,3,2023,2023-09-30,4,2023,89955458,39229
Bureau,Department of Health & Human Services,Health Resources and Services Admin,null,100.0,100.0,0,0,123070576,1665,30,09,3,2023,2023-09-30,4,2023,123070576,1665
Bureau,Department of Agriculture,Commodity Credit Corporation,null,100.0,100.0,0,0,123357004,9445,30,09,3,2023,2023-09-30,4,2023,123357004,9445
Bureau,Securities & Exchange Commission,SEC Enforcement,null,100.0,100.0,0,0,2742536241,1480,30,09,3,2023,2023-09-30,4,2023,2742536241,1480
Bureau,Other Agencies,Privacy & Civil Liberties Oversight Bd,null,0.0,0.0,0,0,0,0,30,09,3,2023,2023-09-30,4,2023,0,0
Bureau,Other Agencies,Delta Regional Authority,null,0.0,0.0,0,0,0,0,30,09,3,2023,2023-09-30,4,2023,0,0
Bureau,Other Agencies,National Mediation Board,null,0.0,0.0,0,0,0,0,30,09,3,2023,2023-09-30,4,2023,0,0
Bureau,Legislative Branch-Office of Tech.,Medicaid & CHIP Payment & Access Comm.,null,0.0,0.0,0,0,0,0,30,09,3,2023,2023-09-30,4,2023,0,0
Bureau,Other Agencies/Boards/Commissions,Medicare Payment Advisory Commission,null,0.0,0.0,0,0,0,0,30,09,3,2023,2023-09-30,4,2023,0,0
Bureau,Department of the Treasury,International Monetary Funds,null,0.0,0.0,0,0,0,0,30,09,3,2023,2023-09-30,4,2023,0,0
Bureau,Department of Education,Office of Postsecondary Education,null,0.0,0.0,0,0,0,0,30,09,3,2023,2023-09-30,4,2023,0,0
Bureau,Export - Import  Bank,Export-Import Bank,null,0.0,0.0,0,0,0,0,30,09,3,2023,2023-09-30,4,2023,0,0
Bureau,National Foundation  Arts & Humanities,National Endowment for the Humanities,null,0.0,0.0,0,0,0,0,30,09,3,2023,2023-09-30,4,2023,0,0
Bureau,Department of Commerce,Bureau of Industry and Security,null,100.0,100.0,0,0,37546041,27,30,09,3,2023,2023-09-30,4,2023,37546041,27
Bureau,Department of Health & Human Services,Office of the Secretary,null,100.0,100.0,0,0,40342364,999,30,09,3,2023,2023-09-30,4,2023,40342364,999
Bureau,Department of Health & Human Services,Administration for Children and Families,null,100.0,100.0,0,0,42030661,1710,30,09,3,2023,2023-09-30,4,2023,42030661,1710
Bureau,Department of Agriculture,Forest Service,null,93.75631316391538,62.46290801186944,4691050,253,70441642,421,30,09,3,2023,2023-09-30,4,2023,75132692,674
Agency,Federal Trade Commission,null,Non-CFO,100.0,100.0,0,0,380675784,56,30,09,3,2023,2023-09-30,4,2023,380675784,56
Bureau,Funds Appropriated to the President,Peace Corps,null,0.0,0.0,0,0,0,0,30,09,3,2023,2023-09-30,4,2023,0,0
Bureau,U.S. Tax Court,U.S. Tax Court,null,0.0,0.0,0,0,0,0,30,09,3,2023,2023-09-30,4,2023,0,0
Bureau,Funds Appropriated to the President,African Development Foundation,null,0.0,0.0,0,0,0,0,30,09,3,2023,2023-09-30,4,2023,0,0
Bureau,Department of Homeland Security,Office of Biometric Identity Management,null,0.0,0.0,0,0,0,0,30,09,3,2023,2023-09-30,4,2023,0,0
Bureau,Other Agencies,Gulf Coast Ecosystem Restoration Council,null,0.0,0.0,0,0,0,0,30,09,3,2023,2023-09-30,4,2023,0,0
Bureau,Other Agencies,U.S. Holocaust Memorial Council,null,0.0,0.0,0,0,0,0,30,09,3,2023,2023-09-30,4,2023,0,0
Bureau,Department of Homeland Security,Management Headquarters,null,0.0,0.0,0,0,0,0,30,09,3,2023,2023-09-30,4,2023,0,0
Bureau,Merit Systems Protection Board,Merit Systems Protection Board,null,100.0,100.0,0,0,144,1,30,09,3,2023,2023-09-30,4,2023,144,1
Bureau,Other Agencies,National Transportation Safety Board,null,0.0,0.0,428,1,0,0,30,09,3,2023,2023-09-30,4,2023,428,1
Bureau,Consumer Product Safety Commission,Consumer Product Safety Commission,null,100.0,100.0,0,0,468,3,30,09,3,2023,2023-09-30,4,2023,468,3
Bureau,Department of the Treasury,Office of Financial Research,null,100.0,100.0,0,0,521,2,30,09,3,2023,2023-09-30,4,2023,521,2
Bureau,Department of the Interior,"Bureau of Ocean Energy Mgmt., Reg & Enf",null,100.0,100.0,0,0,1333,1,30,09,3,2023,2023-09-30,4,2023,1333,1
Bureau,National Credit Union Administration,National Credit Union Administration,null,100.0,100.0,0,0,1373,2,30,09,3,2023,2023-09-30,4,2023,1373,2
Bureau,Other Agencies,Council of Insps. Gen. of Intg. & Effy.,null,0.0,0.0,2894,6,0,0,30,09,3,2023,2023-09-30,4,2023,2894,6
Bureau,Department of Homeland Security,Domestic Nuclear Detection Office,null,0.0,0.0,3252,23,0,0,30,09,3,2023,2023-09-30,4,2023,3252,23
Bureau,Department of Transportation,Office of the Inspector General,null,100.0,100.0,0,0,3334,1,30,09,3,2023,2023-09-30,4,2023,3334,1
Bureau,Department of the Treasury,Spec Insp Gen-Troubled Asset Rel Prog,null,100.0,100.0,0,0,3916,1,30,09,3,2023,2023-09-30,4,2023,3916,1
Bureau,Department of Transportation,Federal Highway Administration,null,100.0,100.0,0,0,10778,9,30,09,3,2023,2023-09-30,4,2023,10778,9
Bureau,Department of Transportation,National Highway Traffic Safety Admin.,null,100.0,100.0,0,0,28794,4,30,09,3,2023,2023-09-30,4,2023,28794,4
Bureau,Department of Health & Human Services,Office of the Inspector General,null,100.0,100.0,0,0,33600,1,30,09,3,2023,2023-09-30,4,2023,33600,1
Bureau,Other Agencies,Architect of the Capitol,null,0.0,0.0,92743,34,0,0,30,09,3,2023,2023-09-30,4,2023,92743,34
Bureau,Department of the Treasury,Bureau of Engraving and Printing,null,0.0,0.0,38345,2,0,0,30,09,3,2023,2023-09-30,4,2023,38345,2
Bureau,Department of the Treasury,Internal Revenue Service,null,100.0,100.0,0,0,46542,40,30,09,3,2023,2023-09-30,4,2023,46542,40
Bureau,Armed Forces Retirement Home,Armed Forces Retirement Home,null,69.89744985933388,99.02912621359224,33170,1,77020,102,30,09,3,2023,2023-09-30,4,2023,110190,103
Bureau,Department of Justice,Federal Prison Industries,null,0.0,0.0,115249,45,0,0,30,09,3,2023,2023-09-30,4,2023,115249,45
Bureau,National Archives & Records Admin,Nat'l Archives & Records Administration,null,100.0,100.0,0,0,126935,112,30,09,3,2023,2023-09-30,4,2023,126935,112
Bureau,Department of Housing and Urban Development,Government National Mortgage Association,null,0.0,0.0,143585,1,0,0,30,09,3,2023,2023-09-30,4,2023,143585,1
Bureau,Department of Transportation,Federal Railroad Administration,null,100.0,100.0,0,0,185691,15,30,09,3,2023,2023-09-30,4,2023,185691,15
Bureau,Department of Labor,Employment and Training Administration,null,100.0,100.0,0,0,885054,10,30,09,3,2023,2023-09-30,4,2023,885054,10
Bureau,Department of Energy,Bonneville Power Administration,null,100.0,100.0,0,0,1058470,28,30,09,3,2023,2023-09-30,4,2023,1058470,28
Bureau,Department of Health & Human Services,Substance Abuse & Mental Health Admin.,null,100.0,100.0,0,0,1071662,11,30,09,3,2023,2023-09-30,4,2023,1071662,11
Bureau,Department of Transportation,Office of the Secretary,null,100.0,100.0,0,0,1139870,16,30,09,3,2023,2023-09-30,4,2023,1139870,16
Bureau,Department of the Treasury,Financial Crimes Enforcement Network,null,100.0,100.0,0,0,1544945,3,30,09,3,2023,2023-09-30,4,2023,1544945,3
Bureau,Department of the Treasury,Community Dev Financial Inst Fund,null,100.0,100.0,0,0,3623095,7,30,09,3,2023,2023-09-30,4,2023,3623095,7
Bureau,Corp. for National and Community Service,Corp. for National and Community Service,null,88.45922304639586,44.61077844311377,470060,185,3602976,149,30,09,3,2023,2023-09-30,4,2023,4073036,334
Bureau,Department of Agriculture,Agricultural Marketing Service,null,78.27633521463792,70.3244837758112,1009142,503,3636216,1192,30,09,3,2023,2023-09-30,4,2023,4645358,1695
Bureau,Pension Benefit Guaranty Corp,Pension Benefit Guaranty Corporation,null,100.0,100.0,0,0,4645894,1683,30,09,3,2023,2023-09-30,4,2023,4645894,1683
Bureau,Department of Agriculture,Food and Nutrition Service,null,0.8274331387819862,8.457711442786069,4679166,184,39040,17,30,09,3,2023,2023-09-30,4,2023,4718206,201
Bureau,Department of Commerce,Economic Development Administration,null,100.0,100.0,0,0,5153780,13,30,09,3,2023,2023-09-30,4,2023,5153780,13
Bureau,Department of Commerce,NOAA,null,100.0,100.0,0,0,30036302,1263,30,09,3,2023,2023-09-30,4,2023,30036302,1263
Agency,Legislative Branch-Office of Tech.,null,Non-CFO,0.0,0.0,0,0,0,0,30,09,3,2023,2023-09-30,4,2023,0,0
Agency,U.S. Court of Appeals / Veterans Claims,null,Non-CFO,0.0,0.0,0,0,0,0,30,09,3,2023,2023-09-30,4,2023,0,0
Bureau,Department of Housing and Urban Development,Management and Administration,null,100.0,100.0,0,0,9981,2,30,09,3,2023,2023-09-30,4,2023,9981,2
Bureau,Department of Homeland Security,Federal Law Enforcement Training Ctr.,null,100.0,100.0,0,0,14673,2,30,09,3,2023,2023-09-30,4,2023,14673,2
Bureau,Department of Housing and Urban Development,Community Planning and Development,null,100.0,100.0,0,0,102215,1,30,09,3,2023,2023-09-30,4,2023,102215,1
Bureau,Department of Agriculture,Food Safety and Inspection Service,null,97.09133641722599,96.70631290027447,33464,36,1117030,1057,30,09,3,2023,2023-09-30,4,2023,1150494,1093
Bureau,General Services Administration,General Services Administration,null,0.0,0.0,1259836,51,0,0,30,09,3,2023,2023-09-30,4,2023,1259836,51
Bureau,Department of Homeland Security,Emergency Preparedness & Resp,null,100.0,100.0,0,0,222162279,43088,30,09,3,2023,2023-09-30,4,2023,222162279,43088
Bureau,Department of Veterans Affairs,Medical and Construction,null,99.71554113292872,99.93380838221167,690922,2335,242199028,3525302,30,09,3,2023,2023-09-30,4,2023,242889950,3527637
Bureau,Federal Communications Commission,Federal Communications Commission,null,100.0,100.0,0,0,249427890,12165,30,09,3,2023,2023-09-30,4,2023,249427890,12165
Bureau,Federal Trade Commission,Federal Trade Commission,null,100.0,100.0,0,0,380675784,56,30,09,3,2023,2023-09-30,4,2023,380675784,56
Bureau,Commodity Futures Trading Commission,Commodity Futures Trading Commission,null,100.0,100.0,0,0,629802832,360,30,09,3,2023,2023-09-30,4,2023,629802832,360
Bureau,Department of Agriculture,Rural Development,null,99.99930694579942,99.98531840704716,5627,4,811907784,27241,30,09,3,2023,2023-09-30,4,2023,811913411,27245
Bureau,Department of Education,Departmental Management,null,99.64191294935645,97.07920792079207,5221285,59,1452883662,1961,30,09,3,2023,2023-09-30,4,2023,1458104947,2020
Bureau,Department of Defense,Consolidated Report,null,33.32431875779446,17.563244256048627,2210869499,1427263,1104986384,304080,30,09,3,2023,2023-09-30,4,2023,3315855883,1731343
Bureau,Social Security Administration,Social Security Administration,null,56.94592081586121,31.48006826919842,1825121278,896079,2414015437,411685,30,09,3,2023,2023-09-30,4,2023,4239136715,1307764
Bureau,Department of Health & Human Services,Centers for Medicare & Medicaid Services,null,98.81899900713353,99.52801183294278,124449829,5396,10413206765,1137853,30,09,3,2023,2023-09-30,4,2023,10537656594,1143249
Bureau,Small Business Administration,Small Business Administration,null,100.0,100.0,0,0,18648730593,148450,30,09,3,2023,2023-09-30,4,2023,18648730593,148450
Bureau,Department of Veterans Affairs,Life Insurance,null,100.0,100.0,0,0,1233112,257,30,09,3,2023,2023-09-30,4,2023,1233112,257
Bureau,Funds Appropriated to the President,Trade and Development Agency,null,0.0,0.0,1236060,7,0,0,30,09,3,2023,2023-09-30,4,2023,1236060,7
Bureau,Department of Transportation,Federal Aviation Administration,null,100.0,100.0,0,0,3895327,485,30,09,3,2023,2023-09-30,4,2023,3895327,485
Bureau,Department of the Interior,National Park Service,null,100.0,100.0,0,0,8916074,1994,30,09,3,2023,2023-09-30,4,2023,8916074,1994
Bureau,Department of the Interior,Bureau of Land Management,null,100.0,100.0,0,0,9060569,348,30,09,3,2023,2023-09-30,4,2023,9060569,348
Bureau,Department of Labor,Mine Safety and Health Administration,null,75.46167839674659,88.65320725785843,2508519,444,7714344,3469,30,09,3,2023,2023-09-30,4,2023,10222863,3913
Bureau,Department of Homeland Security,U.S. Coast Guard,null,5.982844037139339,5.363188673437981,19315427,24598,1229150,1394,30,09,3,2023,2023-09-30,4,2023,20544577,25992
Bureau,Department of Agriculture,U.S. Department of Agriculture,null,88.95380938221467,65.35004086080087,2294315,1272,18475877,2399,30,09,3,2023,2023-09-30,4,2023,20770192,3671
Bureau,Office of Personnel Management,Office of Personnel Management,null,100.0,100.0,0,0,20899877,1153,30,09,3,2023,2023-09-30,4,2023,20899877,1153
Bureau,Department of State,Department of State,null,98.86813518510588,98.26589595375722,236839,168,20687833,9520,30,09,3,2023,2023-09-30,4,2023,20924672,9688
Bureau,Department of the Treasury,Departmental Offices,null,99.51171651775009,99.6969696969697,102321,4,20852924,1316,30,09,3,2023,2023-09-30,4,2023,20955245,1320
Bureau,Department of Labor,Employee Benefit Security Administration,null,100.0,100.0,0,0,21127004,472,30,09,3,2023,2023-09-30,4,2023,21127004,472
Bureau,Railroad Retirement Board,Railroad Retirement Board,null,100.0,100.0,0,0,21719276,4441,30,09,3,2023,2023-09-30,4,2023,21719276,4441
Bureau,Department of the Interior,Office of Natural Resources Revenue,null,100.0,100.0,0,0,24574127,540,30,09,3,2023,2023-09-30,4,2023,24574127,540
Bureau,Department of Justice,Federal Prison System,null,100.0,100.0,0,0,27061326,1194,30,09,3,2023,2023-09-30,4,2023,27061326,1194
Bureau,Department of Transportation,Pipeline Hazardous Material Safety Admin,null,100.0,100.0,0,0,1312721,99,30,09,3,2023,2023-09-30,4,2023,1312721,99
Bureau,Presidio Trust Corporation,Presidio Trust Corporation,null,100.0,100.0,0,0,1324482,60,30,09,3,2023,2023-09-30,4,2023,1324482,60
Bureau,Department of Justice,Office of Justice Assistance Programs,null,100.0,100.0,0,0,1356686,6,30,09,3,2023,2023-09-30,4,2023,1356686,6
Bureau,Department of the Treasury,Comptroller of the Currency,null,99.71231132441417,84.61538461538461,4042,4,1400949,22,30,09,3,2023,2023-09-30,4,2023,1404991,26
Bureau,Department of the Treasury,D.C. Pension Program,null,100.0,100.0,0,0,1504069,20,30,09,3,2023,2023-09-30,4,2023,1504069,20
Bureau,Department of State,Passport NSF,null,100.0,100.0,0,0,1756012,11316,30,09,3,2023,2023-09-30,4,2023,1756012,11316
Bureau,Department of Homeland Security,Bureau of Customs & Border Protection,null,100.0,100.0,0,0,10633073,905,30,09,3,2023,2023-09-30,4,2023,10633073,905
Bureau,Department of Homeland Security,Transportation Safety Administration,null,100.0,100.0,0,0,10949732,14270,30,09,3,2023,2023-09-30,4,2023,10949732,14270
Bureau,Department of the Treasury,Treasury IG for Tax Admin,null,100.0,100.0,0,0,263,2,30,09,3,2023,2023-09-30,4,2023,263,2
Bureau,Department of Health & Human Services,Food and Drug Administration,null,27.77071347642318,6.97639225181598,139270269,24588,53546628,1844,30,09,3,2023,2023-09-30,4,2023,192816897,26432
Bureau,U.S. Tax Court,U.S. Tax Court,null,0.0,0.0,0,0,0,0,31,12,4,2023,2023-12-31,1,2024,0,0
Bureau,Department of Justice,General Administration,null,0.0,0.0,0,0,0,0,31,12,4,2023,2023-12-31,1,2024,0,0
Bureau,Other Agencies,Commission On Fine Arts,null,0.0,0.0,0,0,0,0,31,12,4,2023,2023-12-31,1,2024,0,0
Bureau,Export - Import  Bank,Export-Import Bank,null,0.0,0.0,0,0,0,0,31,12,4,2023,2023-12-31,1,2024,0,0
Bureau,Department of Justice,U.S. Marshals Service,null,0.0,0.0,9330,6,0,0,31,12,4,2023,2023-12-31,1,2024,9330,6
Agency,U.S. Postal Service,null,Non-CFO,82.19298412885753,82.4457785842152,15781580,14415,72844050,67702,31,12,4,2023,2023-12-31,1,2024,88625630,82117
Agency,Federal Communications Commission,null,Non-CFO,100.0,100.0,0,0,251442520,13197,31,12,4,2023,2023-12-31,1,2024,251442520,13197
Bureau,Department of Commerce,General Administration,null,0.0,0.0,0,0,0,0,31,12,4,2023,2023-12-31,1,2024,0,0
Bureau,Department of Health & Human Services,Administration for Community Living,null,0.0,0.0,0,0,0,0,31,12,4,2023,2023-12-31,1,2024,0,0
Bureau,Department of Agriculture,U.S. Department of Agriculture,null,84.14073047672255,60.626456122184834,3659103,1521,19413227,2342,31,12,4,2023,2023-12-31,1,2024,23072330,3863
Bureau,Legislative Branch-GPO,Government Publishing Office,null,0.0,0.0,0,0,0,0,31,12,4,2023,2023-12-31,1,2024,0,0
Bureau,Department of Homeland Security,Bureau of Customs & Border Protection,null,100.0,100.0,0,0,9413643,888,31,12,4,2023,2023-12-31,1,2024,9413643,888
Bureau,General Services Administration,General Services Administration,null,100.0,100.0,0,0,10115910,379,31,12,4,2023,2023-12-31,1,2024,10115910,379
Bureau,Department of Commerce,National Technical Information Service,null,0.0,0.0,0,0,0,0,31,12,4,2023,2023-12-31,1,2024,0,0
Bureau,Other Agencies,Delta Regional Authority,null,0.0,0.0,0,0,0,0,31,12,4,2023,2023-12-31,1,2024,0,0
Bureau,Department of Health & Human Services,Office of the Inspector General,null,100.0,100.0,0,0,33600,1,31,12,4,2023,2023-12-31,1,2024,33600,1
Bureau,Department of Commerce,Bureau of the Census,null,100.0,100.0,0,0,2071882,6275,31,12,4,2023,2023-12-31,1,2024,2071882,6275
Agency,Corp. for National and Community Service,null,Non-CFO,88.08301011283889,43.657817109144545,487446,191,3602899,148,31,12,4,2023,2023-12-31,1,2024,4090345,339
Agency,Pension Benefit Guaranty Corp,null,Non-CFO,100.0,100.0,0,0,6292984,1469,31,12,4,2023,2023-12-31,1,2024,6292984,1469
Agency,Railroad Retirement Board,null,Non-CFO,100.0,100.0,0,0,45492339,6079,31,12,4,2023,2023-12-31,1,2024,45492339,6079
Agency,Federal Trade Commission,null,Non-CFO,100.0,100.0,0,0,652607559,67,31,12,4,2023,2023-12-31,1,2024,652607559,67
Bureau,Funds Appropriated to the President,Peace Corps,null,0.0,0.0,0,0,0,0,31,12,4,2023,2023-12-31,1,2024,0,0
Bureau,Agency for International Development,Agency for International Development,null,99.99903918022434,98.18181818181819,273,1,28412964,54,31,12,4,2023,2023-12-31,1,2024,28413237,55
Bureau,Social Security Administration,Social Security Administration,null,55.07360394474552,30.331085480142637,1944662676,933112,2383889905,406240,31,12,4,2023,2023-12-31,1,2024,4328552581,1339352
Bureau,Department of the Treasury,Treasury Forfeiture Fund,null,0.0,0.0,0,0,0,0,31,12,4,2023,2023-12-31,1,2024,0,0
Bureau,Department of Commerce,Economic and Statistical Analysis,null,0.0,0.0,0,0,0,0,31,12,4,2023,2023-12-31,1,2024,0,0
Bureau,National Labor Relations Board,National Labor Relations Board,null,0.0,0.0,0,0,0,0,31,12,4,2023,2023-12-31,1,2024,0,0
Bureau,Department of Justice,Federal Prison Industries,null,0.0,0.0,109248,127,0,0,31,12,4,2023,2023-12-31,1,2024,109248,127
Agency,Office of Compliance,null,Non-CFO,0.0,0.0,0,0,0,0,31,12,4,2023,2023-12-31,1,2024,0,0
Bureau,Department of Commerce,International Trade Administration,null,0.0,0.0,0,0,0,0,31,12,4,2023,2023-12-31,1,2024,0,0
Bureau,Department of the Interior,Office of Natural Resources Revenue,null,100.0,100.0,0,0,27915764,548,31,12,4,2023,2023-12-31,1,2024,27915764,548
Bureau,Other Agencies,Consumer Financial Protection Bureau,null,99.0756791344308,38.46153846153846,4767,8,510963,5,31,12,4,2023,2023-12-31,1,2024,515730,13
Bureau,Other Agencies,Gulf Coast Ecosystem Restoration Council,null,0.0,0.0,0,0,0,0,31,12,4,2023,2023-12-31,1,2024,0,0
Bureau,National Science Foundation,National Science Foundation,null,99.9116092126549,96.66666666666667,636,1,718896,29,31,12,4,2023,2023-12-31,1,2024,719532,30
Bureau,Department of Transportation,Federal Transit Administration,null,100.0,100.0,0,0,783404,1,31,12,4,2023,2023-12-31,1,2024,783404,1
Agency,Department of Agriculture,null,CFO,98.82894667097558,95.32722320376914,15338662,2539,1294478886,51797,31,12,4,2023,2023-12-31,1,2024,1309817548,54336
Agency,Commodity Futures Trading Commission,null,Non-CFO,100.0,100.0,0,0,632255040,360,31,12,4,2023,2023-12-31,1,2024,632255040,360
Bureau,Department of Commerce,Minority Business Development Agency,null,0.0,0.0,0,0,0,0,31,12,4,2023,2023-12-31,1,2024,0,0
Bureau,Other Agencies,Architect of the Capitol,null,0.0,0.0,0,0,0,0,31,12,4,2023,2023-12-31,1,2024,0,0
Bureau,Funds Appropriated to the President,Executive Branch,null,0.0,0.0,0,0,0,0,31,12,4,2023,2023-12-31,1,2024,0,0
Bureau,Funds Appropriated to the President,Inter-American Foundation,null,0.0,0.0,0,0,0,0,31,12,4,2023,2023-12-31,1,2024,0,0
Bureau,Other Agencies/Boards/Commissions,Nuclear Waste Technical Review Board,null,0.0,0.0,0,0,0,0,31,12,4,2023,2023-12-31,1,2024,0,0
Bureau,Department of Homeland Security,Info Analysis Infrastructure Prot-NPPD,null,0.0,0.0,0,0,0,0,31,12,4,2023,2023-12-31,1,2024,0,0
Bureau,Department of Housing and Urban Development,"Policy, Development and Research",null,0.0,0.0,0,0,0,0,31,12,4,2023,2023-12-31,1,2024,0,0
Bureau,Other Agencies,Federal Mine Safety & Health Review Comm,null,0.0,0.0,0,0,0,0,31,12,4,2023,2023-12-31,1,2024,0,0
Bureau,Other Agencies,U.S. Institute of Peace,null,0.0,0.0,0,0,0,0,31,12,4,2023,2023-12-31,1,2024,0,0
Bureau,Other Agencies,Advisory Council on Hist. Preservation,null,0.0,0.0,0,0,0,0,31,12,4,2023,2023-12-31,1,2024,0,0
Bureau,Other Agencies,Defense Nuclear Facilities Safety Board,null,0.0,0.0,0,0,0,0,31,12,4,2023,2023-12-31,1,2024,0,0
Bureau,Other Agencies/Boards/Commissions,Medicare Payment Advisory Commission,null,0.0,0.0,0,0,0,0,31,12,4,2023,2023-12-31,1,2024,0,0
Bureau,Merit Systems Protection Board,Merit Systems Protection Board,null,100.0,100.0,0,0,144,1,31,12,4,2023,2023-12-31,1,2024,144,1
Bureau,Department of Housing and Urban Development,Public and Indian Housing Programs,null,100.0,100.0,0,0,253,2,31,12,4,2023,2023-12-31,1,2024,253,2
Bureau,Department of the Treasury,Treasury IG for Tax Admin,null,100.0,100.0,0,0,267,2,31,12,4,2023,2023-12-31,1,2024,267,2
Bureau,Consumer Product Safety Commission,Consumer Product Safety Commission,null,100.0,100.0,0,0,413,9,31,12,4,2023,2023-12-31,1,2024,413,9
Bureau,Other Agencies,National Transportation Safety Board,null,0.0,0.0,428,1,0,0,31,12,4,2023,2023-12-31,1,2024,428,1
Bureau,Department of the Treasury,Office of Financial Research,null,51.43953934740883,50.0,253,1,268,1,31,12,4,2023,2023-12-31,1,2024,521,2
Bureau,Farm Credit Administration,Farm Credit Administration,null,100.0,100.0,0,0,630,1,31,12,4,2023,2023-12-31,1,2024,630,1
Bureau,Department of Transportation,Federal Railroad Administration,null,100.0,100.0,0,0,146063,12,31,12,4,2023,2023-12-31,1,2024,146063,12
Bureau,Department of Justice,Drug Enforcement Administration,null,100.0,100.0,0,0,337050,15,31,12,4,2023,2023-12-31,1,2024,337050,15
Bureau,Other Agencies,Morris K. Udall Scholarship,null,0.0,0.0,0,0,0,0,31,12,4,2023,2023-12-31,1,2024,0,0
Bureau,National Archives & Records Admin,Nat'l Archives & Records Administration,null,100.0,100.0,0,0,127725,117,31,12,4,2023,2023-12-31,1,2024,127725,117
Bureau,Legislative Branch - U.S. House/Senate,U.S. House of Representatives,null,0.0,0.0,325235,230,0,0,31,12,4,2023,2023-12-31,1,2024,325235,230
Agency,Department of State,null,CFO,99.15959750021287,99.2311343141908,191971,162,22650774,20908,31,12,4,2023,2023-12-31,1,2024,22842745,21070
Bureau,Department of Agriculture,Food and Nutrition Service,null,0.7203339674290417,15.625,5325952,81,38643,15,31,12,4,2023,2023-12-31,1,2024,5364595,96
Bureau,Department of Education,Departmental Management,null,99.61692813532309,95.73022804463852,5658836,88,1471566855,1973,31,12,4,2023,2023-12-31,1,2024,1477225691,2061
Bureau,Securities & Exchange Commission,SEC Enforcement,null,100.0,100.0,0,0,2903870907,1558,31,12,4,2023,2023-12-31,1,2024,2903870907,1558
Bureau,Department of Defense,Consolidated Report,null,37.1057175011619,17.818308598239636,1854610858,1390732,1094164109,301533,31,12,4,2023,2023-12-31,1,2024,2948774967,1692265
Bureau,Farm Credit Administration,Farm Credit System Insurance Corporation,null,0.0,0.0,0,0,0,0,31,12,4,2023,2023-12-31,1,2024,0,0
Bureau,Smithsonian Institution,Administrative Conference of the US,null,0.0,0.0,0,0,0,0,31,12,4,2023,2023-12-31,1,2024,0,0
Bureau,Office of Compliance,Office of Compliance,null,0.0,0.0,0,0,0,0,31,12,4,2023,2023-12-31,1,2024,0,0
Bureau,Legislative Branch-Office of Tech.,Open World Leadership,null,0.0,0.0,0,0,0,0,31,12,4,2023,2023-12-31,1,2024,0,0
Bureau,National Foundation  Arts & Humanities,National Endowment for the Arts,null,0.0,0.0,0,0,0,0,31,12,4,2023,2023-12-31,1,2024,0,0
Bureau,Department of the Treasury,Treasury Franchise Fund,null,0.0,0.0,0,0,0,0,31,12,4,2023,2023-12-31,1,2024,0,0
Bureau,Other Agencies,Denali Commission,null,0.0,0.0,0,0,0,0,31,12,4,2023,2023-12-31,1,2024,0,0
Bureau,Department of Transportation,Maritime Administration,null,100.0,100.0,0,0,304111,19,31,12,4,2023,2023-12-31,1,2024,304111,19
Bureau,Smithsonian Institution,National Gallery of Art,null,0.0,0.0,0,0,0,0,31,12,4,2023,2023-12-31,1,2024,0,0
Bureau,Other Agencies,National Council on Disability,null,0.0,0.0,0,0,0,0,31,12,4,2023,2023-12-31,1,2024,0,0
Bureau,Department of the Treasury,Tobacco Tax and Trade,null,100.0,100.0,0,0,1000,1,31,12,4,2023,2023-12-31,1,2024,1000,1
Bureau,Other Agencies,Federal Housing Finance Agency,null,100.0,100.0,0,0,1009,1,31,12,4,2023,2023-12-31,1,2024,1009,1
Bureau,Other Agencies/Boards/Commissions,U.S. Comm. on Int. Religious Freedom,null,0.0,0.0,1024,1,0,0,31,12,4,2023,2023-12-31,1,2024,1024,1
Bureau,Selective Service System,Selective Service System,null,0.0,0.0,1301,2,0,0,31,12,4,2023,2023-12-31,1,2024,1301,2
Bureau,Department of the Interior,"Bureau of Ocean Energy Mgmt., Reg & Enf",null,100.0,100.0,0,0,1333,1,31,12,4,2023,2023-12-31,1,2024,1333,1
Bureau,National Credit Union Administration,National Credit Union Administration,null,100.0,100.0,0,0,1373,2,31,12,4,2023,2023-12-31,1,2024,1373,2
Bureau,Other Agencies,John C. Stennis,null,0.0,0.0,6313,2,0,0,31,12,4,2023,2023-12-31,1,2024,6313,2
Bureau,Department of Agriculture,Federal Crop Insurance Corporation,null,100.0,100.0,0,0,7807,6,31,12,4,2023,2023-12-31,1,2024,7807,6
Bureau,Department of Homeland Security,Federal Law Enforcement Training Ctr.,null,100.0,100.0,0,0,8562,1,31,12,4,2023,2023-12-31,1,2024,8562,1
Bureau,Smithsonian Institution,Smithsonian Institution,null,0.0,0.0,8982,21,0,0,31,12,4,2023,2023-12-31,1,2024,8982,21
Bureau,Department of Housing and Urban Development,Management and Administration,null,100.0,100.0,0,0,9981,2,31,12,4,2023,2023-12-31,1,2024,9981,2
Bureau,Department of Transportation,Federal Highway Administration,null,100.0,100.0,0,0,11103,9,31,12,4,2023,2023-12-31,1,2024,11103,9
Bureau,Other Agencies,Chemical Safety Board,null,100.0,100.0,0,0,13361,1,31,12,4,2023,2023-12-31,1,2024,13361,1
Bureau,Equal Employment Opportunity Commission,Equal Employment Opportunity Commission,null,100.0,100.0,0,0,18953,16,31,12,4,2023,2023-12-31,1,2024,18953,16
Bureau,Department of Justice,Bureau of ATF and Explosives,null,100.0,100.0,0,0,19881,1,31,12,4,2023,2023-12-31,1,2024,19881,1
Bureau,Department of Transportation,Research Innovative Technology Admin,null,100.0,100.0,0,0,27322,8,31,12,4,2023,2023-12-31,1,2024,27322,8
Bureau,Department of the Treasury,Internal Revenue Service,null,100.0,100.0,0,0,38820,38,31,12,4,2023,2023-12-31,1,2024,38820,38
Bureau,Department of Housing and Urban Development,Community Planning and Development,null,100.0,100.0,0,0,102215,1,31,12,4,2023,2023-12-31,1,2024,102215,1
Bureau,Armed Forces Retirement Home,Armed Forces Retirement Home,null,69.55623881418934,98.94736842105263,33170,1,75785,94,31,12,4,2023,2023-12-31,1,2024,108955,95
Bureau,Department of Labor,Departmental Management,null,0.0,0.0,135201,163,0,0,31,12,4,2023,2023-12-31,1,2024,135201,163
Bureau,Legis Branch-Library of Congress,Library of Congress,null,0.0,0.0,0,0,0,0,31,12,4,2023,2023-12-31,1,2024,0,0
Bureau,Department of the Treasury,Office of Sec International Affairs,null,0.0,0.0,0,0,0,0,31,12,4,2023,2023-12-31,1,2024,0,0
Bureau,Department of the Treasury,U.S. Treasury IG Office,null,0.0,0.0,0,0,0,0,31,12,4,2023,2023-12-31,1,2024,0,0
Bureau,Other Agencies/Boards/Commissions,U.S.-China Security Review Commission,null,0.0,0.0,0,0,0,0,31,12,4,2023,2023-12-31,1,2024,0,0
Bureau,Other Agencies,Millennium Challenge Corporation,null,0.0,0.0,0,0,0,0,31,12,4,2023,2023-12-31,1,2024,0,0
Bureau,Other Agencies,U.S.  Agency of Global Media,null,0.0,0.0,0,0,0,0,31,12,4,2023,2023-12-31,1,2024,0,0
Bureau,Other Agencies,Federal Housing Finance Agency OIG,null,0.0,0.0,0,0,0,0,31,12,4,2023,2023-12-31,1,2024,0,0
Bureau,US International Development Fin. Corp.,US International Development Fin. Corp.,null,0.0,0.0,0,0,0,0,31,12,4,2023,2023-12-31,1,2024,0,0
Agency,National Labor Relations Board,null,Non-CFO,0.0,0.0,0,0,0,0,31,12,4,2023,2023-12-31,1,2024,0,0
Agency,Neighborhood Reinvestment Corporation,null,Non-CFO,0.0,0.0,0,0,0,0,31,12,4,2023,2023-12-31,1,2024,0,0
Agency,Federal Deposit Insurance Corporation,null,Non-CFO,0.0,0.0,0,0,0,0,31,12,4,2023,2023-12-31,1,2024,0,0
Agency,Legislative Branch-GPO,null,Non-CFO,0.0,0.0,0,0,0,0,31,12,4,2023,2023-12-31,1,2024,0,0
Agency,Legislative Branch-CBO,null,Non-CFO,0.0,0.0,0,0,0,0,31,12,4,2023,2023-12-31,1,2024,0,0
Agency,U.S. Tax Court,null,Non-CFO,0.0,0.0,0,0,0,0,31,12,4,2023,2023-12-31,1,2024,0,0
Agency,Occupational Safety & Health Rev Comm,null,Non-CFO,0.0,0.0,0,0,0,0,31,12,4,2023,2023-12-31,1,2024,0,0
Agency,Federal Labor Relations Authority,null,Non-CFO,0.0,0.0,0,0,0,0,31,12,4,2023,2023-12-31,1,2024,0,0
Bureau,Department of the Interior,Geological Survey,null,100.0,100.0,0,0,149827,453,31,12,4,2023,2023-12-31,1,2024,149827,453
Bureau,Department of the Treasury,U.S. Mint,null,12.942264611023358,85.71428571428571,144952,3,21549,18,31,12,4,2023,2023-12-31,1,2024,166501,21
Bureau,Other Agencies,James Madison Memorial Fellowship,null,0.0,0.0,197452,24,0,0,31,12,4,2023,2023-12-31,1,2024,197452,24
Bureau,Securities & Exchange Commission,Securities and Exchange Commission,null,100.0,100.0,0,0,258525,45,31,12,4,2023,2023-12-31,1,2024,258525,45
Agency,Department of the Interior,null,CFO,99.99536718557913,99.83978718902088,4271,53,92185910,33028,31,12,4,2023,2023-12-31,1,2024,92190181,33081
Agency,Department of Homeland Security,null,CFO,90.75085682215062,60.721093666909375,28430206,48011,278951845,74220,31,12,4,2023,2023-12-31,1,2024,307382051,122231
Agency,Social Security Administration,null,CFO,55.07360394474552,30.331085480142637,1944662676,933112,2383889905,406240,31,12,4,2023,2023-12-31,1,2024,4328552581,1339352
Bureau,Department of the Interior,Office of the Secretary,null,100.0,100.0,0,0,22280,13,31,12,4,2023,2023-12-31,1,2024,22280,13
Bureau,Department of Transportation,National Highway Traffic Safety Admin.,null,100.0,100.0,0,0,26711,4,31,12,4,2023,2023-12-31,1,2024,26711,4
Bureau,Department of Justice,Federal Bureau of Investigation,null,100.0,100.0,0,0,467885,104,31,12,4,2023,2023-12-31,1,2024,467885,104
Bureau,Tennessee Valley Authority,Tennessee Valley Authority,null,0.0,0.0,468082,0,0,0,31,12,4,2023,2023-12-31,1,2024,468082,0
Bureau,Department of Commerce,Patent and Trademark Office,null,100.0,100.0,0,0,492278,851,31,12,4,2023,2023-12-31,1,2024,492278,851
Bureau,Department of the Interior,Fish and Wildlife Service,null,100.0,100.0,0,0,807789,98,31,12,4,2023,2023-12-31,1,2024,807789,98
Bureau,Department of Commerce,Nat'l Institute of Standards& Technology,null,100.0,100.0,0,0,992235,3,31,12,4,2023,2023-12-31,1,2024,992235,3
Bureau,Department of the Treasury,Comptroller of the Currency,null,99.74621126085427,84.0,3542,4,1392107,21,31,12,4,2023,2023-12-31,1,2024,1395649,25
Bureau,Department of the Treasury,D.C. Pension Program,null,100.0,100.0,0,0,1504438,21,31,12,4,2023,2023-12-31,1,2024,1504438,21
Bureau,Department of the Treasury,Financial Crimes Enforcement Network,null,100.0,100.0,0,0,1544945,3,31,12,4,2023,2023-12-31,1,2024,1544945,3
Bureau,Department of Agriculture,Food Safety and Inspection Service,null,96.8083499196662,97.60450915922968,53238,51,1614802,2078,31,12,4,2023,2023-12-31,1,2024,1668040,2129
Bureau,Department of Energy,Bonneville Power Administration,null,100.0,100.0,0,0,1720488,32,31,12,4,2023,2023-12-31,1,2024,1720488,32
Bureau,Federal Election Commission,Federal Election Commission,null,100.0,100.0,0,0,2928612,380,31,12,4,2023,2023-12-31,1,2024,2928612,380
Bureau,Department of Veterans Affairs,Administration and Cemeteries,null,4.014080128960583,40.283687943262414,5697203,421,238254,284,31,12,4,2023,2023-12-31,1,2024,5935457,705
Agency,Department of the Treasury,null,CFO,98.86979617101905,99.70117395944504,529245,14,46298149,4671,31,12,4,2023,2023-12-31,1,2024,46827394,4685
Agency,American Battle Monuments Commission,null,Non-CFO,0.0,0.0,0,0,0,0,31,12,4,2023,2023-12-31,1,2024,0,0
Agency,Legislative Branch-GAO,null,Non-CFO,0.0,0.0,0,0,0,0,31,12,4,2023,2023-12-31,1,2024,0,0
Agency,U.S. Court of Appeals / Veterans Claims,null,Non-CFO,0.0,0.0,0,0,0,0,31,12,4,2023,2023-12-31,1,2024,0,0
Agency,Smithsonian Institution,null,Non-CFO,0.0,0.0,8982,21,0,0,31,12,4,2023,2023-12-31,1,2024,8982,21
Agency,Equal Employment Opportunity Commission,null,Non-CFO,100.0,100.0,0,0,18953,16,31,12,4,2023,2023-12-31,1,2024,18953,16
Agency,Armed Forces Retirement Home,null,Non-CFO,69.55623881418934,98.94736842105263,33170,1,75785,94,31,12,4,2023,2023-12-31,1,2024,108955,95
Bureau,Funds Appropriated to the President,Defense Security Assistance Agency,null,0.0,0.0,0,0,0,0,31,12,4,2023,2023-12-31,1,2024,0,0
Bureau,Department of Justice,Office of Justice Assistance Programs,null,100.0,100.0,0,0,418916,3,31,12,4,2023,2023-12-31,1,2024,418916,3
Bureau,Pension Benefit Guaranty Corp,Pension Benefit Guaranty Corporation,null,100.0,100.0,0,0,6292984,1469,31,12,4,2023,2023-12-31,1,2024,6292984,1469
Bureau,Department of Health & Human Services,Centers for Disease Control,null,14.63278718942185,17.5,5594612,99,958972,21,31,12,4,2023,2023-12-31,1,2024,6553584,120
Bureau,Department of the Interior,National Park Service,null,100.0,100.0,0,0,8558522,1974,31,12,4,2023,2023-12-31,1,2024,8558522,1974
Bureau,Department of the Interior,Office of Surface Mining,null,99.99998891664653,100.0,1,0,9022539,402,31,12,4,2023,2023-12-31,1,2024,9022540,402
Bureau,Department of Labor,Mine Safety and Health Administration,null,77.48859922082724,92.80507876792852,2738848,306,9427645,3947,31,12,4,2023,2023-12-31,1,2024,12166493,4253
Bureau,Department of the Treasury,Bureau of the Fiscal Service,null,100.0,100.0,0,0,13531024,3231,31,12,4,2023,2023-12-31,1,2024,13531024,3231
Bureau,Department of Homeland Security,Immigration and Customs Enforcement,null,100.0,100.0,0,0,17000209,673,31,12,4,2023,2023-12-31,1,2024,17000209,673
Agency,National Science Foundation,null,CFO,99.9116092126549,96.66666666666667,636,1,718896,29,31,12,4,2023,2023-12-31,1,2024,719532,30
Agency,National Aeronautics and Space Administration,null,CFO,99.97432750012422,99.24812030075188,279,1,1086487,132,31,12,4,2023,2023-12-31,1,2024,1086766,133
Agency,Tennessee Valley Authority,null,Non-CFO,0.0,0.0,468082,0,0,0,31,12,4,2023,2023-12-31,1,2024,468082,0
Bureau,Department of Transportation,St. Lawrence Seaway Development Corp.,null,100.0,100.0,0,0,7728,2,31,12,4,2023,2023-12-31,1,2024,7728,2
Bureau,Department of the Treasury,Pandemic Receivables,null,100.0,100.0,0,0,3701819,6,31,12,4,2023,2023-12-31,1,2024,3701819,6
Bureau,Corp. for National and Community Service,Corp. for National and Community Service,null,88.08301011283889,43.657817109144545,487446,191,3602899,148,31,12,4,2023,2023-12-31,1,2024,4090345,339
Bureau,Department of Transportation,Federal Aviation Administration,null,100.0,100.0,0,0,4420950,532,31,12,4,2023,2023-12-31,1,2024,4420950,532
Bureau,Department of Agriculture,Agricultural Marketing Service,null,71.33965866980301,66.29401900503075,1503036,603,3741270,1186,31,12,4,2023,2023-12-31,1,2024,5244306,1789
Bureau,Department of Health & Human Services,Program Support Center,null,100.0,100.0,0,0,6541890,253,31,12,4,2023,2023-12-31,1,2024,6541890,253
Bureau,Department of the Interior,Bureau of Reclamation,null,100.0,100.0,0,0,7391411,64,31,12,4,2023,2023-12-31,1,2024,7391411,64
Bureau,Department of Health & Human Services,Administration for Children and Families,null,100.0,100.0,0,0,40532632,1726,31,12,4,2023,2023-12-31,1,2024,40532632,1726
Bureau,Railroad Retirement Board,Railroad Retirement Board,null,100.0,100.0,0,0,45492339,6079,31,12,4,2023,2023-12-31,1,2024,45492339,6079
Bureau,Department of Health & Human Services,Indian Health Services,null,100.0,100.0,0,0,58200952,3364,31,12,4,2023,2023-12-31,1,2024,58200952,3364
Bureau,U.S. Postal Service,U.S. Postal Service,null,82.19298412885753,82.4457785842152,15781580,14415,72844050,67702,31,12,4,2023,2023-12-31,1,2024,88625630,82117
Bureau,Department of Justice,Legal Activities,null,98.0837745547592,98.90595253204721,1738500,431,88986733,38964,31,12,4,2023,2023-12-31,1,2024,90725233,39395
Bureau,Department of Veterans Affairs,Veterans Benefits,null,0.0,0.0,113176782,86198,0,0,31,12,4,2023,2023-12-31,1,2024,113176782,86198
Bureau,Department of Agriculture,Commodity Credit Corporation,null,100.0,100.0,0,0,120531281,8977,31,12,4,2023,2023-12-31,1,2024,120531281,8977
Bureau,Department of Health & Human Services,Health Resources and Services Admin,null,100.0,100.0,0,0,127766083,709,31,12,4,2023,2023-12-31,1,2024,127766083,709
Agency,Nuclear Regulatory Commission,null,CFO,100.0,100.0,0,0,3168984,356,31,12,4,2023,2023-12-31,1,2024,3168984,356
Agency,General Services Administration,null,CFO,100.0,100.0,0,0,10115910,379,31,12,4,2023,2023-12-31,1,2024,10115910,379
Agency,Department of Energy,null,CFO,100.0,100.0,0,0,14421542,104,31,12,4,2023,2023-12-31,1,2024,14421542,104
Bureau,Department of Health & Human Services,Agency for Healthcare Research & Quality,null,0.0,0.0,0,0,0,0,31,12,4,2023,2023-12-31,1,2024,0,0
Bureau,Legislative Branch-GAO,Government Accountability Office,null,0.0,0.0,0,0,0,0,31,12,4,2023,2023-12-31,1,2024,0,0
Bureau,Department of Commerce,Office of the Inspector General,null,0.0,0.0,0,0,0,0,31,12,4,2023,2023-12-31,1,2024,0,0
Bureau,Department of Justice,Federal Prison System,null,0.0,0.0,0,0,0,0,31,12,4,2023,2023-12-31,1,2024,0,0
Bureau,Department of State,International Commissions,null,0.0,0.0,0,0,0,0,31,12,4,2023,2023-12-31,1,2024,0,0
Bureau,Office of Special Counsel,Office of Special Counsel,null,0.0,0.0,0,0,0,0,31,12,4,2023,2023-12-31,1,2024,0,0
Bureau,National Foundation  Arts & Humanities,National Endowment for the Humanities,null,0.0,0.0,0,0,0,0,31,12,4,2023,2023-12-31,1,2024,0,0
Bureau,Department of Homeland Security,Office of the Inspector General DHS,null,0.0,0.0,0,0,0,0,31,12,4,2023,2023-12-31,1,2024,0,0
Bureau,American Battle Monuments Commission,American Battle Monuments Commission,null,0.0,0.0,0,0,0,0,31,12,4,2023,2023-12-31,1,2024,0,0
Bureau,Neighborhood Reinvestment Corporation,Neighborhood Reinvestment Corporation,null,0.0,0.0,0,0,0,0,31,12,4,2023,2023-12-31,1,2024,0,0
Bureau,Other Agencies,District of Columbia Government,null,0.0,0.0,0,0,0,0,31,12,4,2023,2023-12-31,1,2024,0,0
Bureau,Other Agencies,National Capital Planning Commission,null,0.0,0.0,0,0,0,0,31,12,4,2023,2023-12-31,1,2024,0,0
Bureau,Other Agencies,Archit.&Trans. Barriers Compliance Bd,null,0.0,0.0,0,0,0,0,31,12,4,2023,2023-12-31,1,2024,0,0
Bureau,Office of Government Ethics,Office of Government Ethics,null,0.0,0.0,0,0,0,0,31,12,4,2023,2023-12-31,1,2024,0,0
Bureau,U.S. Court of Appeals / Veterans Claims,U.S. Court of Appeals / Veterans Claims,null,0.0,0.0,0,0,0,0,31,12,4,2023,2023-12-31,1,2024,0,0
Bureau,Legislative Branch-Office of Tech.,Medicaid & CHIP Payment & Access Comm.,null,0.0,0.0,0,0,0,0,31,12,4,2023,2023-12-31,1,2024,0,0
Bureau,Other Agencies,National Mediation Board,null,0.0,0.0,0,0,0,0,31,12,4,2023,2023-12-31,1,2024,0,0
Bureau,Other Agencies,Surface Transportation Board,null,0.0,0.0,0,0,0,0,31,12,4,2023,2023-12-31,1,2024,0,0
Bureau,Department of Veterans Affairs,Medical and Construction,null,99.46286607374286,99.87555887398558,808623,2520,149735396,2022534,31,12,4,2023,2023-12-31,1,2024,150544019,2025054
Bureau,Department of Agriculture,Farm Service Agency,null,100.0,100.0,0,0,164243781,9623,31,12,4,2023,2023-12-31,1,2024,164243781,9623
Bureau,Department of Health & Human Services,Food and Drug Administration,null,28.78060981813636,9.937543372657876,136569198,19467,55189251,2148,31,12,4,2023,2023-12-31,1,2024,191758449,21615
Bureau,Department of Homeland Security,Emergency Preparedness & Resp,null,100.0,100.0,0,0,220110221,45298,31,12,4,2023,2023-12-31,1,2024,220110221,45298
Bureau,Federal Communications Commission,Federal Communications Commission,null,100.0,100.0,0,0,251442520,13197,31,12,4,2023,2023-12-31,1,2024,251442520,13197
Bureau,Commodity Futures Trading Commission,Commodity Futures Trading Commission,null,100.0,100.0,0,0,632255040,360,31,12,4,2023,2023-12-31,1,2024,632255040,360
Bureau,Department of Agriculture,Rural Development,null,99.99918147326451,99.97054925636873,7480,8,913829500,27156,31,12,4,2023,2023-12-31,1,2024,913836980,27164
Agency,Office of Personnel Management,null,CFO,100.0,100.0,0,0,18911332,997,31,12,4,2023,2023-12-31,1,2024,18911332,997
Agency,Department of Transportation,null,CFO,99.99196712463097,99.9572877736252,6900,4,85890113,9361,31,12,4,2023,2023-12-31,1,2024,85897013,9365
Agency,Department of Justice,null,CFO,97.98335590298028,98.57758946810925,1857078,564,90230465,39087,31,12,4,2023,2023-12-31,1,2024,92087543,39651
Agency,Department of Labor,null,CFO,86.83860771547079,65.51524879614767,21638042,5371,142767376,10204,31,12,4,2023,2023-12-31,1,2024,164405418,15575
Agency,Department of Veterans Affairs,null,CFO,55.62361911063477,95.7785653551389,120657550,89167,151238327,2023077,31,12,4,2023,2023-12-31,1,2024,271895877,2112244
Agency,Department of Defense,null,CFO,37.1057175011619,17.818308598239636,1854610858,1390732,1094164109,301533,31,12,4,2023,2023-12-31,1,2024,2948774967,1692265
Agency,Department of Health & Human Services,null,CFO,95.65171757468073,97.15967258213634,270401578,31490,5948182027,1077185,31,12,4,2023,2023-12-31,1,2024,6218583605,1108675
Agency,Small Business Administration,null,CFO,100.0,100.0,0,0,19752855663,164128,31,12,4,2023,2023-12-31,1,2024,19752855663,164128
Agency,Legislative Branch-Office of Tech.,null,Non-CFO,0.0,0.0,0,0,0,0,31,12,4,2023,2023-12-31,1,2024,0,0
Agency,US International Development Fin. Corp.,null,Non-CFO,0.0,0.0,0,0,0,0,31,12,4,2023,2023-12-31,1,2024,0,0
Agency,Office of Government Ethics,null,Non-CFO,0.0,0.0,0,0,0,0,31,12,4,2023,2023-12-31,1,2024,0,0
Bureau,Federal Deposit Insurance Corporation,Federal Deposit Insurance Corporation,null,0.0,0.0,0,0,0,0,31,12,4,2023,2023-12-31,1,2024,0,0
Agency,Department of Education,null,CFO,97.06885647172527,96.61008837683168,3411129022,682832,112964237421,19460230,31,12,4,2023,2023-12-31,1,2024,116375366443,20143062
Agency,Export - Import  Bank,null,Non-CFO,0.0,0.0,0,0,0,0,31,12,4,2023,2023-12-31,1,2024,0,0
Agency,Legis Branch-Library of Congress,null,Non-CFO,0.0,0.0,0,0,0,0,31,12,4,2023,2023-12-31,1,2024,0,0
Agency,Office of Special Counsel,null,Non-CFO,0.0,0.0,0,0,0,0,31,12,4,2023,2023-12-31,1,2024,0,0
Agency,Federal Mediation/Conciliation Service,null,Non-CFO,0.0,0.0,0,0,0,0,31,12,4,2023,2023-12-31,1,2024,0,0
Agency,Merit Systems Protection Board,null,Non-CFO,100.0,100.0,0,0,144,1,31,12,4,2023,2023-12-31,1,2024,144,1
Agency,Consumer Product Safety Commission,null,Non-CFO,100.0,100.0,0,0,413,9,31,12,4,2023,2023-12-31,1,2024,413,9
Agency,Farm Credit Administration,null,Non-CFO,100.0,100.0,0,0,630,1,31,12,4,2023,2023-12-31,1,2024,630,1
Agency,Other Agencies/Boards/Commissions,null,Non-CFO,0.0,0.0,1024,1,0,0,31,12,4,2023,2023-12-31,1,2024,1024,1
Agency,Selective Service System,null,Non-CFO,0.0,0.0,1301,2,0,0,31,12,4,2023,2023-12-31,1,2024,1301,2
Agency,National Credit Union Administration,null,Non-CFO,100.0,100.0,0,0,1373,2,31,12,4,2023,2023-12-31,1,2024,1373,2
Bureau,Department of Transportation,Office of the Inspector General,null,100.0,100.0,0,0,3380,1,31,12,4,2023,2023-12-31,1,2024,3380,1
Bureau,Department of the Treasury,Spec Insp Gen-Troubled Asset Rel Prog,null,100.0,100.0,0,0,3916,1,31,12,4,2023,2023-12-31,1,2024,3916,1
Bureau,Department of Labor,Bureau of Labor Statistics,null,100.0,100.0,0,0,4782,1,31,12,4,2023,2023-12-31,1,2024,4782,1
Bureau,Other Agencies,U.S. Inst. for Env. Conflict Resolution,null,0.0,0.0,8860,2,0,0,31,12,4,2023,2023-12-31,1,2024,8860,2
Bureau,Department of the Interior,Bureau of Safety and Environmental Enf.,null,100.0,100.0,0,0,14064,2,31,12,4,2023,2023-12-31,1,2024,14064,2
Bureau,Department of Commerce,Nat'l Telecomm & Information Admin.,null,100.0,100.0,0,0,296092,1,31,12,4,2023,2023-12-31,1,2024,296092,1
Bureau,Department of Commerce,Economic Development Administration,null,100.0,100.0,0,0,5120584,11,31,12,4,2023,2023-12-31,1,2024,5120584,11
Bureau,Department of the Interior,Bureau of Land Management,null,100.0,100.0,0,0,9044071,347,31,12,4,2023,2023-12-31,1,2024,9044071,347
Bureau,Environmental Protection Agency,Environmental Protection Agency,null,99.97649928426439,99.19354838709677,6679,2,28413732,246,31,12,4,2023,2023-12-31,1,2024,28420411,248
Bureau,Department of the Interior,Bureau of Indian Affairs,null,99.98540798521525,99.81836252099113,4270,53,29258310,29126,31,12,4,2023,2023-12-31,1,2024,29262580,29179
Bureau,Other Agencies,Election Assistance Commission,null,0.0,0.0,5576,1,0,0,31,12,4,2023,2023-12-31,1,2024,5576,1
Bureau,Office of Personnel Management,Office of Personnel Management,null,100.0,100.0,0,0,18911332,997,31,12,4,2023,2023-12-31,1,2024,18911332,997
Bureau,Department of the Treasury,Departmental Offices,null,99.9034937707837,99.848828420257,20223,2,20934901,1321,31,12,4,2023,2023-12-31,1,2024,20955124,1323
Bureau,Department of Labor,Employee Benefit Security Administration,null,100.0,100.0,0,0,21183238,471,31,12,4,2023,2023-12-31,1,2024,21183238,471
Bureau,Department of Homeland Security,U.S. Coast Guard,null,4.0979645987604005,2.8367214708026243,28425885,47987,1214659,1401,31,12,4,2023,2023-12-31,1,2024,29640544,49388
Bureau,Department of Homeland Security,Transportation Safety Administration,null,100.0,100.0,0,0,30015734,24501,31,12,4,2023,2023-12-31,1,2024,30015734,24501
Bureau,Department of Veterans Affairs,Housing Credit Assistance,null,3.135997202202471,6.666666666666667,974942,28,31564,2,31,12,4,2023,2023-12-31,1,2024,1006506,30
Bureau,The Judiciary,Administrative Office of the U.S. Courts,null,96.55650219132538,56.86274509803921,36457,132,1022263,174,31,12,4,2023,2023-12-31,1,2024,1058720,306
Bureau,Department of Health & Human Services,Substance Abuse & Mental Health Admin.,null,100.0,100.0,0,0,1084500,10,31,12,4,2023,2023-12-31,1,2024,1084500,10
Bureau,National Aeronautics and Space Administration,National Aeronautics and Space Admin,null,99.97432750012422,99.24812030075188,279,1,1086487,132,31,12,4,2023,2023-12-31,1,2024,1086766,133
Bureau,Department of Transportation,Office of the Secretary,null,100.0,100.0,0,0,1148207,15,31,12,4,2023,2023-12-31,1,2024,1148207,15
Bureau,Department of Homeland Security,Citizenship and Immigration Services,null,100.0,100.0,0,0,1188817,1458,31,12,4,2023,2023-12-31,1,2024,1188817,1458
Bureau,Department of Transportation,Pipeline Hazardous Material Safety Admin,null,100.0,100.0,0,0,1227189,97,31,12,4,2023,2023-12-31,1,2024,1227189,97
Bureau,Department of Veterans Affairs,Life Insurance,null,100.0,100.0,0,0,1233113,257,31,12,4,2023,2023-12-31,1,2024,1233113,257
Bureau,Funds Appropriated to the President,Trade and Development Agency,null,0.0,0.0,1236060,7,0,0,31,12,4,2023,2023-12-31,1,2024,1236060,7
Bureau,Department of Labor,Employment and Training Administration,null,100.0,100.0,0,0,1257938,11,31,12,4,2023,2023-12-31,1,2024,1257938,11
Bureau,Department of State,Department of State,null,99.09092721484176,98.36759371221282,191971,162,20925260,9762,31,12,4,2023,2023-12-31,1,2024,21117231,9924
Bureau,Department of Commerce,Bureau of Industry and Security,null,100.0,100.0,0,0,37546041,27,31,12,4,2023,2023-12-31,1,2024,37546041,27
Bureau,Department of Labor,Occupational Safety and Health Admin,null,87.33161825313375,80.69866800703694,7783661,768,53657975,3211,31,12,4,2023,2023-12-31,1,2024,61441636,3979
Bureau,Department of Labor,Employment Standards Administration,null,83.90361341225308,38.27086755263551,10980332,4134,57235798,2563,31,12,4,2023,2023-12-31,1,2024,68216130,6697
Bureau,Department of Housing and Urban Development,Housing Programs,null,99.96829351307676,99.89568845618915,22225,3,70073841,2873,31,12,4,2023,2023-12-31,1,2024,70096066,2876
Bureau,Department of Agriculture,Forest Service,null,93.68496734039103,60.087082728592165,4789853,275,71058575,414,31,12,4,2023,2023-12-31,1,2024,75848428,689
Bureau,Presidio Trust Corporation,Presidio Trust Corporation,null,100.0,100.0,0,0,1337667,60,31,12,4,2023,2023-12-31,1,2024,1337667,60
Bureau,Department of Health & Human Services,Centers for Medicare & Medicaid Services,null,98.06606405213282,98.93284904208315,111182668,11523,5637853029,1068268,31,12,4,2023,2023-12-31,1,2024,5749035697,1079791
Bureau,Small Business Administration,Small Business Administration,null,100.0,100.0,0,0,19752855663,164128,31,12,4,2023,2023-12-31,1,2024,19752855663,164128
Bureau,Department of Education,Federal Student Aid,null,97.03609635133219,96.61017841168868,3405470186,682744,111492670566,19458257,31,12,4,2023,2023-12-31,1,2024,114898140752,20141001
Agency,Funds Appropriated to the President,null,Non-CFO,0.15170388177760114,12.5,1236060,7,1878,1,31,12,4,2023,2023-12-31,1,2024,1237938,8
Agency,Presidio Trust Corporation,null,Non-CFO,100.0,100.0,0,0,1337667,60,31,12,4,2023,2023-12-31,1,2024,1337667,60
Agency,Federal Election Commission,null,Non-CFO,100.0,100.0,0,0,2928612,380,31,12,4,2023,2023-12-31,1,2024,2928612,380
Agency,Securities & Exchange Commission,null,Non-CFO,100.0,100.0,0,0,2904129432,1603,31,12,4,2023,2023-12-31,1,2024,2904129432,1603
Bureau,Department of the Treasury,Office of the Secretary,null,0.0,0.0,0,0,0,0,31,12,4,2023,2023-12-31,1,2024,0,0
Bureau,Department of Homeland Security,U.S. Secret Service,null,0.0,0.0,0,0,0,0,31,12,4,2023,2023-12-31,1,2024,0,0
Bureau,Department of Homeland Security,Science and Technology,null,0.0,0.0,0,0,0,0,31,12,4,2023,2023-12-31,1,2024,0,0
Bureau,Department of the Treasury,International Monetary Funds,null,0.0,0.0,0,0,0,0,31,12,4,2023,2023-12-31,1,2024,0,0
Bureau,Department of Homeland Security,Office of Biometric Identity Management,null,0.0,0.0,0,0,0,0,31,12,4,2023,2023-12-31,1,2024,0,0
Agency,Agency for International Development,null,CFO,99.99903918022434,98.18181818181819,273,1,28412964,54,31,12,4,2023,2023-12-31,1,2024,28413237,55
Agency,Environmental Protection Agency,null,CFO,99.97649928426439,99.19354838709677,6679,2,28413732,246,31,12,4,2023,2023-12-31,1,2024,28420411,248
Agency,National Archives & Records Admin,null,Non-CFO,100.0,100.0,0,0,127725,117,31,12,4,2023,2023-12-31,1,2024,127725,117
Agency,Legislative Branch - U.S. House/Senate,null,Non-CFO,0.0,0.0,325235,230,0,0,31,12,4,2023,2023-12-31,1,2024,325235,230
Agency,Federal Maritime Commission,null,Non-CFO,100.0,100.0,0,0,397569,6,31,12,4,2023,2023-12-31,1,2024,397569,6
Agency,Other Agencies,null,Non-CFO,70.16330341151472,15.555555555555555,223396,38,525333,7,31,12,4,2023,2023-12-31,1,2024,748729,45
Agency,The Judiciary,null,Non-CFO,96.55650219132538,56.86274509803921,36457,132,1022263,174,31,12,4,2023,2023-12-31,1,2024,1058720,306
Bureau,Department of the Treasury,Community Dev Financial Inst Fund,null,100.0,100.0,0,0,3623095,7,31,12,4,2023,2023-12-31,1,2024,3623095,7
Bureau,Department of Health & Human Services,National Institutes of Health,null,32.653924466379756,26.824817518248175,17055100,401,8269464,147,31,12,4,2023,2023-12-31,1,2024,25324564,548
Bureau,Department of State,Passport NSF,null,100.0,100.0,0,0,1725514,11146,31,12,4,2023,2023-12-31,1,2024,1725514,11146
Bureau,Department of Transportation,Federal Motor Carrier Safety Admin,null,99.99113006164157,99.95383727639931,6900,4,77783945,8661,31,12,4,2023,2023-12-31,1,2024,77790845,8665
Bureau,Federal Trade Commission,Federal Trade Commission,null,100.0,100.0,0,0,652607559,67,31,12,4,2023,2023-12-31,1,2024,652607559,67
Bureau,Department of the Treasury,Interest on Tax/Deposit of Earnings,null,0.0,0.0,0,0,0,0,31,12,4,2023,2023-12-31,1,2024,0,0
Bureau,Smithsonian Institution,JFK Center for the Performing Arts,null,0.0,0.0,0,0,0,0,31,12,4,2023,2023-12-31,1,2024,0,0
Bureau,Department of Homeland Security,Management Headquarters,null,0.0,0.0,0,0,0,0,31,12,4,2023,2023-12-31,1,2024,0,0
Bureau,Federal Mediation/Conciliation Service,Federal Mediation/Conciliation Service,null,0.0,0.0,0,0,0,0,31,12,4,2023,2023-12-31,1,2024,0,0
Bureau,Other Agencies,U.S. Holocaust Memorial Council,null,0.0,0.0,0,0,0,0,31,12,4,2023,2023-12-31,1,2024,0,0
Bureau,Other Agencies,Comm. for Purchase from Blind/Handic.,null,0.0,0.0,0,0,0,0,31,12,4,2023,2023-12-31,1,2024,0,0
Bureau,Department of Commerce,NOAA,null,100.0,100.0,0,0,12517698,814,31,12,4,2023,2023-12-31,1,2024,12517698,814
Bureau,Department of Energy,Energy Consolidated Reports,null,100.0,100.0,0,0,12701054,72,31,12,4,2023,2023-12-31,1,2024,12701054,72
Bureau,Department of Health & Human Services,Office of the Secretary,null,100.0,100.0,0,0,11751654,538,31,12,4,2023,2023-12-31,1,2024,11751654,538
Agency,Department of Commerce,null,CFO,100.0,100.0,0,0,59036810,7982,31,12,4,2023,2023-12-31,1,2024,59036810,7982
Agency,Department of Housing and Urban Development,null,CFO,99.75725399287825,99.86120749479528,170789,4,70186290,2878,31,12,4,2023,2023-12-31,1,2024,70357079,2882
Agency,National Foundation  Arts & Humanities,null,Non-CFO,0.0,0.0,0,0,0,0,31,12,4,2023,2023-12-31,1,2024,0,0
Bureau,Federal Labor Relations Authority,Federal Labor Relations Authority,null,0.0,0.0,0,0,0,0,31,12,4,2023,2023-12-31,1,2024,0,0
Bureau,Department of Education,Office of Postsecondary Education,null,0.0,0.0,0,0,0,0,31,12,4,2023,2023-12-31,1,2024,0,0
Bureau,Occupational Safety & Health Rev Comm,Occupational Safety & Health Rev Comm,null,0.0,0.0,0,0,0,0,31,12,4,2023,2023-12-31,1,2024,0,0
Bureau,Other Agencies,Council of Insps. Gen. of Intg. & Effy.,null,0.0,0.0,0,0,0,0,31,12,4,2023,2023-12-31,1,2024,0,0
Bureau,Other Agencies,Privacy & Civil Liberties Oversight Bd,null,0.0,0.0,0,0,0,0,31,12,4,2023,2023-12-31,1,2024,0,0
Bureau,Funds Appropriated to the President,African Development Foundation,null,100.0,100.0,0,0,1878,1,31,12,4,2023,2023-12-31,1,2024,1878,1
Bureau,Department of Homeland Security,Domestic Nuclear Detection Office,null,0.0,0.0,4321,24,0,0,31,12,4,2023,2023-12-31,1,2024,4321,24
Bureau,Department of Housing and Urban Development,Government National Mortgage Association,null,0.0,0.0,148564,1,0,0,31,12,4,2023,2023-12-31,1,2024,148564,1
Bureau,Department of the Treasury,Bureau of Engraving and Printing,null,0.0,0.0,360275,4,0,0,31,12,4,2023,2023-12-31,1,2024,360275,4
Bureau,Federal Maritime Commission,Salaries and Expenses,null,100.0,100.0,0,0,397569,6,31,12,4,2023,2023-12-31,1,2024,397569,6
Bureau,Nuclear Regulatory Commission,Nuclear Regulatory Commission,null,100.0,100.0,0,0,3168984,356,31,12,4,2023,2023-12-31,1,2024,3168984,356
Bureau,Legislative Branch-CBO,Congressional Budget Office,null,0.0,0.0,0,0,0,0,31,12,4,2023,2023-12-31,1,2024,0,0
Agency,Department of Veterans Affairs,null,CFO,96.50143293950092,99.86232382276374,7091575,4920,195607841,3568683,31,03,1,2024,2024-03-31,2,2024,202699416,3573603
Agency,Merit Systems Protection Board,null,Non-CFO,100.0,100.0,0,0,144,1,31,03,1,2024,2024-03-31,2,2024,144,1
Bureau,Other Agencies,Denali Commission,null,0.0,0.0,0,0,0,0,31,03,1,2024,2024-03-31,2,2024,0,0
Bureau,Federal Mediation/Conciliation Service,Federal Mediation/Conciliation Service,null,0.0,0.0,0,0,0,0,31,03,1,2024,2024-03-31,2,2024,0,0
Agency,Armed Forces Retirement Home,null,Non-CFO,69.44771940166531,98.91304347826087,33170,1,75398,91,31,03,1,2024,2024-03-31,2,2024,108568,92
Bureau,Armed Forces Retirement Home,Armed Forces Retirement Home,null,69.44771940166531,98.91304347826087,33170,1,75398,91,31,03,1,2024,2024-03-31,2,2024,108568,92
Bureau,Legis Branch-Library of Congress,Library of Congress,null,0.0,0.0,0,0,0,0,31,03,1,2024,2024-03-31,2,2024,0,0
Bureau,Legislative Branch-Office of Tech.,Open World Leadership,null,0.0,0.0,0,0,0,0,31,03,1,2024,2024-03-31,2,2024,0,0
Bureau,Department of State,International Commissions,null,0.0,0.0,0,0,0,0,31,03,1,2024,2024-03-31,2,2024,0,0
Bureau,Other Agencies,Gulf Coast Ecosystem Restoration Council,null,0.0,0.0,0,0,0,0,31,03,1,2024,2024-03-31,2,2024,0,0
Agency,Environmental Protection Agency,null,CFO,100.0,100.0,0,0,28612461,249,31,03,1,2024,2024-03-31,2,2024,28612461,249
Bureau,Department of the Treasury,Departmental Offices,null,99.90445679328916,99.92418498862774,20005,1,20918166,1318,31,03,1,2024,2024-03-31,2,2024,20938171,1319
Bureau,Department of State,Department of State,null,98.0604648627493,99.10264166162533,414886,89,20976116,9829,31,03,1,2024,2024-03-31,2,2024,21391002,9918
Bureau,Department of Agriculture,U.S. Department of Agriculture,null,82.44631298320631,56.99106496015455,4093385,1781,19225847,2360,31,03,1,2024,2024-03-31,2,2024,23319232,4141
Agency,Presidio Trust Corporation,null,Non-CFO,100.0,100.0,0,0,1343620,60,31,03,1,2024,2024-03-31,2,2024,1343620,60
Agency,Federal Deposit Insurance Corporation,null,Non-CFO,0.0,0.0,0,0,0,0,31,03,1,2024,2024-03-31,2,2024,0,0
Agency,Other Agencies/Boards/Commissions,null,Non-CFO,0.0,0.0,1024,1,0,0,31,03,1,2024,2024-03-31,2,2024,1024,1
Bureau,Department of the Treasury,U.S. Treasury IG Office,null,0.0,0.0,0,0,0,0,31,03,1,2024,2024-03-31,2,2024,0,0
Bureau,Funds Appropriated to the President,Inter-American Foundation,null,0.0,0.0,0,0,0,0,31,03,1,2024,2024-03-31,2,2024,0,0
Bureau,Other Agencies,Defense Nuclear Facilities Safety Board,null,0.0,0.0,0,0,0,0,31,03,1,2024,2024-03-31,2,2024,0,0
Bureau,Department of the Treasury,Tobacco Tax and Trade,null,100.0,100.0,0,0,1000,1,31,03,1,2024,2024-03-31,2,2024,1000,1
Agency,Other Agencies,null,Non-CFO,70.19732091623676,14.285714285714286,217100,36,511358,6,31,03,1,2024,2024-03-31,2,2024,728458,42
Agency,Pension Benefit Guaranty Corp,null,Non-CFO,100.0,100.0,0,0,4818938,1601,31,03,1,2024,2024-03-31,2,2024,4818938,1601
Bureau,Funds Appropriated to the President,Executive Branch,null,0.0,0.0,0,0,0,0,31,03,1,2024,2024-03-31,2,2024,0,0
Bureau,National Credit Union Administration,National Credit Union Administration,null,100.0,100.0,0,0,1373,2,31,03,1,2024,2024-03-31,2,2024,1373,2
Bureau,Department of Justice,Drug Enforcement Administration,null,100.0,100.0,0,0,343135,15,31,03,1,2024,2024-03-31,2,2024,343135,15
Bureau,Office of Personnel Management,Office of Personnel Management,null,100.0,100.0,0,0,15868250,881,31,03,1,2024,2024-03-31,2,2024,15868250,881
Agency,National Science Foundation,null,CFO,99.9115831618751,96.55172413793103,636,1,718684,28,31,03,1,2024,2024-03-31,2,2024,719320,29
Agency,Nuclear Regulatory Commission,null,CFO,100.0,100.0,0,0,3246047,356,31,03,1,2024,2024-03-31,2,2024,3246047,356
Bureau,Department of Commerce,General Administration,null,0.0,0.0,0,0,0,0,31,03,1,2024,2024-03-31,2,2024,0,0
Agency,National Archives & Records Admin,null,Non-CFO,99.93004669383187,98.9247311827957,80,1,114282,92,31,03,1,2024,2024-03-31,2,2024,114362,93
Agency,Federal Maritime Commission,null,Non-CFO,100.0,100.0,0,0,466589,7,31,03,1,2024,2024-03-31,2,2024,466589,7
Agency,The Judiciary,null,Non-CFO,98.85438514053003,57.92880258899677,11995,130,1035041,179,31,03,1,2024,2024-03-31,2,2024,1047036,309
Agency,Funds Appropriated to the President,null,Non-CFO,0.0,0.0,1236060,7,0,0,31,03,1,2024,2024-03-31,2,2024,1236060,7
Agency,Federal Election Commission,null,Non-CFO,100.0,100.0,0,0,2997472,385,31,03,1,2024,2024-03-31,2,2024,2997472,385
Agency,Railroad Retirement Board,null,Non-CFO,100.0,100.0,0,0,24878995,2449,31,03,1,2024,2024-03-31,2,2024,24878995,2449
Agency,Commodity Futures Trading Commission,null,Non-CFO,100.0,100.0,0,0,630758270,359,31,03,1,2024,2024-03-31,2,2024,630758270,359
Agency,Federal Trade Commission,null,Non-CFO,100.0,100.0,0,0,701640302,75,31,03,1,2024,2024-03-31,2,2024,701640302,75
Bureau,Other Agencies,National Transportation Safety Board,null,0.0,0.0,0,0,0,0,31,03,1,2024,2024-03-31,2,2024,0,0
Bureau,Other Agencies,Federal Housing Finance Agency OIG,null,0.0,0.0,0,0,0,0,31,03,1,2024,2024-03-31,2,2024,0,0
Agency,Securities & Exchange Commission,null,Non-CFO,100.0,100.0,0,0,3127384644,1704,31,03,1,2024,2024-03-31,2,2024,3127384644,1704
Bureau,Department of Commerce,Office of the Inspector General,null,0.0,0.0,0,0,0,0,31,03,1,2024,2024-03-31,2,2024,0,0
Bureau,Department of Commerce,National Technical Information Service,null,0.0,0.0,0,0,0,0,31,03,1,2024,2024-03-31,2,2024,0,0
Bureau,Department of the Treasury,Office of the Secretary,null,0.0,0.0,0,0,0,0,31,03,1,2024,2024-03-31,2,2024,0,0
Bureau,Department of Transportation,Office of the Inspector General,null,0.0,0.0,0,0,0,0,31,03,1,2024,2024-03-31,2,2024,0,0
Bureau,Other Agencies,Chemical Safety Board,null,0.0,0.0,0,0,0,0,31,03,1,2024,2024-03-31,2,2024,0,0
Bureau,Other Agencies,District of Columbia Government,null,0.0,0.0,0,0,0,0,31,03,1,2024,2024-03-31,2,2024,0,0
Bureau,Smithsonian Institution,Administrative Conference of the US,null,0.0,0.0,0,0,0,0,31,03,1,2024,2024-03-31,2,2024,0,0
Bureau,Department of Homeland Security,Office of Biometric Identity Management,null,0.0,0.0,0,0,0,0,31,03,1,2024,2024-03-31,2,2024,0,0
Agency,Social Security Administration,null,CFO,54.65488905163852,30.210078345450572,1943917970,922777,2343022627,399444,31,03,1,2024,2024-03-31,2,2024,4286940597,1322221
Agency,Export - Import  Bank,null,Non-CFO,0.0,0.0,0,0,0,0,31,03,1,2024,2024-03-31,2,2024,0,0
Agency,American Battle Monuments Commission,null,Non-CFO,0.0,0.0,0,0,0,0,31,03,1,2024,2024-03-31,2,2024,0,0
Agency,Consumer Product Safety Commission,null,Non-CFO,100.0,100.0,0,0,420,2,31,03,1,2024,2024-03-31,2,2024,420,2
Agency,Farm Credit Administration,null,Non-CFO,100.0,100.0,0,0,630,1,31,03,1,2024,2024-03-31,2,2024,630,1
Agency,Selective Service System,null,Non-CFO,0.0,0.0,1301,2,0,0,31,03,1,2024,2024-03-31,2,2024,1301,2
Agency,National Credit Union Administration,null,Non-CFO,100.0,100.0,0,0,1373,2,31,03,1,2024,2024-03-31,2,2024,1373,2
Agency,Smithsonian Institution,null,Non-CFO,0.0,0.0,8262,21,0,0,31,03,1,2024,2024-03-31,2,2024,8262,21
Agency,Equal Employment Opportunity Commission,null,Non-CFO,100.0,100.0,0,0,24513,22,31,03,1,2024,2024-03-31,2,2024,24513,22
Bureau,National Archives & Records Admin,Nat'l Archives & Records Administration,null,99.93004669383187,98.9247311827957,80,1,114282,92,31,03,1,2024,2024-03-31,2,2024,114362,93
Bureau,Department of Transportation,Federal Railroad Administration,null,100.0,100.0,0,0,144874,12,31,03,1,2024,2024-03-31,2,2024,144874,12
Bureau,Department of the Treasury,U.S. Mint,null,13.350154834269985,90.47619047619048,143545,2,22116,19,31,03,1,2024,2024-03-31,2,2024,165661,21
Bureau,Department of the Interior,Geological Survey,null,100.0,100.0,0,0,168506,485,31,03,1,2024,2024-03-31,2,2024,168506,485
Bureau,Department of Housing and Urban Development,Government National Mortgage Association,null,0.0,0.0,218994,7,0,0,31,03,1,2024,2024-03-31,2,2024,218994,7
Bureau,Department of the Treasury,Internal Revenue Service,null,100.0,100.0,0,0,119803,42,31,03,1,2024,2024-03-31,2,2024,119803,42
Bureau,Department of Homeland Security,Citizenship and Immigration Services,null,100.0,100.0,0,0,1236530,1536,31,03,1,2024,2024-03-31,2,2024,1236530,1536
Bureau,Department of Transportation,Pipeline Hazardous Material Safety Admin,null,100.0,100.0,0,0,1257058,98,31,03,1,2024,2024-03-31,2,2024,1257058,98
Bureau,Presidio Trust Corporation,Presidio Trust Corporation,null,100.0,100.0,0,0,1343620,60,31,03,1,2024,2024-03-31,2,2024,1343620,60
Bureau,Department of the Treasury,Community Dev Financial Inst Fund,null,100.0,100.0,0,0,3623095,7,31,03,1,2024,2024-03-31,2,2024,3623095,7
Bureau,Department of the Treasury,Pandemic Receivables,null,100.0,100.0,0,0,3701819,6,31,03,1,2024,2024-03-31,2,2024,3701819,6
Bureau,Corp. for National and Community Service,Corp. for National and Community Service,null,92.55107103937188,39.41018766756032,289889,226,3601798,147,31,03,1,2024,2024-03-31,2,2024,3891687,373
Bureau,Department of Transportation,Federal Aviation Administration,null,100.0,100.0,0,0,4489917,527,31,03,1,2024,2024-03-31,2,2024,4489917,527
Bureau,Pension Benefit Guaranty Corp,Pension Benefit Guaranty Corporation,null,100.0,100.0,0,0,4818938,1601,31,03,1,2024,2024-03-31,2,2024,4818938,1601
Bureau,Department of Agriculture,Agricultural Marketing Service,null,77.58722158965658,58.08713069604406,1108220,837,3836370,1160,31,03,1,2024,2024-03-31,2,2024,4944590,1997
Bureau,Department of Commerce,Economic Development Administration,null,100.0,100.0,0,0,5120584,11,31,03,1,2024,2024-03-31,2,2024,5120584,11
Bureau,Department of Veterans Affairs,Administration and Cemeteries,null,15.305126452149805,36.59378596087457,4361963,551,788246,318,31,03,1,2024,2024-03-31,2,2024,5150209,869
Bureau,Department of Health & Human Services,Centers for Disease Control,null,14.76721178991374,16.666666666666668,5610802,100,972113,20,31,03,1,2024,2024-03-31,2,2024,6582915,120
Bureau,Federal Trade Commission,Federal Trade Commission,null,100.0,100.0,0,0,701640302,75,31,03,1,2024,2024-03-31,2,2024,701640302,75
Bureau,Department of Agriculture,Rural Development,null,99.99912110374295,99.97504456327985,7197,7,818860780,28043,31,03,1,2024,2024-03-31,2,2024,818867977,28050
Bureau,Department of Education,Departmental Management,null,99.62931147895887,96.28557645923782,4471534,77,1201806445,1996,31,03,1,2024,2024-03-31,2,2024,1206277979,2073
Bureau,Department of Defense,Consolidated Report,null,36.60638979042152,17.76929038621872,1883691300,1400537,1087730100,302643,31,03,1,2024,2024-03-31,2,2024,2971421400,1703180
Bureau,Securities & Exchange Commission,SEC Enforcement,null,100.0,100.0,0,0,3127127944,1660,31,03,1,2024,2024-03-31,2,2024,3127127944,1660
Bureau,Social Security Administration,Social Security Administration,null,54.65488905163852,30.210078345450572,1943917970,922777,2343022627,399444,31,03,1,2024,2024-03-31,2,2024,4286940597,1322221
Bureau,Office of Compliance,Office of Compliance,null,0.0,0.0,0,0,0,0,31,03,1,2024,2024-03-31,2,2024,0,0
Bureau,Occupational Safety & Health Rev Comm,Occupational Safety & Health Rev Comm,null,0.0,0.0,0,0,0,0,31,03,1,2024,2024-03-31,2,2024,0,0
Bureau,Other Agencies,National Council on Disability,null,0.0,0.0,0,0,0,0,31,03,1,2024,2024-03-31,2,2024,0,0
Bureau,Other Agencies,Millennium Challenge Corporation,null,0.0,0.0,0,0,0,0,31,03,1,2024,2024-03-31,2,2024,0,0
Bureau,Department of the Treasury,Office of Financial Research,null,100.0,100.0,0,0,268,1,31,03,1,2024,2024-03-31,2,2024,268,1
Bureau,Department of Agriculture,Food and Nutrition Service,null,82.06239723248414,75.0,8400,5,38429,15,31,03,1,2024,2024-03-31,2,2024,46829,20
Bureau,Department of Transportation,Office of the Secretary,null,100.0,100.0,0,0,1156735,15,31,03,1,2024,2024-03-31,2,2024,1156735,15
Bureau,Department of Veterans Affairs,Veterans Benefits,null,0.0,0.0,1227103,1632,0,0,31,03,1,2024,2024-03-31,2,2024,1227103,1632
Bureau,Department of Veterans Affairs,Life Insurance,null,100.0,100.0,0,0,1227637,255,31,03,1,2024,2024-03-31,2,2024,1227637,255
Bureau,Department of Housing and Urban Development,Public and Indian Housing Programs,null,100.0,100.0,0,0,1355432,7,31,03,1,2024,2024-03-31,2,2024,1355432,7
Bureau,Department of the Treasury,Comptroller of the Currency,null,99.5103700738189,57.5,6800,17,1382004,23,31,03,1,2024,2024-03-31,2,2024,1388804,40
Bureau,Department of Labor,Employment and Training Administration,null,100.0,100.0,0,0,1423363,13,31,03,1,2024,2024-03-31,2,2024,1423363,13
Bureau,Department of the Treasury,Financial Crimes Enforcement Network,null,100.0,100.0,0,0,1544945,3,31,03,1,2024,2024-03-31,2,2024,1544945,3
Bureau,Department of State,Passport NSF,null,100.0,100.0,0,0,1688737,10878,31,03,1,2024,2024-03-31,2,2024,1688737,10878
Bureau,Department of Agriculture,Food Safety and Inspection Service,null,95.82332295921445,98.55072463768116,70617,44,1620129,2992,31,03,1,2024,2024-03-31,2,2024,1690746,3036
Bureau,Department of Commerce,Bureau of the Census,null,100.0,100.0,0,0,1958543,6005,31,03,1,2024,2024-03-31,2,2024,1958543,6005
Bureau,Department of Homeland Security,Immigration and Customs Enforcement,null,100.0,100.0,0,0,17049916,683,31,03,1,2024,2024-03-31,2,2024,17049916,683
Bureau,Department of the Interior,Bureau of Indian Affairs,null,99.9707112530102,99.76787203946175,5952,64,20315846,27507,31,03,1,2024,2024-03-31,2,2024,20321798,27571
Agency,Agency for International Development,null,CFO,99.99904299775885,98.18181818181819,272,1,28421814,54,31,03,1,2024,2024-03-31,2,2024,28422086,55
Agency,Department of Housing and Urban Development,null,CFO,99.67978676326246,99.72352778545756,269668,10,83945464,3607,31,03,1,2024,2024-03-31,2,2024,84215132,3617
Agency,Department of Justice,null,CFO,97.29392052192024,98.5559657449961,2516744,575,90486585,39244,31,03,1,2024,2024-03-31,2,2024,93003329,39819
Agency,Department of Labor,null,CFO,88.57799474492005,70.3740278977904,20072994,4800,155666673,11402,31,03,1,2024,2024-03-31,2,2024,175739667,16202
Agency,Office of Government Ethics,null,Non-CFO,0.0,0.0,0,0,0,0,31,03,1,2024,2024-03-31,2,2024,0,0
Agency,National Labor Relations Board,null,Non-CFO,0.0,0.0,0,0,0,0,31,03,1,2024,2024-03-31,2,2024,0,0
Agency,Office of Compliance,null,Non-CFO,0.0,0.0,0,0,0,0,31,03,1,2024,2024-03-31,2,2024,0,0
Bureau,Department of the Treasury,Interest on Tax/Deposit of Earnings,null,0.0,0.0,0,0,0,0,31,03,1,2024,2024-03-31,2,2024,0,0
Bureau,Department of the Treasury,Treasury Forfeiture Fund,null,0.0,0.0,0,0,0,0,31,03,1,2024,2024-03-31,2,2024,0,0
Bureau,Federal Deposit Insurance Corporation,Federal Deposit Insurance Corporation,null,0.0,0.0,0,0,0,0,31,03,1,2024,2024-03-31,2,2024,0,0
Bureau,Other Agencies,Architect of the Capitol,null,0.0,0.0,0,0,0,0,31,03,1,2024,2024-03-31,2,2024,0,0
Bureau,Other Agencies,Morris K. Udall Scholarship,null,0.0,0.0,0,0,0,0,31,03,1,2024,2024-03-31,2,2024,0,0
Bureau,Other Agencies,Commission On Fine Arts,null,0.0,0.0,0,0,0,0,31,03,1,2024,2024-03-31,2,2024,0,0
Bureau,Other Agencies,Election Assistance Commission,null,0.0,0.0,0,0,0,0,31,03,1,2024,2024-03-31,2,2024,0,0
Bureau,Department of the Treasury,International Monetary Funds,null,0.0,0.0,0,0,0,0,31,03,1,2024,2024-03-31,2,2024,0,0
Bureau,Other Agencies,Council of Insps. Gen. of Intg. & Effy.,null,0.0,0.0,0,0,0,0,31,03,1,2024,2024-03-31,2,2024,0,0
Bureau,Other Agencies,Surface Transportation Board,null,0.0,0.0,0,0,0,0,31,03,1,2024,2024-03-31,2,2024,0,0
Bureau,Department of the Treasury,Treasury Franchise Fund,null,0.0,0.0,0,0,0,0,31,03,1,2024,2024-03-31,2,2024,0,0
Bureau,Department of Labor,Bureau of Labor Statistics,null,100.0,100.0,0,0,4782,1,31,03,1,2024,2024-03-31,2,2024,4782,1
Agency,National Aeronautics and Space Administration,null,CFO,100.0,100.0,0,0,1075789,132,31,03,1,2024,2024-03-31,2,2024,1075789,132
Agency,General Services Administration,null,CFO,100.0,100.0,0,0,10027350,382,31,03,1,2024,2024-03-31,2,2024,10027350,382
Agency,Department of Energy,null,CFO,100.0,100.0,0,0,13773303,104,31,03,1,2024,2024-03-31,2,2024,13773303,104
Agency,Office of Personnel Management,null,CFO,100.0,100.0,0,0,15868250,881,31,03,1,2024,2024-03-31,2,2024,15868250,881
Agency,Department of State,null,CFO,98.2023800182489,99.57203308328525,414886,89,22664853,20707,31,03,1,2024,2024-03-31,2,2024,23079739,20796
Agency,Department of the Treasury,null,CFO,98.8145014009244,99.47414548641542,550580,24,45892326,4540,31,03,1,2024,2024-03-31,2,2024,46442906,4564
Agency,Department of the Interior,null,CFO,99.9926301156974,99.7981072555205,5952,64,80755153,31636,31,03,1,2024,2024-03-31,2,2024,80761105,31700
Agency,Department of Transportation,null,CFO,99.9711866886275,99.91655366642328,25656,8,89016522,9579,31,03,1,2024,2024-03-31,2,2024,89042178,9587
Agency,Department of Health & Human Services,null,CFO,96.31729912755311,97.45578403013357,239644995,29632,6267671328,1135049,31,03,1,2024,2024-03-31,2,2024,6507316323,1164681
Agency,Small Business Administration,null,CFO,100.0,100.0,0,0,57217803197,771093,31,03,1,2024,2024-03-31,2,2024,57217803197,771093
Agency,Department of Education,null,CFO,97.34769113019772,96.94138304155315,3062375384,598466,112398362197,18968090,31,03,1,2024,2024-03-31,2,2024,115460737581,19566556
Agency,Legislative Branch-Office of Tech.,null,Non-CFO,0.0,0.0,0,0,0,0,31,03,1,2024,2024-03-31,2,2024,0,0
Agency,Legislative Branch - U.S. House/Senate,null,Non-CFO,0.0,0.0,349877,240,0,0,31,03,1,2024,2024-03-31,2,2024,349877,240
Bureau,Office of Special Counsel,Office of Special Counsel,null,0.0,0.0,0,0,0,0,31,03,1,2024,2024-03-31,2,2024,0,0
Bureau,National Foundation  Arts & Humanities,National Endowment for the Arts,null,0.0,0.0,0,0,0,0,31,03,1,2024,2024-03-31,2,2024,0,0
Bureau,Other Agencies/Boards/Commissions,Medicare Payment Advisory Commission,null,0.0,0.0,0,0,0,0,31,03,1,2024,2024-03-31,2,2024,0,0
Bureau,Other Agencies,National Mediation Board,null,0.0,0.0,0,0,0,0,31,03,1,2024,2024-03-31,2,2024,0,0
Bureau,US International Development Fin. Corp.,US International Development Fin. Corp.,null,0.0,0.0,0,0,0,0,31,03,1,2024,2024-03-31,2,2024,0,0
Bureau,Department of Commerce,Nat'l Institute of Standards& Technology,null,100.0,100.0,0,0,992651,5,31,03,1,2024,2024-03-31,2,2024,992651,5
Agency,Federal Mediation/Conciliation Service,null,Non-CFO,0.0,0.0,0,0,0,0,31,03,1,2024,2024-03-31,2,2024,0,0
Agency,Neighborhood Reinvestment Corporation,null,Non-CFO,0.0,0.0,0,0,0,0,31,03,1,2024,2024-03-31,2,2024,0,0
Agency,Legis Branch-Library of Congress,null,Non-CFO,0.0,0.0,0,0,0,0,31,03,1,2024,2024-03-31,2,2024,0,0
Agency,Office of Special Counsel,null,Non-CFO,0.0,0.0,0,0,0,0,31,03,1,2024,2024-03-31,2,2024,0,0
Agency,Legislative Branch-CBO,null,Non-CFO,0.0,0.0,0,0,0,0,31,03,1,2024,2024-03-31,2,2024,0,0
Agency,Tennessee Valley Authority,null,Non-CFO,0.0,0.0,0,0,0,0,31,03,1,2024,2024-03-31,2,2024,0,0
Agency,U.S. Tax Court,null,Non-CFO,0.0,0.0,0,0,0,0,31,03,1,2024,2024-03-31,2,2024,0,0
Agency,US International Development Fin. Corp.,null,Non-CFO,0.0,0.0,0,0,0,0,31,03,1,2024,2024-03-31,2,2024,0,0
Agency,U.S. Court of Appeals / Veterans Claims,null,Non-CFO,0.0,0.0,0,0,0,0,31,03,1,2024,2024-03-31,2,2024,0,0
Agency,National Foundation  Arts & Humanities,null,Non-CFO,0.0,0.0,0,0,0,0,31,03,1,2024,2024-03-31,2,2024,0,0
Agency,Federal Labor Relations Authority,null,Non-CFO,0.0,0.0,0,0,0,0,31,03,1,2024,2024-03-31,2,2024,0,0
Agency,Occupational Safety & Health Rev Comm,null,Non-CFO,0.0,0.0,0,0,0,0,31,03,1,2024,2024-03-31,2,2024,0,0
Agency,Legislative Branch-GAO,null,Non-CFO,0.0,0.0,0,0,0,0,31,03,1,2024,2024-03-31,2,2024,0,0
Bureau,Legislative Branch-GPO,Government Publishing Office,null,0.0,0.0,0,0,0,0,31,03,1,2024,2024-03-31,2,2024,0,0
Bureau,Legislative Branch-GAO,Government Accountability Office,null,0.0,0.0,0,0,0,0,31,03,1,2024,2024-03-31,2,2024,0,0
Bureau,Funds Appropriated to the President,Peace Corps,null,0.0,0.0,0,0,0,0,31,03,1,2024,2024-03-31,2,2024,0,0
Bureau,National Foundation  Arts & Humanities,National Endowment for the Humanities,null,0.0,0.0,0,0,0,0,31,03,1,2024,2024-03-31,2,2024,0,0
Bureau,National Labor Relations Board,National Labor Relations Board,null,0.0,0.0,0,0,0,0,31,03,1,2024,2024-03-31,2,2024,0,0
Bureau,Department of Education,Office of Postsecondary Education,null,0.0,0.0,0,0,0,0,31,03,1,2024,2024-03-31,2,2024,0,0
Bureau,Other Agencies,U.S. Holocaust Memorial Council,null,0.0,0.0,0,0,0,0,31,03,1,2024,2024-03-31,2,2024,0,0
Bureau,Department of Commerce,Minority Business Development Agency,null,0.0,0.0,0,0,0,0,31,03,1,2024,2024-03-31,2,2024,0,0
Bureau,Smithsonian Institution,JFK Center for the Performing Arts,null,0.0,0.0,0,0,0,0,31,03,1,2024,2024-03-31,2,2024,0,0
Bureau,Other Agencies/Boards/Commissions,Nuclear Waste Technical Review Board,null,0.0,0.0,0,0,0,0,31,03,1,2024,2024-03-31,2,2024,0,0
Bureau,Tennessee Valley Authority,Tennessee Valley Authority,null,0.0,0.0,0,0,0,0,31,03,1,2024,2024-03-31,2,2024,0,0
Bureau,Other Agencies,Advisory Council on Hist. Preservation,null,0.0,0.0,0,0,0,0,31,03,1,2024,2024-03-31,2,2024,0,0
Bureau,Department of Energy,Energy Consolidated Reports,null,100.0,100.0,0,0,12714833,76,31,03,1,2024,2024-03-31,2,2024,12714833,76
Bureau,Department of Labor,Mine Safety and Health Administration,null,73.772506844884,68.23149145759581,4041957,2064,11369188,4433,31,03,1,2024,2024-03-31,2,2024,15411145,6497
Bureau,Department of Labor,Employee Benefit Security Administration,null,100.0,100.0,0,0,20713277,447,31,03,1,2024,2024-03-31,2,2024,20713277,447
Agency,Federal Communications Commission,null,Non-CFO,100.0,100.0,0,0,252531990,12468,31,03,1,2024,2024-03-31,2,2024,252531990,12468
Bureau,Department of Justice,General Administration,null,0.0,0.0,0,0,0,0,31,03,1,2024,2024-03-31,2,2024,0,0
Bureau,Federal Labor Relations Authority,Federal Labor Relations Authority,null,0.0,0.0,0,0,0,0,31,03,1,2024,2024-03-31,2,2024,0,0
Bureau,Other Agencies,U.S. Institute of Peace,null,0.0,0.0,0,0,0,0,31,03,1,2024,2024-03-31,2,2024,0,0
Bureau,Other Agencies/Boards/Commissions,U.S. Comm. on Int. Religious Freedom,null,0.0,0.0,1024,1,0,0,31,03,1,2024,2024-03-31,2,2024,1024,1
Bureau,Selective Service System,Selective Service System,null,0.0,0.0,1301,2,0,0,31,03,1,2024,2024-03-31,2,2024,1301,2
Bureau,Department of Transportation,Research Innovative Technology Admin,null,100.0,100.0,0,0,3472,4,31,03,1,2024,2024-03-31,2,2024,3472,4
Bureau,Department of Homeland Security,Domestic Nuclear Detection Office,null,0.0,0.0,3752,27,0,0,31,03,1,2024,2024-03-31,2,2024,3752,27
Bureau,Department of Transportation,Federal Highway Administration,null,100.0,100.0,0,0,10438,8,31,03,1,2024,2024-03-31,2,2024,10438,8
Bureau,Department of the Interior,Bureau of Safety and Environmental Enf.,null,100.0,100.0,0,0,14064,2,31,03,1,2024,2024-03-31,2,2024,14064,2
Bureau,Department of Housing and Urban Development,Management and Administration,null,100.0,100.0,0,0,55945,53,31,03,1,2024,2024-03-31,2,2024,55945,53
Bureau,Securities & Exchange Commission,Securities and Exchange Commission,null,100.0,100.0,0,0,256700,44,31,03,1,2024,2024-03-31,2,2024,256700,44
Bureau,Department of Commerce,Nat'l Telecomm & Information Admin.,null,100.0,100.0,0,0,296093,1,31,03,1,2024,2024-03-31,2,2024,296093,1
Bureau,Department of Transportation,Maritime Administration,null,100.0,100.0,0,0,304542,19,31,03,1,2024,2024-03-31,2,2024,304542,19
Agency,Department of Commerce,null,CFO,100.0,100.0,0,0,59048584,7680,31,03,1,2024,2024-03-31,2,2024,59048584,7680
Bureau,Department of the Treasury,Office of Sec International Affairs,null,0.0,0.0,0,0,0,0,31,03,1,2024,2024-03-31,2,2024,0,0
Bureau,Department of Homeland Security,U.S. Secret Service,null,0.0,0.0,0,0,0,0,31,03,1,2024,2024-03-31,2,2024,0,0
Bureau,Neighborhood Reinvestment Corporation,Neighborhood Reinvestment Corporation,null,0.0,0.0,0,0,0,0,31,03,1,2024,2024-03-31,2,2024,0,0
Bureau,Other Agencies,Delta Regional Authority,null,0.0,0.0,0,0,0,0,31,03,1,2024,2024-03-31,2,2024,0,0
Bureau,U.S. Tax Court,U.S. Tax Court,null,0.0,0.0,0,0,0,0,31,03,1,2024,2024-03-31,2,2024,0,0
Bureau,Department of the Interior,Office of the Secretary,null,100.0,100.0,0,0,43873,14,31,03,1,2024,2024-03-31,2,2024,43873,14
Bureau,Legislative Branch - U.S. House/Senate,U.S. House of Representatives,null,0.0,0.0,349877,240,0,0,31,03,1,2024,2024-03-31,2,2024,349877,240
Bureau,Department of the Treasury,Bureau of Engraving and Printing,null,9.160843337514185,33.333333333333336,380230,4,38345,2,31,03,1,2024,2024-03-31,2,2024,418575,6
Bureau,Department of Justice,Office of Justice Assistance Programs,null,100.0,100.0,0,0,418916,3,31,03,1,2024,2024-03-31,2,2024,418916,3
Bureau,Federal Maritime Commission,Salaries and Expenses,null,100.0,100.0,0,0,466589,7,31,03,1,2024,2024-03-31,2,2024,466589,7
Bureau,Department of Justice,Federal Bureau of Investigation,null,100.0,100.0,0,0,497990,114,31,03,1,2024,2024-03-31,2,2024,497990,114
Bureau,Other Agencies,Consumer Financial Protection Bureau,null,99.12190242843408,46.15384615384615,4530,7,511358,6,31,03,1,2024,2024-03-31,2,2024,515888,13
Bureau,Department of Justice,Federal Prison Industries,null,0.0,0.0,525521,238,0,0,31,03,1,2024,2024-03-31,2,2024,525521,238
Bureau,Department of Veterans Affairs,Housing Credit Assistance,null,5.406647051190781,20.0,539464,8,30834,2,31,03,1,2024,2024-03-31,2,2024,570298,10
Bureau,National Science Foundation,National Science Foundation,null,99.9115831618751,96.55172413793103,636,1,718684,28,31,03,1,2024,2024-03-31,2,2024,719320,29
Bureau,Department of Transportation,Federal Transit Administration,null,100.0,100.0,0,0,786379,2,31,03,1,2024,2024-03-31,2,2024,786379,2
Bureau,Department of the Interior,Fish and Wildlife Service,null,100.0,100.0,0,0,817954,90,31,03,1,2024,2024-03-31,2,2024,817954,90
Bureau,Department of the Treasury,D.C. Pension Program,null,100.0,100.0,0,0,864123,16,31,03,1,2024,2024-03-31,2,2024,864123,16
Bureau,Department of Commerce,NOAA,null,100.0,100.0,0,0,12517698,814,31,03,1,2024,2024-03-31,2,2024,12517698,814
Agency,Department of Defense,null,CFO,36.60638979042152,17.76929038621872,1883691300,1400537,1087730100,302643,31,03,1,2024,2024-03-31,2,2024,2971421400,1703180
Bureau,Funds Appropriated to the President,African Development Foundation,null,0.0,0.0,0,0,0,0,31,03,1,2024,2024-03-31,2,2024,0,0
Bureau,Department of Commerce,International Trade Administration,null,0.0,0.0,0,0,0,0,31,03,1,2024,2024-03-31,2,2024,0,0
Bureau,Department of Commerce,Economic and Statistical Analysis,null,0.0,0.0,0,0,0,0,31,03,1,2024,2024-03-31,2,2024,0,0
Bureau,Department of Labor,Departmental Management,null,0.0,0.0,0,0,0,0,31,03,1,2024,2024-03-31,2,2024,0,0
Bureau,Department of Homeland Security,Info Analysis Infrastructure Prot-NPPD,null,0.0,0.0,0,0,0,0,31,03,1,2024,2024-03-31,2,2024,0,0
Bureau,American Battle Monuments Commission,American Battle Monuments Commission,null,0.0,0.0,0,0,0,0,31,03,1,2024,2024-03-31,2,2024,0,0
Bureau,Other Agencies,Federal Mine Safety & Health Review Comm,null,0.0,0.0,0,0,0,0,31,03,1,2024,2024-03-31,2,2024,0,0
Bureau,Other Agencies,U.S.  Agency of Global Media,null,0.0,0.0,0,0,0,0,31,03,1,2024,2024-03-31,2,2024,0,0
Bureau,Other Agencies,Federal Housing Finance Agency,null,0.0,0.0,0,0,0,0,31,03,1,2024,2024-03-31,2,2024,0,0
Bureau,Department of the Treasury,Treasury IG for Tax Admin,null,100.0,100.0,0,0,64,1,31,03,1,2024,2024-03-31,2,2024,64,1
Bureau,Department of Homeland Security,Office of the Inspector General DHS,null,100.0,100.0,0,0,100,1,31,03,1,2024,2024-03-31,2,2024,100,1
Bureau,Merit Systems Protection Board,Merit Systems Protection Board,null,100.0,100.0,0,0,144,1,31,03,1,2024,2024-03-31,2,2024,144,1
Bureau,Department of Agriculture,Federal Crop Insurance Corporation,null,100.0,100.0,0,0,5591,6,31,03,1,2024,2024-03-31,2,2024,5591,6
Bureau,Department of the Interior,Office of Surface Mining,null,100.0,100.0,0,0,13600391,610,31,03,1,2024,2024-03-31,2,2024,13600391,610
Bureau,Department of the Treasury,Bureau of the Fiscal Service,null,100.0,100.0,0,0,13676578,3101,31,03,1,2024,2024-03-31,2,2024,13676578,3101
Agency,Department of Homeland Security,null,CFO,93.52001544013638,64.77128046562386,25823014,61980,372681238,113956,31,03,1,2024,2024-03-31,2,2024,398504252,175936
Agency,Department of Agriculture,null,CFO,99.22007544849797,93.81815166466271,8757529,2982,1114111213,45256,31,03,1,2024,2024-03-31,2,2024,1122868742,48238
Bureau,Consumer Product Safety Commission,Consumer Product Safety Commission,null,100.0,100.0,0,0,420,2,31,03,1,2024,2024-03-31,2,2024,420,2
Bureau,Farm Credit Administration,Farm Credit Administration,null,100.0,100.0,0,0,630,1,31,03,1,2024,2024-03-31,2,2024,630,1
Bureau,Department of the Interior,"Bureau of Ocean Energy Mgmt., Reg & Enf",null,100.0,100.0,0,0,933,1,31,03,1,2024,2024-03-31,2,2024,933,1
Bureau,Department of Justice,U.S. Marshals Service,null,0.0,0.0,6034,4,0,0,31,03,1,2024,2024-03-31,2,2024,6034,4
Bureau,Department of Transportation,St. Lawrence Seaway Development Corp.,null,100.0,100.0,0,0,7728,2,31,03,1,2024,2024-03-31,2,2024,7728,2
Bureau,Smithsonian Institution,Smithsonian Institution,null,0.0,0.0,8262,21,0,0,31,03,1,2024,2024-03-31,2,2024,8262,21
Bureau,Department of Homeland Security,Federal Law Enforcement Training Ctr.,null,100.0,100.0,0,0,8562,1,31,03,1,2024,2024-03-31,2,2024,8562,1
Bureau,Other Agencies,U.S. Inst. for Env. Conflict Resolution,null,0.0,0.0,8860,2,0,0,31,03,1,2024,2024-03-31,2,2024,8860,2
Bureau,Department of Justice,Bureau of ATF and Explosives,null,100.0,100.0,0,0,19881,1,31,03,1,2024,2024-03-31,2,2024,19881,1
Bureau,Equal Employment Opportunity Commission,Equal Employment Opportunity Commission,null,100.0,100.0,0,0,24513,22,31,03,1,2024,2024-03-31,2,2024,24513,22
Bureau,Department of Transportation,National Highway Traffic Safety Admin.,null,100.0,100.0,0,0,29816,6,31,03,1,2024,2024-03-31,2,2024,29816,6
Bureau,Department of Health & Human Services,Office of the Inspector General,null,100.0,100.0,0,0,33600,1,31,03,1,2024,2024-03-31,2,2024,33600,1
Bureau,Department of Housing and Urban Development,Community Planning and Development,null,100.0,100.0,0,0,102184,1,31,03,1,2024,2024-03-31,2,2024,102184,1
Bureau,Other Agencies,James Madison Memorial Fellowship,null,0.0,0.0,197397,25,0,0,31,03,1,2024,2024-03-31,2,2024,197397,25
Bureau,Department of Commerce,Patent and Trademark Office,null,100.0,100.0,0,0,616974,817,31,03,1,2024,2024-03-31,2,2024,616974,817
Bureau,Federal Election Commission,Federal Election Commission,null,100.0,100.0,0,0,2997472,385,31,03,1,2024,2024-03-31,2,2024,2997472,385
Bureau,Nuclear Regulatory Commission,Nuclear Regulatory Commission,null,100.0,100.0,0,0,3246047,356,31,03,1,2024,2024-03-31,2,2024,3246047,356
Bureau,Department of the Interior,Bureau of Reclamation,null,100.0,100.0,0,0,7403974,62,31,03,1,2024,2024-03-31,2,2024,7403974,62
Bureau,Environmental Protection Agency,Environmental Protection Agency,null,100.0,100.0,0,0,28612461,249,31,03,1,2024,2024-03-31,2,2024,28612461,249
Bureau,Other Agencies,John C. Stennis,null,0.0,0.0,6313,2,0,0,31,03,1,2024,2024-03-31,2,2024,6313,2
Bureau,Department of Health & Human Services,Substance Abuse & Mental Health Admin.,null,100.0,100.0,0,0,1097248,10,31,03,1,2024,2024-03-31,2,2024,1097248,10
Bureau,Department of the Interior,Office of Natural Resources Revenue,null,100.0,100.0,0,0,20814336,505,31,03,1,2024,2024-03-31,2,2024,20814336,505
Bureau,Railroad Retirement Board,Railroad Retirement Board,null,100.0,100.0,0,0,24878995,2449,31,03,1,2024,2024-03-31,2,2024,24878995,2449
Bureau,Commodity Futures Trading Commission,Commodity Futures Trading Commission,null,100.0,100.0,0,0,630758270,359,31,03,1,2024,2024-03-31,2,2024,630758270,359
Bureau,Legislative Branch-CBO,Congressional Budget Office,null,0.0,0.0,0,0,0,0,31,03,1,2024,2024-03-31,2,2024,0,0
Bureau,Funds Appropriated to the President,Defense Security Assistance Agency,null,0.0,0.0,0,0,0,0,31,03,1,2024,2024-03-31,2,2024,0,0
Bureau,Smithsonian Institution,National Gallery of Art,null,0.0,0.0,0,0,0,0,31,03,1,2024,2024-03-31,2,2024,0,0
Bureau,Other Agencies/Boards/Commissions,U.S.-China Security Review Commission,null,0.0,0.0,0,0,0,0,31,03,1,2024,2024-03-31,2,2024,0,0
Bureau,Department of Homeland Security,Management Headquarters,null,0.0,0.0,0,0,0,0,31,03,1,2024,2024-03-31,2,2024,0,0
Bureau,Department of Homeland Security,Science and Technology,null,0.0,0.0,0,0,0,0,31,03,1,2024,2024-03-31,2,2024,0,0
Bureau,Department of Health & Human Services,Administration for Community Living,null,0.0,0.0,0,0,0,0,31,03,1,2024,2024-03-31,2,2024,0,0
Bureau,Export - Import  Bank,Export-Import Bank,null,0.0,0.0,0,0,0,0,31,03,1,2024,2024-03-31,2,2024,0,0
Bureau,Other Agencies,Comm. for Purchase from Blind/Handic.,null,0.0,0.0,0,0,0,0,31,03,1,2024,2024-03-31,2,2024,0,0
Bureau,Office of Government Ethics,Office of Government Ethics,null,0.0,0.0,0,0,0,0,31,03,1,2024,2024-03-31,2,2024,0,0
Bureau,Legislative Branch-Office of Tech.,Medicaid & CHIP Payment & Access Comm.,null,0.0,0.0,0,0,0,0,31,03,1,2024,2024-03-31,2,2024,0,0
Bureau,Department of Health & Human Services,Program Support Center,null,100.0,100.0,0,0,6599578,251,31,03,1,2024,2024-03-31,2,2024,6599578,251
Bureau,Department of the Interior,National Park Service,null,100.0,100.0,0,0,8614602,2048,31,03,1,2024,2024-03-31,2,2024,8614602,2048
Bureau,Department of Health & Human Services,Agency for Healthcare Research & Quality,null,0.0,0.0,0,0,0,0,31,03,1,2024,2024-03-31,2,2024,0,0
Agency,Legislative Branch-GPO,null,Non-CFO,0.0,0.0,0,0,0,0,31,03,1,2024,2024-03-31,2,2024,0,0
Bureau,The Judiciary,Administrative Office of the U.S. Courts,null,98.85438514053003,57.92880258899677,11995,130,1035041,179,31,03,1,2024,2024-03-31,2,2024,1047036,309
Bureau,Department of Energy,Bonneville Power Administration,null,100.0,100.0,0,0,1058470,28,31,03,1,2024,2024-03-31,2,2024,1058470,28
Bureau,National Aeronautics and Space Administration,National Aeronautics and Space Admin,null,100.0,100.0,0,0,1075789,132,31,03,1,2024,2024-03-31,2,2024,1075789,132
Bureau,General Services Administration,General Services Administration,null,100.0,100.0,0,0,10027350,382,31,03,1,2024,2024-03-31,2,2024,10027350,382
Agency,Corp. for National and Community Service,null,Non-CFO,92.55107103937188,39.41018766756032,289889,226,3601798,147,31,03,1,2024,2024-03-31,2,2024,3891687,373
Agency,U.S. Postal Service,null,Non-CFO,86.20744964630228,88.46277299164174,11281868,8986,70514955,68901,31,03,1,2024,2024-03-31,2,2024,81796823,77887
Bureau,Department of Justice,Federal Prison System,null,0.0,0.0,0,0,0,0,31,03,1,2024,2024-03-31,2,2024,0,0
Bureau,Department of the Treasury,Spec Insp Gen-Troubled Asset Rel Prog,null,0.0,0.0,0,0,0,0,31,03,1,2024,2024-03-31,2,2024,0,0
Bureau,Farm Credit Administration,Farm Credit System Insurance Corporation,null,0.0,0.0,0,0,0,0,31,03,1,2024,2024-03-31,2,2024,0,0
Bureau,Department of Housing and Urban Development,"Policy, Development and Research",null,0.0,0.0,0,0,0,0,31,03,1,2024,2024-03-31,2,2024,0,0
Bureau,Other Agencies,National Capital Planning Commission,null,0.0,0.0,0,0,0,0,31,03,1,2024,2024-03-31,2,2024,0,0
Bureau,Other Agencies,Archit.&Trans. Barriers Compliance Bd,null,0.0,0.0,0,0,0,0,31,03,1,2024,2024-03-31,2,2024,0,0
Bureau,U.S. Court of Appeals / Veterans Claims,U.S. Court of Appeals / Veterans Claims,null,0.0,0.0,0,0,0,0,31,03,1,2024,2024-03-31,2,2024,0,0
Bureau,Funds Appropriated to the President,Trade and Development Agency,null,0.0,0.0,1236060,7,0,0,31,03,1,2024,2024-03-31,2,2024,1236060,7
Bureau,Department of the Interior,Bureau of Land Management,null,100.0,100.0,0,0,8960674,312,31,03,1,2024,2024-03-31,2,2024,8960674,312
Bureau,Department of Homeland Security,Bureau of Customs & Border Protection,null,100.0,100.0,0,0,9436867,862,31,03,1,2024,2024-03-31,2,2024,9436867,862
Bureau,Department of Homeland Security,U.S. Coast Guard,null,3.49931501990505,2.1248696641284086,25819262,61953,936260,1345,31,03,1,2024,2024-03-31,2,2024,26755522,63298
Bureau,Department of Health & Human Services,National Institutes of Health,null,28.93721594009745,26.070038910505836,19181342,380,7810764,134,31,03,1,2024,2024-03-31,2,2024,26992106,514
Bureau,Agency for International Development,Agency for International Development,null,99.99904299775885,98.18181818181819,272,1,28421814,54,31,03,1,2024,2024-03-31,2,2024,28422086,55
Bureau,Department of Commerce,Bureau of Industry and Security,null,100.0,100.0,0,0,37546041,27,31,03,1,2024,2024-03-31,2,2024,37546041,27
Bureau,Department of Health & Human Services,Health Resources and Services Admin,null,100.0,100.0,0,0,134213968,696,31,03,1,2024,2024-03-31,2,2024,134213968,696
Bureau,Department of Health & Human Services,Food and Drug Administration,null,29.93694078885022,9.239608915249525,135037292,19587,57699499,1994,31,03,1,2024,2024-03-31,2,2024,192736791,21581
Bureau,Department of Veterans Affairs,Medical and Construction,null,99.50492270191886,99.92357534101949,963045,2729,193561124,3568108,31,03,1,2024,2024-03-31,2,2024,194524169,3570837
Bureau,Department of Health & Human Services,Office of the Secretary,null,100.0,100.0,0,0,195075001,5322,31,03,1,2024,2024-03-31,2,2024,195075001,5322
Bureau,Department of Homeland Security,Emergency Preparedness & Resp,null,100.0,100.0,0,0,215630768,44592,31,03,1,2024,2024-03-31,2,2024,215630768,44592
Bureau,Federal Communications Commission,Federal Communications Commission,null,100.0,100.0,0,0,252531990,12468,31,03,1,2024,2024-03-31,2,2024,252531990,12468
Bureau,Small Business Administration,Small Business Administration,null,100.0,100.0,0,0,57217803197,771093,31,03,1,2024,2024-03-31,2,2024,57217803197,771093
Bureau,Department of Education,Federal Student Aid,null,97.32360219403947,96.94145252905481,3057903850,598389,111196555752,18966094,31,03,1,2024,2024-03-31,2,2024,114254459602,19564483
Bureau,Department of Health & Human Services,Centers for Medicare & Medicaid Services,null,98.65710075280775,99.15351060788824,77793247,9565,5715139258,1120396,31,03,1,2024,2024-03-31,2,2024,5792932505,1129961
Bureau,Department of Health & Human Services,Administration for Children and Families,null,100.0,100.0,0,0,38434245,1739,31,03,1,2024,2024-03-31,2,2024,38434245,1739
Bureau,Department of Labor,Occupational Safety and Health Admin,null,90.32181485077272,79.09975118751414,6531451,924,60954869,3497,31,03,1,2024,2024-03-31,2,2024,67486320,4421
Bureau,Department of Labor,Employment Standards Administration,null,86.5636758180037,62.4300228073813,9499586,1812,61201194,3011,31,03,1,2024,2024-03-31,2,2024,70700780,4823
Bureau,Department of Agriculture,Forest Service,null,95.37981402530063,56.80224403927069,3469710,308,71629215,405,31,03,1,2024,2024-03-31,2,2024,75098925,713
Bureau,Department of Agriculture,Farm Service Agency,null,100.0,100.0,0,0,75242985,1544,31,03,1,2024,2024-03-31,2,2024,75242985,1544
Bureau,Department of Transportation,Federal Motor Carrier Safety Admin,null,99.96826763984845,99.91005172026085,25656,8,80825563,8886,31,03,1,2024,2024-03-31,2,2024,80851219,8894
Bureau,U.S. Postal Service,U.S. Postal Service,null,86.20744964630228,88.46277299164174,11281868,8986,70514955,68901,31,03,1,2024,2024-03-31,2,2024,81796823,77887
Bureau,Department of Housing and Urban Development,Housing Programs,null,99.93856399515742,99.91546914623838,50674,3,82431903,3546,31,03,1,2024,2024-03-31,2,2024,82482577,3549
Bureau,Department of Justice,Legal Activities,null,97.82306318332037,99.15576513538181,1985189,333,89206663,39111,31,03,1,2024,2024-03-31,2,2024,91191852,39444
Bureau,Department of Health & Human Services,Indian Health Services,null,98.20427868754551,100.0,2022312,0,110596054,4486,31,03,1,2024,2024-03-31,2,2024,112618366,4486
Bureau,Department of Agriculture,Commodity Credit Corporation,null,100.0,100.0,0,0,123651867,8731,31,03,1,2024,2024-03-31,2,2024,123651867,8731
Bureau,Department of Homeland Security,Transportation Safety Administration,null,100.0,100.0,0,0,128382235,64936,31,03,1,2024,2024-03-31,2,2024,128382235,64936
Bureau,Other Agencies,Privacy & Civil Liberties Oversight Bd,null,0.0,0.0,0,0,0,0,31,03,1,2024,2024-03-31,2,2024,0,0
Agency,U.S. Court of Appeals / Veterans Claims,null,Non-CFO,0.0,0.0,0,0,0,0,30,06,2,2024,2024-06-30,3,2024,0,0
Agency,Neighborhood Reinvestment Corporation,null,Non-CFO,0.0,0.0,0,0,0,0,30,06,2,2024,2024-06-30,3,2024,0,0
Bureau,Department of the Interior,Geological Survey,null,100.0,100.0,0,0,154550,563,30,06,2,2024,2024-06-30,3,2024,154550,563
Bureau,Securities & Exchange Commission,Securities and Exchange Commission,null,100.0,100.0,0,0,254277,44,30,06,2,2024,2024-06-30,3,2024,254277,44
Bureau,The Judiciary,Administrative Office of the U.S. Courts,null,98.85412088437064,58.064516129032256,11993,130,1034627,180,30,06,2,2024,2024-06-30,3,2024,1046620,310
Bureau,Department of Commerce,Nat'l Telecomm & Information Admin.,null,100.0,100.0,0,0,296093,1,30,06,2,2024,2024-06-30,3,2024,296093,1
Bureau,Department of Transportation,Pipeline Hazardous Material Safety Admin,null,100.0,100.0,0,0,1264142,98,30,06,2,2024,2024-06-30,3,2024,1264142,98
Bureau,Department of Commerce,Bureau of the Census,null,100.0,100.0,0,0,1789388,5524,30,06,2,2024,2024-06-30,3,2024,1789388,5524
Bureau,Department of Homeland Security,Immigration and Customs Enforcement,null,100.0,100.0,0,0,18547458,690,30,06,2,2024,2024-06-30,3,2024,18547458,690
Bureau,Department of the Interior,Bureau of Indian Affairs,null,99.96941329388125,99.71533448198367,6187,76,20221555,26622,30,06,2,2024,2024-06-30,3,2024,20227742,26698
Bureau,Department of the Treasury,Departmental Offices,null,99.90418352774745,99.92435703479576,20005,1,20858451,1321,30,06,2,2024,2024-06-30,3,2024,20878456,1322
Bureau,Department of State,Department of State,null,99.60660827345154,99.59839357429719,82731,39,20947452,9672,30,06,2,2024,2024-06-30,3,2024,21030183,9711
Bureau,Department of Labor,Employee Benefit Security Administration,null,100.0,100.0,0,0,22166455,478,30,06,2,2024,2024-06-30,3,2024,22166455,478
Bureau,Railroad Retirement Board,Railroad Retirement Board,null,100.0,100.0,0,0,26012310,1930,30,06,2,2024,2024-06-30,3,2024,26012310,1930
Bureau,Department of Labor,Occupational Safety and Health Admin,null,92.12102919674507,84.07040704070407,5532828,724,64689897,3821,30,06,2,2024,2024-06-30,3,2024,70222725,4545
Agency,Legislative Branch-GPO,null,Non-CFO,0.0,0.0,0,0,0,0,30,06,2,2024,2024-06-30,3,2024,0,0
Bureau,Equal Employment Opportunity Commission,Equal Employment Opportunity Commission,null,100.0,100.0,0,0,25460,22,30,06,2,2024,2024-06-30,3,2024,25460,22
Bureau,Department of Labor,Employment Standards Administration,null,86.070044080251,82.65440210249672,11048560,660,68266551,3145,30,06,2,2024,2024-06-30,3,2024,79315111,3805
Bureau,Selective Service System,Selective Service System,null,0.0,0.0,1301,2,0,0,30,06,2,2024,2024-06-30,3,2024,1301,2
Agency,American Battle Monuments Commission,null,Non-CFO,0.0,0.0,0,0,0,0,30,06,2,2024,2024-06-30,3,2024,0,0
Agency,U.S. Tax Court,null,Non-CFO,0.0,0.0,0,0,0,0,30,06,2,2024,2024-06-30,3,2024,0,0
Bureau,Legislative Branch-GPO,Government Publishing Office,null,0.0,0.0,0,0,0,0,30,06,2,2024,2024-06-30,3,2024,0,0
Agency,Department of the Interior,null,CFO,99.9919340626373,99.75305432804782,6187,76,76699095,30700,30,06,2,2024,2024-06-30,3,2024,76705282,30776
Bureau,Department of the Treasury,Bureau of Engraving and Printing,null,100.0,100.0,0,0,38345,2,30,06,2,2024,2024-06-30,3,2024,38345,2
Bureau,Other Agencies,Chemical Safety Board,null,0.0,0.0,0,0,0,0,30,06,2,2024,2024-06-30,3,2024,0,0
Bureau,U.S. Postal Service,U.S. Postal Service,null,86.13984115898549,83.84586110804209,11675303,13159,72561127,68300,30,06,2,2024,2024-06-30,3,2024,84236430,81459
Agency,Federal Labor Relations Authority,null,Non-CFO,0.0,0.0,0,0,0,0,30,06,2,2024,2024-06-30,3,2024,0,0
Agency,National Labor Relations Board,null,Non-CFO,0.0,0.0,0,0,0,0,30,06,2,2024,2024-06-30,3,2024,0,0
Bureau,Department of Agriculture,Commodity Credit Corporation,null,97.16628374912762,96.16053822062406,4093135,331,140350932,8290,30,06,2,2024,2024-06-30,3,2024,144444067,8621
Bureau,Department of Housing and Urban Development,Housing Programs,null,99.86967600768469,99.89693377995361,118783,4,91025601,3877,30,06,2,2024,2024-06-30,3,2024,91144384,3881
Bureau,Department of Transportation,Maritime Administration,null,100.0,100.0,0,0,301146,17,30,06,2,2024,2024-06-30,3,2024,301146,17
Agency,Federal Election Commission,null,Non-CFO,100.0,100.0,0,0,3293452,414,30,06,2,2024,2024-06-30,3,2024,3293452,414
Agency,Export - Import  Bank,null,Non-CFO,0.0,0.0,0,0,0,0,30,06,2,2024,2024-06-30,3,2024,0,0
Agency,National Archives & Records Admin,null,Non-CFO,100.0,100.0,0,0,100964,87,30,06,2,2024,2024-06-30,3,2024,100964,87
Bureau,Other Agencies,Election Assistance Commission,null,0.0,0.0,0,0,0,0,30,06,2,2024,2024-06-30,3,2024,0,0
Bureau,Federal Trade Commission,Federal Trade Commission,null,100.0,100.0,0,0,731122916,90,30,06,2,2024,2024-06-30,3,2024,731122916,90
Bureau,National Labor Relations Board,National Labor Relations Board,null,0.0,0.0,0,0,0,0,30,06,2,2024,2024-06-30,3,2024,0,0
Bureau,Other Agencies,Federal Housing Finance Agency,null,0.0,0.0,0,0,0,0,30,06,2,2024,2024-06-30,3,2024,0,0
Bureau,Department of Homeland Security,Office of the Inspector General DHS,null,100.0,100.0,0,0,100,1,30,06,2,2024,2024-06-30,3,2024,100,1
Agency,Environmental Protection Agency,null,CFO,100.0,100.0,0,0,28860774,257,30,06,2,2024,2024-06-30,3,2024,28860774,257
Agency,Department of the Treasury,null,CFO,99.62608470100876,99.80066445182725,167465,9,44619416,4506,30,06,2,2024,2024-06-30,3,2024,44786881,4515
Bureau,Department of Transportation,National Highway Traffic Safety Admin.,null,100.0,100.0,0,0,31918,7,30,06,2,2024,2024-06-30,3,2024,31918,7
Agency,Pension Benefit Guaranty Corp,null,Non-CFO,100.0,100.0,0,0,5562406,1735,30,06,2,2024,2024-06-30,3,2024,5562406,1735
Agency,Railroad Retirement Board,null,Non-CFO,100.0,100.0,0,0,26012310,1930,30,06,2,2024,2024-06-30,3,2024,26012310,1930
Agency,U.S. Postal Service,null,Non-CFO,86.13984115898549,83.84586110804209,11675303,13159,72561127,68300,30,06,2,2024,2024-06-30,3,2024,84236430,81459
Agency,Federal Communications Commission,null,Non-CFO,100.0,100.0,0,0,309028435,16116,30,06,2,2024,2024-06-30,3,2024,309028435,16116
Agency,Commodity Futures Trading Commission,null,Non-CFO,100.0,100.0,0,0,633205219,359,30,06,2,2024,2024-06-30,3,2024,633205219,359
Bureau,Other Agencies/Boards/Commissions,Nuclear Waste Technical Review Board,null,0.0,0.0,0,0,0,0,30,06,2,2024,2024-06-30,3,2024,0,0
Bureau,Other Agencies,Federal Mine Safety & Health Review Comm,null,0.0,0.0,0,0,0,0,30,06,2,2024,2024-06-30,3,2024,0,0
Bureau,Department of Agriculture,Farm Service Agency,null,99.99533377331669,75.21679598356914,3578,543,76675080,1648,30,06,2,2024,2024-06-30,3,2024,76678658,2191
Bureau,Department of Commerce,International Trade Administration,null,0.0,0.0,0,0,0,0,30,06,2,2024,2024-06-30,3,2024,0,0
Bureau,Other Agencies,Delta Regional Authority,null,0.0,0.0,0,0,0,0,30,06,2,2024,2024-06-30,3,2024,0,0
Bureau,Department of the Interior,Office of the Secretary,null,100.0,100.0,0,0,3936,9,30,06,2,2024,2024-06-30,3,2024,3936,9
Bureau,Department of Health & Human Services,Office of the Inspector General,null,100.0,100.0,0,0,33600,1,30,06,2,2024,2024-06-30,3,2024,33600,1
Bureau,Funds Appropriated to the President,Peace Corps,null,0.0,0.0,0,0,0,0,30,06,2,2024,2024-06-30,3,2024,0,0
Agency,Department of Commerce,null,CFO,100.0,100.0,0,0,58831267,7126,30,06,2,2024,2024-06-30,3,2024,58831267,7126
Agency,Department of Transportation,null,CFO,99.99182352640362,99.98988775407018,7486,1,91547876,9888,30,06,2,2024,2024-06-30,3,2024,91555362,9889
Bureau,Department of Commerce,Office of the Inspector General,null,0.0,0.0,0,0,0,0,30,06,2,2024,2024-06-30,3,2024,0,0
Bureau,Department of Justice,Legal Activities,null,98.05160988118249,99.18086500655308,1793004,325,90231893,39351,30,06,2,2024,2024-06-30,3,2024,92024897,39676
Bureau,Department of Health & Human Services,Indian Health Services,null,99.99999901075114,100.0,1,0,101086797,4363,30,06,2,2024,2024-06-30,3,2024,101086798,4363
Bureau,Department of Agriculture,Forest Service,null,97.51880718151824,48.009101251422074,1839003,457,72278695,422,30,06,2,2024,2024-06-30,3,2024,74117698,879
Bureau,Department of the Treasury,U.S. Mint,null,13.15762870106624,82.6086956521739,146035,4,22126,19,30,06,2,2024,2024-06-30,3,2024,168161,23
Bureau,Department of Housing and Urban Development,Government National Mortgage Association,null,0.0,0.0,221266,7,0,0,30,06,2,2024,2024-06-30,3,2024,221266,7
Bureau,Other Agencies,James Madison Memorial Fellowship,null,0.0,0.0,197397,25,0,0,30,06,2,2024,2024-06-30,3,2024,197397,25
Agency,Office of Government Ethics,null,Non-CFO,0.0,0.0,0,0,0,0,30,06,2,2024,2024-06-30,3,2024,0,0
Bureau,Legislative Branch-CBO,Congressional Budget Office,null,0.0,0.0,0,0,0,0,30,06,2,2024,2024-06-30,3,2024,0,0
Bureau,Department of Commerce,Economic and Statistical Analysis,null,0.0,0.0,0,0,0,0,30,06,2,2024,2024-06-30,3,2024,0,0
Bureau,Department of the Treasury,Spec Insp Gen-Troubled Asset Rel Prog,null,0.0,0.0,0,0,0,0,30,06,2,2024,2024-06-30,3,2024,0,0
Bureau,Smithsonian Institution,National Gallery of Art,null,0.0,0.0,0,0,0,0,30,06,2,2024,2024-06-30,3,2024,0,0
Bureau,National Foundation  Arts & Humanities,National Endowment for the Arts,null,0.0,0.0,0,0,0,0,30,06,2,2024,2024-06-30,3,2024,0,0
Bureau,Neighborhood Reinvestment Corporation,Neighborhood Reinvestment Corporation,null,0.0,0.0,0,0,0,0,30,06,2,2024,2024-06-30,3,2024,0,0
Bureau,Federal Mediation/Conciliation Service,Federal Mediation/Conciliation Service,null,0.0,0.0,0,0,0,0,30,06,2,2024,2024-06-30,3,2024,0,0
Bureau,Other Agencies,Morris K. Udall Scholarship,null,0.0,0.0,0,0,0,0,30,06,2,2024,2024-06-30,3,2024,0,0
Bureau,Other Agencies,National Transportation Safety Board,null,0.0,0.0,0,0,0,0,30,06,2,2024,2024-06-30,3,2024,0,0
Bureau,Other Agencies,District of Columbia Government,null,0.0,0.0,0,0,0,0,30,06,2,2024,2024-06-30,3,2024,0,0
Bureau,Other Agencies,National Council on Disability,null,0.0,0.0,0,0,0,0,30,06,2,2024,2024-06-30,3,2024,0,0
Bureau,U.S. Court of Appeals / Veterans Claims,U.S. Court of Appeals / Veterans Claims,null,0.0,0.0,0,0,0,0,30,06,2,2024,2024-06-30,3,2024,0,0
Bureau,Other Agencies,Federal Housing Finance Agency OIG,null,0.0,0.0,0,0,0,0,30,06,2,2024,2024-06-30,3,2024,0,0
Bureau,Other Agencies,Gulf Coast Ecosystem Restoration Council,null,0.0,0.0,0,0,0,0,30,06,2,2024,2024-06-30,3,2024,0,0
Bureau,Department of Homeland Security,Office of Biometric Identity Management,null,0.0,0.0,0,0,0,0,30,06,2,2024,2024-06-30,3,2024,0,0
Bureau,Department of the Treasury,Treasury Franchise Fund,null,0.0,0.0,0,0,0,0,30,06,2,2024,2024-06-30,3,2024,0,0
Bureau,Department of Health & Human Services,Health Resources and Services Admin,null,100.0,100.0,0,0,137731660,706,30,06,2,2024,2024-06-30,3,2024,137731660,706
Bureau,Federal Maritime Commission,Salaries and Expenses,null,18.808626206718063,70.0,1982656,3,459298,7,30,06,2,2024,2024-06-30,3,2024,2441954,10
Bureau,Office of Personnel Management,Office of Personnel Management,null,100.0,100.0,0,0,17802092,989,30,06,2,2024,2024-06-30,3,2024,17802092,989
Bureau,Department of the Interior,Office of Natural Resources Revenue,null,100.0,100.0,0,0,18448088,488,30,06,2,2024,2024-06-30,3,2024,18448088,488
Bureau,Department of Transportation,Federal Motor Carrier Safety Admin,null,99.99101397756225,99.98913869881612,7486,1,83299673,9206,30,06,2,2024,2024-06-30,3,2024,83307159,9207
Agency,Federal Maritime Commission,null,Non-CFO,18.808626206718063,70.0,1982656,3,459298,7,30,06,2,2024,2024-06-30,3,2024,2441954,10
Agency,Corp. for National and Community Service,null,Non-CFO,96.18314249758028,47.58842443729903,142912,163,3601320,148,30,06,2,2024,2024-06-30,3,2024,3744232,311
Agency,Federal Trade Commission,null,Non-CFO,100.0,100.0,0,0,731122916,90,30,06,2,2024,2024-06-30,3,2024,731122916,90
Agency,Securities & Exchange Commission,null,Non-CFO,100.0,100.0,0,0,3931043971,1782,30,06,2,2024,2024-06-30,3,2024,3931043971,1782
Bureau,Department of the Treasury,Interest on Tax/Deposit of Earnings,null,0.0,0.0,0,0,0,0,30,06,2,2024,2024-06-30,3,2024,0,0
Bureau,Department of Homeland Security,Management Headquarters,null,0.0,0.0,0,0,0,0,30,06,2,2024,2024-06-30,3,2024,0,0
Bureau,Department of Education,Office of Postsecondary Education,null,0.0,0.0,0,0,0,0,30,06,2,2024,2024-06-30,3,2024,0,0
Bureau,Other Agencies,U.S. Institute of Peace,null,0.0,0.0,0,0,0,0,30,06,2,2024,2024-06-30,3,2024,0,0
Agency,Armed Forces Retirement Home,null,Non-CFO,100.0,100.0,0,0,108119,91,30,06,2,2024,2024-06-30,3,2024,108119,91
Agency,Other Agencies,null,Non-CFO,70.13905284831846,11.363636363636363,217537,39,510963,5,30,06,2,2024,2024-06-30,3,2024,728500,44
Agency,The Judiciary,null,Non-CFO,98.85412088437064,58.064516129032256,11993,130,1034627,180,30,06,2,2024,2024-06-30,3,2024,1046620,310
Agency,Funds Appropriated to the President,null,Non-CFO,0.0,0.0,1236060,7,0,0,30,06,2,2024,2024-06-30,3,2024,1236060,7
Agency,Presidio Trust Corporation,null,Non-CFO,100.0,100.0,0,0,1402257,61,30,06,2,2024,2024-06-30,3,2024,1402257,61
Bureau,Office of Compliance,Office of Compliance,null,0.0,0.0,0,0,0,0,30,06,2,2024,2024-06-30,3,2024,0,0
Bureau,Funds Appropriated to the President,Inter-American Foundation,null,0.0,0.0,0,0,0,0,30,06,2,2024,2024-06-30,3,2024,0,0
Bureau,Department of Commerce,General Administration,null,0.0,0.0,0,0,0,0,30,06,2,2024,2024-06-30,3,2024,0,0
Bureau,Department of Justice,General Administration,null,0.0,0.0,0,0,0,0,30,06,2,2024,2024-06-30,3,2024,0,0
Bureau,Department of Justice,Federal Prison System,null,0.0,0.0,0,0,0,0,30,06,2,2024,2024-06-30,3,2024,0,0
Bureau,Department of the Treasury,Office of the Secretary,null,0.0,0.0,0,0,0,0,30,06,2,2024,2024-06-30,3,2024,0,0
Bureau,Smithsonian Institution,JFK Center for the Performing Arts,null,0.0,0.0,0,0,0,0,30,06,2,2024,2024-06-30,3,2024,0,0
Bureau,Federal Deposit Insurance Corporation,Federal Deposit Insurance Corporation,null,0.0,0.0,0,0,0,0,30,06,2,2024,2024-06-30,3,2024,0,0
Bureau,National Foundation  Arts & Humanities,National Endowment for the Humanities,null,0.0,0.0,0,0,0,0,30,06,2,2024,2024-06-30,3,2024,0,0
Bureau,Department of Housing and Urban Development,"Policy, Development and Research",null,0.0,0.0,0,0,0,0,30,06,2,2024,2024-06-30,3,2024,0,0
Bureau,Occupational Safety & Health Rev Comm,Occupational Safety & Health Rev Comm,null,0.0,0.0,0,0,0,0,30,06,2,2024,2024-06-30,3,2024,0,0
Bureau,Other Agencies,Architect of the Capitol,null,0.0,0.0,0,0,0,0,30,06,2,2024,2024-06-30,3,2024,0,0
Bureau,Other Agencies,U.S. Holocaust Memorial Council,null,0.0,0.0,0,0,0,0,30,06,2,2024,2024-06-30,3,2024,0,0
Bureau,Other Agencies,Defense Nuclear Facilities Safety Board,null,0.0,0.0,0,0,0,0,30,06,2,2024,2024-06-30,3,2024,0,0
Bureau,Other Agencies,Millennium Challenge Corporation,null,0.0,0.0,0,0,0,0,30,06,2,2024,2024-06-30,3,2024,0,0
Bureau,Other Agencies,Denali Commission,null,0.0,0.0,0,0,0,0,30,06,2,2024,2024-06-30,3,2024,0,0
Bureau,Other Agencies/Boards/Commissions,Medicare Payment Advisory Commission,null,0.0,0.0,0,0,0,0,30,06,2,2024,2024-06-30,3,2024,0,0
Bureau,Other Agencies,Council of Insps. Gen. of Intg. & Effy.,null,0.0,0.0,0,0,0,0,30,06,2,2024,2024-06-30,3,2024,0,0
Bureau,Department of Agriculture,U.S. Department of Agriculture,null,85.54578930790643,58.48181596289968,3541302,1701,20958839,2396,30,06,2,2024,2024-06-30,3,2024,24500141,4097
Bureau,Department of Commerce,Bureau of Industry and Security,null,100.0,100.0,0,0,37545771,27,30,06,2,2024,2024-06-30,3,2024,37545771,27
Bureau,Department of Health & Human Services,Administration for Children and Families,null,100.0,100.0,0,0,38911023,1779,30,06,2,2024,2024-06-30,3,2024,38911023,1779
Bureau,Department of Homeland Security,Transportation Safety Administration,null,100.0,100.0,0,0,44709558,32717,30,06,2,2024,2024-06-30,3,2024,44709558,32717
Bureau,Legis Branch-Library of Congress,Library of Congress,null,0.0,0.0,0,0,0,0,30,06,2,2024,2024-06-30,3,2024,0,0
Bureau,Legislative Branch-GAO,Government Accountability Office,null,0.0,0.0,0,0,0,0,30,06,2,2024,2024-06-30,3,2024,0,0
Bureau,Funds Appropriated to the President,Executive Branch,null,0.0,0.0,0,0,0,0,30,06,2,2024,2024-06-30,3,2024,0,0
Bureau,Funds Appropriated to the President,Defense Security Assistance Agency,null,0.0,0.0,0,0,0,0,30,06,2,2024,2024-06-30,3,2024,0,0
Bureau,Funds Appropriated to the President,African Development Foundation,null,0.0,0.0,0,0,0,0,30,06,2,2024,2024-06-30,3,2024,0,0
Bureau,Department of Commerce,Minority Business Development Agency,null,0.0,0.0,0,0,0,0,30,06,2,2024,2024-06-30,3,2024,0,0
Bureau,Department of Commerce,National Technical Information Service,null,0.0,0.0,0,0,0,0,30,06,2,2024,2024-06-30,3,2024,0,0
Bureau,Department of the Treasury,Office of Sec International Affairs,null,0.0,0.0,0,0,0,0,30,06,2,2024,2024-06-30,3,2024,0,0
Bureau,Department of the Treasury,U.S. Treasury IG Office,null,0.0,0.0,0,0,0,0,30,06,2,2024,2024-06-30,3,2024,0,0
Bureau,Office of Special Counsel,Office of Special Counsel,null,0.0,0.0,0,0,0,0,30,06,2,2024,2024-06-30,3,2024,0,0
Bureau,Tennessee Valley Authority,Tennessee Valley Authority,null,0.0,0.0,0,0,0,0,30,06,2,2024,2024-06-30,3,2024,0,0
Bureau,Department of Transportation,Office of the Inspector General,null,0.0,0.0,0,0,0,0,30,06,2,2024,2024-06-30,3,2024,0,0
Bureau,Department of Homeland Security,Info Analysis Infrastructure Prot-NPPD,null,0.0,0.0,0,0,0,0,30,06,2,2024,2024-06-30,3,2024,0,0
Bureau,American Battle Monuments Commission,American Battle Monuments Commission,null,0.0,0.0,0,0,0,0,30,06,2,2024,2024-06-30,3,2024,0,0
Bureau,Other Agencies,Comm. for Purchase from Blind/Handic.,null,0.0,0.0,0,0,0,0,30,06,2,2024,2024-06-30,3,2024,0,0
Bureau,Other Agencies,U.S.  Agency of Global Media,null,0.0,0.0,0,0,0,0,30,06,2,2024,2024-06-30,3,2024,0,0
Bureau,Smithsonian Institution,Administrative Conference of the US,null,0.0,0.0,0,0,0,0,30,06,2,2024,2024-06-30,3,2024,0,0
Bureau,Other Agencies,Surface Transportation Board,null,0.0,0.0,0,0,0,0,30,06,2,2024,2024-06-30,3,2024,0,0
Bureau,Other Agencies,Privacy & Civil Liberties Oversight Bd,null,0.0,0.0,0,0,0,0,30,06,2,2024,2024-06-30,3,2024,0,0
Bureau,Department of the Treasury,Treasury IG for Tax Admin,null,100.0,100.0,0,0,65,1,30,06,2,2024,2024-06-30,3,2024,65,1
Bureau,Merit Systems Protection Board,Merit Systems Protection Board,null,100.0,100.0,0,0,144,1,30,06,2,2024,2024-06-30,3,2024,144,1
Bureau,Smithsonian Institution,Smithsonian Institution,null,0.0,0.0,4786,11,0,0,30,06,2,2024,2024-06-30,3,2024,4786,11
Bureau,Other Agencies,John C. Stennis,null,0.0,0.0,6313,2,0,0,30,06,2,2024,2024-06-30,3,2024,6313,2
Bureau,National Aeronautics and Space Administration,National Aeronautics and Space Admin,null,100.0,100.0,0,0,1207201,134,30,06,2,2024,2024-06-30,3,2024,1207201,134
Bureau,Department of Labor,Employment and Training Administration,null,100.0,100.0,0,0,1226363,12,30,06,2,2024,2024-06-30,3,2024,1226363,12
Bureau,Department of Veterans Affairs,Veterans Benefits,null,0.0,0.0,1230592,1636,0,0,30,06,2,2024,2024-06-30,3,2024,1230592,1636
Bureau,Funds Appropriated to the President,Trade and Development Agency,null,0.0,0.0,1236060,7,0,0,30,06,2,2024,2024-06-30,3,2024,1236060,7
Bureau,Farm Credit Administration,Farm Credit Administration,null,100.0,100.0,0,0,630,1,30,06,2,2024,2024-06-30,3,2024,630,1
Bureau,Department of the Interior,"Bureau of Ocean Energy Mgmt., Reg & Enf",null,100.0,100.0,0,0,933,1,30,06,2,2024,2024-06-30,3,2024,933,1
Bureau,Department of the Treasury,Tobacco Tax and Trade,null,100.0,100.0,0,0,1000,1,30,06,2,2024,2024-06-30,3,2024,1000,1
Bureau,Other Agencies/Boards/Commissions,U.S. Comm. on Int. Religious Freedom,null,0.0,0.0,1024,1,0,0,30,06,2,2024,2024-06-30,3,2024,1024,1
Bureau,Department of Homeland Security,Domestic Nuclear Detection Office,null,0.0,0.0,2272,24,0,0,30,06,2,2024,2024-06-30,3,2024,2272,24
Bureau,Department of Transportation,Research Innovative Technology Admin,null,100.0,100.0,0,0,2582,4,30,06,2,2024,2024-06-30,3,2024,2582,4
Bureau,Department of Transportation,St. Lawrence Seaway Development Corp.,null,100.0,100.0,0,0,4348,2,30,06,2,2024,2024-06-30,3,2024,4348,2
Bureau,Department of Labor,Bureau of Labor Statistics,null,100.0,100.0,0,0,4743,1,30,06,2,2024,2024-06-30,3,2024,4743,1
Agency,Occupational Safety & Health Rev Comm,null,Non-CFO,0.0,0.0,0,0,0,0,30,06,2,2024,2024-06-30,3,2024,0,0
Bureau,Department of Justice,U.S. Marshals Service,null,0.0,0.0,8052,6,0,0,30,06,2,2024,2024-06-30,3,2024,8052,6
Bureau,Department of Justice,Bureau of ATF and Explosives,null,100.0,100.0,0,0,19881,1,30,06,2,2024,2024-06-30,3,2024,19881,1
Bureau,Commodity Futures Trading Commission,Commodity Futures Trading Commission,null,100.0,100.0,0,0,633205219,359,30,06,2,2024,2024-06-30,3,2024,633205219,359
Bureau,Department of Commerce,Patent and Trademark Office,null,100.0,100.0,0,0,568935,743,30,06,2,2024,2024-06-30,3,2024,568935,743
Bureau,Department of Justice,Federal Prison Industries,null,0.0,0.0,758742,175,0,0,30,06,2,2024,2024-06-30,3,2024,758742,175
Bureau,Department of Transportation,Federal Transit Administration,null,100.0,100.0,0,0,786477,2,30,06,2,2024,2024-06-30,3,2024,786477,2
Bureau,Department of the Treasury,D.C. Pension Program,null,100.0,100.0,0,0,864124,16,30,06,2,2024,2024-06-30,3,2024,864124,16
Bureau,Department of the Interior,Fish and Wildlife Service,null,100.0,100.0,0,0,864974,142,30,06,2,2024,2024-06-30,3,2024,864974,142
Bureau,Department of Commerce,Nat'l Institute of Standards& Technology,null,100.0,100.0,0,0,992798,6,30,06,2,2024,2024-06-30,3,2024,992798,6
Bureau,Department of Energy,Bonneville Power Administration,null,100.0,100.0,0,0,1058471,28,30,06,2,2024,2024-06-30,3,2024,1058471,28
Bureau,Department of Health & Human Services,Substance Abuse & Mental Health Admin.,null,100.0,100.0,0,0,1109997,10,30,06,2,2024,2024-06-30,3,2024,1109997,10
Bureau,Department of State,Passport NSF,null,100.0,100.0,0,0,1649205,10576,30,06,2,2024,2024-06-30,3,2024,1649205,10576
Bureau,Legislative Branch - U.S. House/Senate,U.S. House of Representatives,null,0.0,0.0,339405,224,0,0,30,06,2,2024,2024-06-30,3,2024,339405,224
Bureau,Department of Justice,Drug Enforcement Administration,null,100.0,100.0,0,0,339485,15,30,06,2,2024,2024-06-30,3,2024,339485,15
Bureau,Department of Justice,Office of Justice Assistance Programs,null,100.0,100.0,0,0,418916,3,30,06,2,2024,2024-06-30,3,2024,418916,3
Bureau,Department of Veterans Affairs,Housing Credit Assistance,null,6.860345330561937,28.571428571428573,408667,5,30101,2,30,06,2,2024,2024-06-30,3,2024,438768,7
Bureau,Department of Justice,Federal Bureau of Investigation,null,100.0,100.0,0,0,488813,114,30,06,2,2024,2024-06-30,3,2024,488813,114
Bureau,Other Agencies,Consumer Financial Protection Bureau,null,99.03727249820712,33.333333333333336,4967,10,510963,5,30,06,2,2024,2024-06-30,3,2024,515930,15
Agency,US International Development Fin. Corp.,null,Non-CFO,0.0,0.0,0,0,0,0,30,06,2,2024,2024-06-30,3,2024,0,0
Bureau,Export - Import  Bank,Export-Import Bank,null,0.0,0.0,0,0,0,0,30,06,2,2024,2024-06-30,3,2024,0,0
Bureau,National Science Foundation,National Science Foundation,null,100.0,100.0,0,0,555548,28,30,06,2,2024,2024-06-30,3,2024,555548,28
Bureau,Environmental Protection Agency,Environmental Protection Agency,null,100.0,100.0,0,0,28860774,257,30,06,2,2024,2024-06-30,3,2024,28860774,257
Bureau,Department of Homeland Security,U.S. Coast Guard,null,2.9344469637959003,1.6998492488433747,28249580,75640,854030,1308,30,06,2,2024,2024-06-30,3,2024,29103610,76948
Agency,Legislative Branch - U.S. House/Senate,null,Non-CFO,0.0,0.0,339405,224,0,0,30,06,2,2024,2024-06-30,3,2024,339405,224
Bureau,Pension Benefit Guaranty Corp,Pension Benefit Guaranty Corporation,null,100.0,100.0,0,0,5562406,1735,30,06,2,2024,2024-06-30,3,2024,5562406,1735
Bureau,Department of Health & Human Services,Program Support Center,null,100.0,100.0,0,0,6638393,246,30,06,2,2024,2024-06-30,3,2024,6638393,246
Bureau,Department of the Interior,Bureau of Land Management,null,100.0,100.0,0,0,8891486,286,30,06,2,2024,2024-06-30,3,2024,8891486,286
Bureau,General Services Administration,General Services Administration,null,100.0,100.0,0,0,10836356,380,30,06,2,2024,2024-06-30,3,2024,10836356,380
Bureau,Department of the Interior,Office of Surface Mining,null,100.0,100.0,0,0,11820135,458,30,06,2,2024,2024-06-30,3,2024,11820135,458
Bureau,Department of Labor,Mine Safety and Health Administration,null,86.41195091531067,93.6404931862427,1626457,294,10343304,4329,30,06,2,2024,2024-06-30,3,2024,11969761,4623
Bureau,Department of the Treasury,Pandemic Receivables,null,100.0,100.0,0,0,2514281,5,30,06,2,2024,2024-06-30,3,2024,2514281,5
Bureau,Department of the Treasury,Bureau of the Fiscal Service,null,100.0,100.0,0,0,13852414,3067,30,06,2,2024,2024-06-30,3,2024,13852414,3067
Bureau,Agency for International Development,Agency for International Development,null,99.99903452298256,98.18181818181819,273,1,28275905,54,30,06,2,2024,2024-06-30,3,2024,28276178,55
Bureau,Department of Health & Human Services,National Institutes of Health,null,26.90220150932318,24.71042471042471,20751552,390,7637199,128,30,06,2,2024,2024-06-30,3,2024,28388751,518
Agency,Department of Housing and Urban Development,null,CFO,99.63446807725246,99.72194135490395,340049,11,92688488,3945,30,06,2,2024,2024-06-30,3,2024,93028537,3956
Agency,Department of Justice,null,CFO,97.27851261018827,98.73468367091773,2559798,506,91498988,39484,30,06,2,2024,2024-06-30,3,2024,94058786,39990
Agency,Department of Labor,null,CFO,90.05229572905112,77.57519910485092,18414362,3407,166697313,11786,30,06,2,2024,2024-06-30,3,2024,185111675,15193
Agency,Federal Mediation/Conciliation Service,null,Non-CFO,0.0,0.0,0,0,0,0,30,06,2,2024,2024-06-30,3,2024,0,0
Agency,Legis Branch-Library of Congress,null,Non-CFO,0.0,0.0,0,0,0,0,30,06,2,2024,2024-06-30,3,2024,0,0
Agency,Legislative Branch-CBO,null,Non-CFO,0.0,0.0,0,0,0,0,30,06,2,2024,2024-06-30,3,2024,0,0
Agency,Social Security Administration,null,CFO,54.31493382407205,29.93372975962225,1943270074,922372,2310352032,394056,30,06,2,2024,2024-06-30,3,2024,4253622106,1316428
Agency,Department of Health & Human Services,null,CFO,94.58833741126485,97.16159761122081,280367890,29582,4900440880,1012624,30,06,2,2024,2024-06-30,3,2024,5180808770,1042206
Agency,Small Business Administration,null,CFO,100.0,100.0,0,0,74414103000,1252332,30,06,2,2024,2024-06-30,3,2024,74414103000,1252332
Agency,Department of Education,null,CFO,97.06538075878971,96.6708820767903,3347271195,636775,110714244793,18490664,30,06,2,2024,2024-06-30,3,2024,114061515988,19127439
Bureau,US International Development Fin. Corp.,US International Development Fin. Corp.,null,0.0,0.0,0,0,0,0,30,06,2,2024,2024-06-30,3,2024,0,0
Bureau,Department of Agriculture,Food and Nutrition Service,null,83.77624207015326,78.94736842105263,7442,4,38429,15,30,06,2,2024,2024-06-30,3,2024,45871,19
Bureau,Department of Housing and Urban Development,Management and Administration,null,100.0,100.0,0,0,59759,59,30,06,2,2024,2024-06-30,3,2024,59759,59
Bureau,National Archives & Records Admin,Nat'l Archives & Records Administration,null,100.0,100.0,0,0,100964,87,30,06,2,2024,2024-06-30,3,2024,100964,87
Bureau,Department of Housing and Urban Development,Community Planning and Development,null,100.0,100.0,0,0,102184,1,30,06,2,2024,2024-06-30,3,2024,102184,1
Bureau,Department of the Treasury,Internal Revenue Service,null,100.0,100.0,0,0,105781,40,30,06,2,2024,2024-06-30,3,2024,105781,40
Bureau,Armed Forces Retirement Home,Armed Forces Retirement Home,null,100.0,100.0,0,0,108119,91,30,06,2,2024,2024-06-30,3,2024,108119,91
Bureau,Department of Transportation,Federal Railroad Administration,null,100.0,100.0,0,0,145009,11,30,06,2,2024,2024-06-30,3,2024,145009,11
Bureau,Department of Labor,Departmental Management,null,0.0,0.0,206517,1729,0,0,30,06,2,2024,2024-06-30,3,2024,206517,1729
Agency,Department of Homeland Security,null,CFO,90.6860236145484,51.17065489558326,28251852,75664,275075651,79292,30,06,2,2024,2024-06-30,3,2024,303327503,154956
Agency,Department of Veterans Affairs,null,CFO,98.72862416617842,99.97197063433433,6818194,4800,529466500,17120097,30,06,2,2024,2024-06-30,3,2024,536284694,17124897
Agency,Department of Agriculture,null,CFO,99.09564563734594,91.72549594654042,10370227,3950,1136329278,43787,30,06,2,2024,2024-06-30,3,2024,1146699505,47737
Agency,Department of Defense,null,CFO,36.03974447708058,20.131840250980744,1899889548,1144589,1070532525,288509,30,06,2,2024,2024-06-30,3,2024,2970422073,1433098
Bureau,Department of Health & Human Services,Centers for Disease Control,null,18.363054267795892,14.782608695652174,4335659,98,975244,17,30,06,2,2024,2024-06-30,3,2024,5310903,115
Bureau,Department of the Interior,Bureau of Reclamation,null,100.0,100.0,0,0,7424984,72,30,06,2,2024,2024-06-30,3,2024,7424984,72
Bureau,Department of the Interior,National Park Service,null,100.0,100.0,0,0,8854736,2057,30,06,2,2024,2024-06-30,3,2024,8854736,2057
Bureau,Department of Homeland Security,Bureau of Customs & Border Protection,null,100.0,100.0,0,0,9499670,1010,30,06,2,2024,2024-06-30,3,2024,9499670,1010
Bureau,Department of the Treasury,Comptroller of the Currency,null,99.88136082875913,85.18518518518519,1425,4,1199696,23,30,06,2,2024,2024-06-30,3,2024,1201121,27
Bureau,Department of Veterans Affairs,Life Insurance,null,100.0,100.0,0,0,1266595,264,30,06,2,2024,2024-06-30,3,2024,1266595,264
Bureau,Department of Homeland Security,Citizenship and Immigration Services,null,100.0,100.0,0,0,1279189,1603,30,06,2,2024,2024-06-30,3,2024,1279189,1603
Bureau,Presidio Trust Corporation,Presidio Trust Corporation,null,100.0,100.0,0,0,1402257,61,30,06,2,2024,2024-06-30,3,2024,1402257,61
Bureau,Department of Housing and Urban Development,Public and Indian Housing Programs,null,100.0,100.0,0,0,1500944,8,30,06,2,2024,2024-06-30,3,2024,1500944,8
Bureau,Department of Agriculture,Food Safety and Inspection Service,null,94.36616660646325,97.69778149853495,93424,55,1564843,2334,30,06,2,2024,2024-06-30,3,2024,1658267,2389
Agency,Legislative Branch-Office of Tech.,null,Non-CFO,0.0,0.0,0,0,0,0,30,06,2,2024,2024-06-30,3,2024,0,0
Agency,Office of Special Counsel,null,Non-CFO,0.0,0.0,0,0,0,0,30,06,2,2024,2024-06-30,3,2024,0,0
Agency,Tennessee Valley Authority,null,Non-CFO,0.0,0.0,0,0,0,0,30,06,2,2024,2024-06-30,3,2024,0,0
Agency,National Foundation  Arts & Humanities,null,Non-CFO,0.0,0.0,0,0,0,0,30,06,2,2024,2024-06-30,3,2024,0,0
Agency,Legislative Branch-GAO,null,Non-CFO,0.0,0.0,0,0,0,0,30,06,2,2024,2024-06-30,3,2024,0,0
Bureau,Department of Transportation,Office of the Secretary,null,100.0,100.0,0,0,1127150,14,30,06,2,2024,2024-06-30,3,2024,1127150,14
Bureau,Department of the Treasury,Financial Crimes Enforcement Network,null,100.0,100.0,0,0,1544945,3,30,06,2,2024,2024-06-30,3,2024,1544945,3
Bureau,Legislative Branch-Office of Tech.,Medicaid & CHIP Payment & Access Comm.,null,0.0,0.0,0,0,0,0,30,06,2,2024,2024-06-30,3,2024,0,0
Bureau,Other Agencies,National Mediation Board,null,0.0,0.0,0,0,0,0,30,06,2,2024,2024-06-30,3,2024,0,0
Bureau,U.S. Tax Court,U.S. Tax Court,null,0.0,0.0,0,0,0,0,30,06,2,2024,2024-06-30,3,2024,0,0
Bureau,Department of Health & Human Services,Agency for Healthcare Research & Quality,null,0.0,0.0,0,0,0,0,30,06,2,2024,2024-06-30,3,2024,0,0
Bureau,Legislative Branch-Office of Tech.,Open World Leadership,null,0.0,0.0,0,0,0,0,30,06,2,2024,2024-06-30,3,2024,0,0
Bureau,Federal Labor Relations Authority,Federal Labor Relations Authority,null,0.0,0.0,0,0,0,0,30,06,2,2024,2024-06-30,3,2024,0,0
Bureau,Department of Homeland Security,U.S. Secret Service,null,0.0,0.0,0,0,0,0,30,06,2,2024,2024-06-30,3,2024,0,0
Bureau,Department of Homeland Security,Science and Technology,null,0.0,0.0,0,0,0,0,30,06,2,2024,2024-06-30,3,2024,0,0
Bureau,Department of Health & Human Services,Administration for Community Living,null,0.0,0.0,0,0,0,0,30,06,2,2024,2024-06-30,3,2024,0,0
Bureau,Farm Credit Administration,Farm Credit System Insurance Corporation,null,0.0,0.0,0,0,0,0,30,06,2,2024,2024-06-30,3,2024,0,0
Bureau,Other Agencies,Advisory Council on Hist. Preservation,null,0.0,0.0,0,0,0,0,30,06,2,2024,2024-06-30,3,2024,0,0
Bureau,Other Agencies,Commission On Fine Arts,null,0.0,0.0,0,0,0,0,30,06,2,2024,2024-06-30,3,2024,0,0
Bureau,Other Agencies,Archit.&Trans. Barriers Compliance Bd,null,0.0,0.0,0,0,0,0,30,06,2,2024,2024-06-30,3,2024,0,0
Bureau,Office of Government Ethics,Office of Government Ethics,null,0.0,0.0,0,0,0,0,30,06,2,2024,2024-06-30,3,2024,0,0
Bureau,Department of the Treasury,International Monetary Funds,null,0.0,0.0,0,0,0,0,30,06,2,2024,2024-06-30,3,2024,0,0
Bureau,Department of State,International Commissions,null,0.0,0.0,0,0,0,0,30,06,2,2024,2024-06-30,3,2024,0,0
Bureau,Department of the Treasury,Treasury Forfeiture Fund,null,0.0,0.0,0,0,0,0,30,06,2,2024,2024-06-30,3,2024,0,0
Bureau,Other Agencies/Boards/Commissions,U.S.-China Security Review Commission,null,0.0,0.0,0,0,0,0,30,06,2,2024,2024-06-30,3,2024,0,0
Bureau,Other Agencies,National Capital Planning Commission,null,0.0,0.0,0,0,0,0,30,06,2,2024,2024-06-30,3,2024,0,0
Bureau,Department of the Treasury,Office of Financial Research,null,100.0,100.0,0,0,268,1,30,06,2,2024,2024-06-30,3,2024,268,1
Bureau,National Credit Union Administration,National Credit Union Administration,null,100.0,100.0,0,0,397,1,30,06,2,2024,2024-06-30,3,2024,397,1
Bureau,Consumer Product Safety Commission,Consumer Product Safety Commission,null,100.0,100.0,0,0,425,2,30,06,2,2024,2024-06-30,3,2024,425,2
Agency,National Science Foundation,null,CFO,100.0,100.0,0,0,555548,28,30,06,2,2024,2024-06-30,3,2024,555548,28
Agency,National Aeronautics and Space Administration,null,CFO,100.0,100.0,0,0,1207201,134,30,06,2,2024,2024-06-30,3,2024,1207201,134
Agency,Nuclear Regulatory Commission,null,CFO,100.0,100.0,0,0,3409530,364,30,06,2,2024,2024-06-30,3,2024,3409530,364
Agency,General Services Administration,null,CFO,100.0,100.0,0,0,10836356,380,30,06,2,2024,2024-06-30,3,2024,10836356,380
Agency,Department of Energy,null,CFO,100.0,100.0,0,0,13731228,99,30,06,2,2024,2024-06-30,3,2024,13731228,99
Agency,Office of Personnel Management,null,CFO,100.0,100.0,0,0,17802092,989,30,06,2,2024,2024-06-30,3,2024,17802092,989
Agency,Department of State,null,CFO,99.63521502432076,99.80775866318332,82731,39,22596657,20248,30,06,2,2024,2024-06-30,3,2024,22679388,20287
Agency,Agency for International Development,null,CFO,99.99903452298256,98.18181818181819,273,1,28275905,54,30,06,2,2024,2024-06-30,3,2024,28276178,55
Bureau,Department of the Interior,Bureau of Safety and Environmental Enf.,null,100.0,100.0,0,0,13718,2,30,06,2,2024,2024-06-30,3,2024,13718,2
Bureau,Department of Agriculture,Federal Crop Insurance Corporation,null,100.0,100.0,0,0,13798,2,30,06,2,2024,2024-06-30,3,2024,13798,2
Agency,Office of Compliance,null,Non-CFO,0.0,0.0,0,0,0,0,30,06,2,2024,2024-06-30,3,2024,0,0
Agency,Federal Deposit Insurance Corporation,null,Non-CFO,0.0,0.0,0,0,0,0,30,06,2,2024,2024-06-30,3,2024,0,0
Agency,Merit Systems Protection Board,null,Non-CFO,100.0,100.0,0,0,144,1,30,06,2,2024,2024-06-30,3,2024,144,1
Agency,National Credit Union Administration,null,Non-CFO,100.0,100.0,0,0,397,1,30,06,2,2024,2024-06-30,3,2024,397,1
Agency,Consumer Product Safety Commission,null,Non-CFO,100.0,100.0,0,0,425,2,30,06,2,2024,2024-06-30,3,2024,425,2
Agency,Farm Credit Administration,null,Non-CFO,100.0,100.0,0,0,630,1,30,06,2,2024,2024-06-30,3,2024,630,1
Agency,Other Agencies/Boards/Commissions,null,Non-CFO,0.0,0.0,1024,1,0,0,30,06,2,2024,2024-06-30,3,2024,1024,1
Agency,Selective Service System,null,Non-CFO,0.0,0.0,1301,2,0,0,30,06,2,2024,2024-06-30,3,2024,1301,2
Agency,Smithsonian Institution,null,Non-CFO,0.0,0.0,4786,11,0,0,30,06,2,2024,2024-06-30,3,2024,4786,11
Agency,Equal Employment Opportunity Commission,null,Non-CFO,100.0,100.0,0,0,25460,22,30,06,2,2024,2024-06-30,3,2024,25460,22
Bureau,Department of Homeland Security,Federal Law Enforcement Training Ctr.,null,100.0,100.0,0,0,8562,1,30,06,2,2024,2024-06-30,3,2024,8562,1
Bureau,Other Agencies,U.S. Inst. for Env. Conflict Resolution,null,0.0,0.0,8860,2,0,0,30,06,2,2024,2024-06-30,3,2024,8860,2
Bureau,Department of Transportation,Federal Highway Administration,null,100.0,100.0,0,0,9229,8,30,06,2,2024,2024-06-30,3,2024,9229,8
Bureau,Department of Health & Human Services,Centers for Medicare & Medicaid Services,null,97.79701128015991,99.08501200375217,96836498,9208,4298850921,997144,30,06,2,2024,2024-06-30,3,2024,4395687419,1006352
Bureau,Small Business Administration,Small Business Administration,null,100.0,100.0,0,0,74414103000,1252332,30,06,2,2024,2024-06-30,3,2024,74414103000,1252332
Bureau,Department of Education,Federal Student Aid,null,97.03689617950234,96.67090623938745,3343689188,636701,109500456362,18488654,30,06,2,2024,2024-06-30,3,2024,112844145550,19125355
Bureau,Department of Homeland Security,Emergency Preparedness & Resp,null,100.0,100.0,0,0,200177084,41962,30,06,2,2024,2024-06-30,3,2024,200177084,41962
Bureau,Department of Health & Human Services,Food and Drug Administration,null,30.978497738106903,9.3990614606588,158444180,19886,71113530,2063,30,06,2,2024,2024-06-30,3,2024,229557710,21949
Bureau,Department of Health & Human Services,Office of the Secretary,null,100.0,100.0,0,0,236352516,6167,30,06,2,2024,2024-06-30,3,2024,236352516,6167
Bureau,Federal Communications Commission,Federal Communications Commission,null,100.0,100.0,0,0,309028435,16116,30,06,2,2024,2024-06-30,3,2024,309028435,16116
Bureau,Department of Veterans Affairs,Medical and Construction,null,99.814660591924,99.98460474163446,979308,2636,527406970,17119519,30,06,2,2024,2024-06-30,3,2024,528386278,17122155
Bureau,Department of Agriculture,Rural Development,null,99.99915244337785,99.98183271564567,6955,5,820587188,27517,30,06,2,2024,2024-06-30,3,2024,820594143,27522
Bureau,Department of Education,Departmental Management,null,99.70575866735479,96.44913627639156,3582007,74,1213788431,2010,30,06,2,2024,2024-06-30,3,2024,1217370438,2084
Bureau,Department of Defense,Consolidated Report,null,36.03974447708058,20.131840250980744,1899889548,1144589,1070532525,288509,30,06,2,2024,2024-06-30,3,2024,2970422073,1433098
Bureau,Securities & Exchange Commission,SEC Enforcement,null,100.0,100.0,0,0,3930789694,1738,30,06,2,2024,2024-06-30,3,2024,3930789694,1738
Bureau,Social Security Administration,Social Security Administration,null,54.31493382407205,29.93372975962225,1943270074,922372,2310352032,394056,30,06,2,2024,2024-06-30,3,2024,4253622106,1316428
Bureau,Department of Commerce,NOAA,null,100.0,100.0,0,0,12517698,814,30,06,2,2024,2024-06-30,3,2024,12517698,814
Bureau,Department of Energy,Energy Consolidated Reports,null,100.0,100.0,0,0,12672757,71,30,06,2,2024,2024-06-30,3,2024,12672757,71
Bureau,Federal Election Commission,Federal Election Commission,null,100.0,100.0,0,0,3293452,414,30,06,2,2024,2024-06-30,3,2024,3293452,414
Bureau,Nuclear Regulatory Commission,Nuclear Regulatory Commission,null,100.0,100.0,0,0,3409530,364,30,06,2,2024,2024-06-30,3,2024,3409530,364
Bureau,Department of the Treasury,Community Dev Financial Inst Fund,null,100.0,100.0,0,0,3617920,7,30,06,2,2024,2024-06-30,3,2024,3617920,7
Bureau,Department of Agriculture,Agricultural Marketing Service,null,83.09852971747385,57.659890927119484,785388,854,3861474,1163,30,06,2,2024,2024-06-30,3,2024,4646862,2017
Bureau,Department of Veterans Affairs,Administration and Cemeteries,null,15.372090581669054,37.365269461077844,4199627,523,762834,312,30,06,2,2024,2024-06-30,3,2024,4962461,835
Bureau,Corp. for National and Community Service,Corp. for National and Community Service,null,96.18314249758028,47.58842443729903,142912,163,3601320,148,30,06,2,2024,2024-06-30,3,2024,3744232,311
Bureau,Department of Transportation,Federal Aviation Administration,null,100.0,100.0,0,0,4576202,519,30,06,2,2024,2024-06-30,3,2024,4576202,519
Bureau,Department of Commerce,Economic Development Administration,null,100.0,100.0,0,0,5120584,11,30,06,2,2024,2024-06-30,3,2024,5120584,11
